"","date","state","positive","negative","pending","hospitalizedCurrently","hospitalizedCumulative","inIcuCurrently","inIcuCumulative","onVentilatorCurrently","onVentilatorCumulative","recovered","dataQualityGrade","lastUpdateEt","hash","dateChecked","death","hospitalized","total","totalTestResults","posNeg","fips","deathIncrease","hospitalizedIncrease","negativeIncrease","positiveIncrease","totalTestResultsIncrease"
"1",20200528,"AK",425,47545,NA,10,NA,NA,NA,NA,NA,366,"B","5/28/2020 00:00","37e60616c88a6df069f2a7030ec9f82b3978cb83","2020-05-28T20:00:00Z",10,NA,47970,47970,47970,2,0,0,1594,13,1607
"2",20200528,"AL",16310,184171,NA,NA,1765,NA,566,NA,338,9355,"B","5/28/2020 00:00","b774f53f9f66430cb45fa6be6f576eb6ef99e74d","2020-05-28T20:00:00Z",590,1765,200481,200481,200481,1,9,46,4220,467,4687
"3",20200528,"AR",6538,112364,NA,104,640,NA,NA,27,118,4583,"A","5/27/2020 19:30","e62e173d8cad6fe1acec1555776aa074b3947e0b","2020-05-28T20:00:00Z",120,640,118902,118902,118902,5,0,13,3045,261,3306
"4",20200528,"AS",0,174,NA,NA,NA,NA,NA,NA,NA,NA,"C","5/27/2020 00:00","c8ab6f4513aca84f90b5b0a8124f6717609418d2","2020-05-28T20:00:00Z",0,NA,174,174,174,60,0,0,0,0,0
"5",20200528,"AZ",17763,185151,NA,945,2848,374,NA,222,NA,4452,"A+","5/28/2020 00:00","45c769434c737e258af3517aa823e29db459b8c5","2020-05-28T20:00:00Z",857,2848,202914,202914,202914,4,26,817,6147,501,6648
"6",20200528,"CA",101697,1688862,NA,4529,NA,1325,NA,NA,NA,NA,"B","5/28/2020 00:00","0d6445cf4d68a90656e6555a195d5a9962ef31d6","2020-05-28T20:00:00Z",3973,NA,1790559,1790559,1790559,6,89,0,50948,2717,53665
"7",20200528,"CO",24767,138356,NA,464,4196,NA,NA,NA,NA,3783,"A","5/28/2020 00:00","47429073013e32fc25412a25d102ed82fd2d8c5b","2020-05-28T20:00:00Z",1392,4196,163123,163123,163123,8,40,36,3501,202,3703
"8",20200528,"CT",41559,193966,NA,648,12538,NA,NA,NA,NA,7127,"B","5/27/2020 20:30","b80aa1e7519d87cc4826d75322b19a7d3bd31d8d","2020-05-28T20:00:00Z",3826,12538,235525,235525,235525,9,57,0,9907,256,10163
"9",20200528,"DC",8492,35022,NA,343,NA,108,NA,65,NA,1082,"A+","5/27/2020 00:00","3f9cd5fb4826e55d96651d25152b4b0e455634e9","2020-05-28T20:00:00Z",453,NA,43514,43514,43514,11,8,0,731,86,817
"10",20200528,"DE",9171,47630,NA,192,NA,NA,NA,NA,NA,5010,"A","5/27/2020 18:00","da39ed47ae2ed22845d694130a3faaf79621cea8","2020-05-28T20:00:00Z",345,NA,56801,56801,56801,10,1,0,1305,75,1380
"11",20200528,"FL",53285,898331,1158,NA,10056,NA,NA,NA,NA,NA,"A","5/28/2020 11:06","8c42f020c41108f56b0f6dc309b25606a65e4930","2020-05-28T20:00:00Z",2446,10056,952774,951616,951616,12,46,157,17394,651,18045
"12",20200528,"GA",45070,399576,NA,903,7767,NA,1761,NA,NA,NA,"A","5/28/2020 13:00","5b127b95bbad149e46a66d70861b87e05917bb61","2020-05-28T20:00:00Z",1962,7767,444646,444646,444646,13,55,101,3241,649,3890
"13",20200528,"GU",172,5790,NA,NA,NA,NA,NA,NA,NA,143,"C","5/28/2020 07:45","d5cfba905aa705acb646beade0967b9322c97f8a","2020-05-28T20:00:00Z",5,NA,5962,5962,5962,66,0,0,275,2,277
"14",20200528,"HI",644,51195,NA,NA,83,NA,NA,NA,NA,600,"D","5/27/2020 18:00","eb5caab44b97cab87b00780c807576c1aa2249c4","2020-05-28T20:00:00Z",17,83,51839,51839,51839,15,0,0,636,1,637
"15",20200528,"IA",18573,124360,NA,383,NA,112,NA,67,NA,10359,"A+","5/28/2020 00:00","0c558bbcd9759637c5852624cf7ff428f9b7706d","2020-05-28T20:00:00Z",504,NA,142933,142933,142933,19,13,0,3194,213,3407
"16",20200528,"ID",2731,41144,NA,NA,234,NA,95,NA,NA,2185,"A","5/27/2020 19:00","cc9ca61004890c3c4708d90004805a71ba8dd12a","2020-05-28T20:00:00Z",82,234,43875,43875,43875,16,1,3,826,32,858
"17",20200528,"IL",115833,714133,NA,3649,NA,1009,NA,576,NA,NA,"A","5/28/2020 00:00","e1b1875c6d981adf1ee8074b1e73bdfa026e263d","2020-05-28T20:00:00Z",5186,NA,829966,829966,829966,17,103,0,24466,1527,25993
"18",20200528,"IN",33068,209219,NA,1131,5285,411,1166,178,NA,NA,"A+","5/27/2020 23:59","8fa2579596481ba0941b248b486b5718440f0634","2020-05-28T20:00:00Z",2068,5285,242287,242287,242287,18,38,0,6323,631,6954
"19",20200528,"KS",9337,75151,NA,NA,822,NA,275,NA,122,534,"A","5/27/2020 10:00","420d9678eab5e67987bc2dbf21d650ac62cd9cbd","2020-05-28T20:00:00Z",205,822,84488,84488,84488,20,0,0,0,0,0
"20",20200528,"KY",9077,173024,NA,512,2142,82,899,NA,NA,3124,"A","5/27/2020 17:00","71be8eb32be047d18efb7195be6dda99a0498e34","2020-05-28T20:00:00Z",400,2142,182101,182101,182101,21,0,6,0,0,0
"21",20200528,"LA",38802,316225,NA,761,NA,NA,NA,100,NA,28700,"B","5/28/2020 13:00","e2aac96a2a5dec451d10bdac274808510452330d","2020-05-28T20:00:00Z",2740,NA,355027,355027,355027,22,18,0,7075,305,7380
"22",20200528,"MA",94895,467428,NA,2112,9618,529,NA,NA,NA,NA,"A","5/28/2020 10:00","105e052b4e29072082da566bd62689b53a509d2a","2020-05-28T20:00:00Z",6640,9618,562323,562323,562323,25,167,230,15640,1202,16842
"23",20200528,"MD",49709,225149,NA,1334,8392,511,NA,NA,NA,3468,"B","5/28/2020 10:00","8ab2e4b5e209f592e8201fecea3d561b26f8cf6d","2020-05-28T20:00:00Z",2428,8392,274858,274858,274858,24,36,111,11517,1286,12803
"24",20200528,"ME",2189,43480,NA,58,264,22,NA,14,NA,1402,"B","5/27/2020 23:59","70be23f06535f9c5b80a8e678ab7616468d6e0a7","2020-05-28T20:00:00Z",84,264,45669,45669,45669,23,3,4,0,52,52
"25",20200528,"MI",56014,448444,NA,860,NA,405,NA,251,NA,33168,"A+","5/28/2020 11:00","7d7f5821c6c7d00ec9763f6d6db5e192bf524a97","2020-05-28T20:00:00Z",5372,NA,504458,504458,504458,26,38,0,9800,406,10206
"26",20200528,"MN",22947,202261,NA,606,2880,242,924,NA,NA,16655,"A","5/27/2020 17:00","7dedd434b482687cbdb03d046c043669b586d3fb","2020-05-28T20:00:00Z",977,2880,225208,225208,225208,27,35,84,8193,483,8676
"27",20200528,"MO",12673,158394,NA,648,NA,NA,NA,88,NA,NA,"B","5/28/2020 15:00","f0435496343e9f13f7a18986b5dd7f464799c978","2020-05-28T20:00:00Z",707,NA,171067,171067,171067,29,11,0,5365,181,5546
"28",20200528,"MP",22,5401,NA,NA,NA,NA,NA,NA,NA,13,"D","5/28/2020 00:00","4b1e8a3bb27629a6313be8ced9c00fef6be2059b","2020-05-28T20:00:00Z",2,NA,5423,5423,5423,69,0,0,223,0,223
"29",20200528,"MS",14372,142125,NA,594,2147,148,NA,78,NA,9401,"A","5/27/2020 19:00","661b9dd86110272c057d91cdbf3dcc33743487ff","2020-05-28T20:00:00Z",693,2147,156497,156497,156497,28,23,41,8037,328,8365
"30",20200528,"MT",485,36308,NA,1,66,NA,NA,NA,NA,445,"C","5/28/2020 00:00","d26c244d850a92f579a1a14038ee6bccc748d16c","2020-05-28T20:00:00Z",17,66,36793,36793,36793,30,0,0,1146,4,1150
"31",20200528,"NC",25412,349780,NA,708,NA,NA,NA,NA,NA,14954,"A","5/28/2020 10:30","4c9326fc2d7f33cc29224ab037231efa77e1c720","2020-05-28T20:00:00Z",827,NA,375192,375192,375192,37,33,0,10252,784,11036
"32",20200528,"ND",2481,65773,NA,35,161,NA,NA,NA,NA,1793,"C","5/28/2020 00:00","b2c5f3c80e5d4084a0ae2c9ca8fc48c84bd14163","2020-05-28T20:00:00Z",57,161,68254,68254,68254,38,1,0,872,42,914
"33",20200528,"NE",12976,80004,NA,NA,NA,NA,NA,NA,NA,NA,"D","5/26/2020 19:45","725a3605316363d1bd3cd869e0128be93129b8d5","2020-05-28T20:00:00Z",163,NA,92980,92980,92980,31,10,0,2202,357,2559
"34",20200528,"NH",4286,61310,NA,105,426,NA,120,NA,NA,2691,"B","5/27/2020 09:00","c4b87fc4a66c5f58efc30592052b6bdeb8ed00fb","2020-05-28T20:00:00Z",223,426,65596,65596,65596,33,9,5,1309,55,1364
"35",20200528,"NJ",157815,528042,NA,2797,16778,740,NA,564,NA,25804,"A+","5/28/2020 13:00","8c07b34e421f01a33bdbeb9776805936d9fd953b","2020-05-28T20:00:00Z",11401,16778,685857,685857,685857,34,62,181,24345,1187,25532
"36",20200528,"NM",7252,172291,NA,210,1282,NA,NA,NA,NA,2638,"C","5/27/2020 18:19","39ed39ce08a30a1f99b1c7341e95f0d4287ad486","2020-05-28T20:00:00Z",329,1282,179543,179543,179543,35,4,0,-1225,122,-1103
"37",20200528,"NV",8208,122982,NA,439,NA,123,NA,55,NA,406,"A+","5/28/2020 12:30","bb72893caad2225b6dab6d6ec4cf62e296c5c9d0","2020-05-28T20:00:00Z",406,NA,131190,131190,131190,32,10,0,2536,95,2631
"38",20200528,"NY",366733,1510056,NA,4010,78043,1219,NA,931,NA,64954,"A","5/28/2020 00:00","bc0a13ef57e5405d70899664f175c10af1327dde","2020-05-28T20:00:00Z",23722,78043,1876789,1876789,1876789,36,79,205,63477,1768,65245
"39",20200528,"OH",33915,326097,NA,812,5811,285,1516,190,NA,NA,"B","5/28/2020 14:00","57302292ddfb7add68839b860938d3bf23fdd562","2020-05-28T20:00:00Z",2098,5811,360012,360012,360012,39,54,111,9811,476,10287
"40",20200528,"OK",6270,176136,NA,181,975,80,NA,NA,NA,5236,"A+","5/28/2020 00:00","78a25c9436f9cdfd77b7460220c32eb5095fe9a8","2020-05-28T20:00:00Z",326,975,182406,182406,182406,40,4,34,3727,41,3768
"41",20200528,"OR",4086,115561,NA,149,768,32,NA,17,NA,1981,"A+","5/28/2020 03:01","6103c88787be52bdc91a79ae56bdbda4165430a2","2020-05-28T20:00:00Z",151,768,119647,119647,119647,41,3,9,2607,48,2655
"42",20200528,"PA",70042,357804,NA,1476,NA,NA,NA,321,NA,44826,"A","5/28/2020 00:00","74922bd8f5c91ea0ecb0ffbcc3d8c4c8e6890ab2","2020-05-28T20:00:00Z",5373,NA,427846,427846,427846,42,108,0,7814,625,8439
"43",20200528,"PR",3486,NA,NA,120,NA,12,NA,5,NA,NA,"B","5/28/2020 06:30","df5c1df1454099980ca23e3de7a52ce5415de407","2020-05-28T20:00:00Z",131,NA,3486,3486,3486,72,2,0,0,89,89
"44",20200528,"RI",14494,125871,NA,222,1639,53,NA,36,NA,1186,"A+","5/28/2020 12:00","0365a22bde589e79431321290ad95465e7ffc69c","2020-05-28T20:00:00Z",677,1639,140365,140365,140365,44,22,15,1841,141,1982
"45",20200528,"SC",10788,171461,NA,397,1618,NA,NA,NA,NA,6102,"A","5/27/2020 16:00","b4baccaa6e0dd2bae6cbca85e540a460e6e3aa0e","2020-05-28T20:00:00Z",470,1618,182249,182249,182249,45,4,0,6401,165,6566
"46",20200528,"SD",4793,34233,NA,105,406,NA,NA,NA,NA,3698,"B","5/27/2020 18:00","fa05e5217208735ebc102e945cbc97d5d59f86c7","2020-05-28T20:00:00Z",54,406,39026,39026,39026,46,0,15,937,83,1020
"47",20200528,"TN",21679,394310,NA,NA,1689,NA,NA,NA,NA,14632,"B","5/28/2020 15:00","051f068b0367433b0434448cb15dfb6bcb727374","2020-05-28T20:00:00Z",356,1689,415989,415989,415989,47,3,42,5986,373,6359
"48",20200528,"TX",59776,813442,NA,1692,NA,NA,NA,NA,NA,38905,"B","5/28/2020 16:30","0a198f4e7f8092c607c50595e88ddf4ab8e353b7","2020-05-28T20:00:00Z",1601,NA,873218,873218,873218,48,39,0,15689,1855,17544
"49",20200528,"UT",8921,194586,NA,169,734,NA,231,NA,98,5623,"B","5/28/2020 10:04","d5814481b1d5eedb1e2494bba14567ef694b7863","2020-05-28T20:00:00Z",106,734,203507,203507,203507,49,1,18,2666,215,2881
"50",20200528,"VA",41401,245880,476,1502,6974,416,NA,195,NA,5472,"A+","5/27/2020 17:00","4b6e4ffcf530d52d9e30d5c0d284b33e1a26e8f9","2020-05-28T20:00:00Z",1338,6974,287757,287281,287281,51,57,148,9082,1152,10234
"51",20200528,"VI",69,1617,22,NA,NA,NA,NA,NA,NA,61,"C","5/28/2020 08:14","3ee3e7b83088b16851f527f504bac0e033123a34","2020-05-28T20:00:00Z",6,NA,1708,1686,1686,78,0,0,175,0,175
"52",20200528,"VT",974,30178,NA,17,NA,NA,NA,NA,NA,855,"B","5/27/2020 05:00","4db1a5083bf37630d6bbe8e4b0c6a32a04aee34c","2020-05-28T20:00:00Z",55,NA,31152,31152,31152,50,1,0,150,3,153
"53",20200528,"WA",20406,315395,NA,325,3394,NA,NA,94,NA,NA,"B","5/27/2020 02:59","d1a0f872ae25f78d2c838361c0c507e58d90a0ba","2020-05-28T20:00:00Z",1095,3394,335801,335801,335801,53,17,56,2785,225,3010
"54",20200528,"WI",16974,220719,250,659,2452,138,556,NA,NA,10384,"A+","5/28/2020 00:00","ac96dda89bd3d0838d20726087818ffba991cb20","2020-05-28T20:00:00Z",550,2452,237943,237693,237693,55,11,41,10114,512,10626
"55",20200528,"WV",1906,88409,NA,35,NA,13,NA,6,NA,1211,"B","5/28/2020 10:00","740f235cab16a8d5f1c0e7266170b10a12cbe10f","2020-05-28T20:00:00Z",74,NA,90315,90315,90315,54,0,0,1815,39,1854
"56",20200528,"WY",874,22286,NA,15,82,NA,NA,NA,NA,624,"C","5/28/2020 00:00","29c67970b133b2a4e1cc987d94362f6912baa22f","2020-05-28T20:00:00Z",15,82,23160,23160,23160,56,2,0,1634,24,1658
"57",20200527,"AK",412,45951,NA,14,NA,NA,NA,NA,NA,364,"C","5/27/2020 00:00","1f920b901222020b42b640349ef1bfb698ae06fd","2020-05-27T20:00:00Z",10,NA,46363,46363,46363,2,0,0,1398,1,1399
"58",20200527,"AL",15843,179951,NA,NA,1719,NA,560,NA,334,7951,"B","5/27/2020 00:00","b1e78b216055a939eadb2fa0b35b6aea3709d5e0","2020-05-27T20:00:00Z",581,1719,195794,195794,195794,1,6,48,1588,447,2035
"59",20200527,"AR",6277,109319,NA,108,627,NA,NA,22,116,4424,"A","5/27/2020 00:00","d8c27fb7bce335f3feb8c55820da56e48b931a71","2020-05-27T20:00:00Z",120,627,115596,115596,115596,5,1,10,3726,97,3823
"60",20200527,"AS",0,174,NA,NA,NA,NA,NA,NA,NA,NA,"C","5/27/2020 00:00","a6489f77760f6b067beaa7e06b64c868272d3fc0","2020-05-27T20:00:00Z",0,NA,174,174,174,60,0,0,50,0,50
"61",20200527,"AZ",17262,179004,NA,911,2031,375,NA,237,NA,4361,"A+","5/27/2020 00:00","970f8046d3328a5389a2f96fd2b3f3c31309fc0d","2020-05-27T20:00:00Z",831,2031,196266,196266,196266,4,24,43,5056,479,5535
"62",20200527,"CA",98980,1637914,NA,4544,NA,1407,NA,NA,NA,NA,"B","5/27/2020 00:00","66f26242f4b8832827757a771d3b4bfb701edccf","2020-05-27T20:00:00Z",3884,NA,1736894,1736894,1736894,6,70,0,38251,2247,40498
"63",20200527,"CO",24565,134855,NA,484,4160,NA,NA,NA,NA,3741,"A","5/26/2020 00:00","b55d6e6913201d7715deb0b19b4b6a10d96dd635","2020-05-27T20:00:00Z",1352,4160,159420,159420,159420,8,19,32,3113,296,3409
"64",20200527,"CT",41303,184059,NA,694,12538,NA,NA,NA,NA,7127,"B","5/25/2020 20:30","4810b771723164a6ce9535dccda84f28a46eecef","2020-05-27T20:00:00Z",3769,12538,225362,225362,225362,9,0,0,0,0,0
"65",20200527,"DC",8406,34291,NA,349,NA,113,NA,76,NA,1082,"A+","5/26/2020 00:00","5ad869913d410959a85c3ab8d2967c5258fb000f","2020-05-27T20:00:00Z",445,NA,42697,42697,42697,11,5,0,570,72,642
"66",20200527,"DE",9096,46325,NA,196,NA,NA,NA,NA,NA,4909,"A","5/26/2020 18:00","bb9172f3ddfd5c8828cb9d59dcdff3a26a04c8fe","2020-05-27T20:00:00Z",344,NA,55421,55421,55421,10,9,0,477,30,507
"67",20200527,"FL",52634,880937,955,NA,9899,NA,NA,NA,NA,NA,"A","5/27/2020 10:13","275368b62ae6c5c09bd3532f4d9955951b04bf46","2020-05-27T20:00:00Z",2400,9899,934526,933571,933571,12,62,159,9968,379,10347
"68",20200527,"GA",44421,396335,NA,907,7666,NA,1735,NA,NA,NA,"A","5/27/2020 13:24","d3f7997b8ceb0a404aba7909b549a522a3230f37","2020-05-27T20:00:00Z",1907,7666,440756,440756,440756,13,36,119,-74880,691,-74189
"69",20200527,"GU",170,5515,NA,1,NA,NA,NA,NA,NA,143,"C","5/27/2020 08:15","1014ee99fad693962f6a826c7125af38c4eda5dc","2020-05-27T20:00:00Z",5,NA,5685,5685,5685,66,0,0,0,1,1
"70",20200527,"HI",643,50559,NA,NA,83,NA,NA,NA,NA,593,"D","5/26/2020 00:00","ba6f2c5f74d3666b4ea34a87faea7df2ecdd2647","2020-05-27T20:00:00Z",17,83,51202,51202,51202,15,0,-1,831,0,831
"71",20200527,"IA",18360,121166,NA,393,NA,109,NA,66,NA,10016,"A+","5/27/2020 00:00","da99d86a36337d08d1629f92cbc53edd27deb5db","2020-05-27T20:00:00Z",491,NA,139526,139526,139526,19,13,0,3865,657,4522
"72",20200527,"ID",2699,40318,NA,NA,231,NA,95,NA,NA,2100,"A","5/26/2020 19:00","59fb8a17bbb37bac087774c1c584b69f83ef8af2","2020-05-27T20:00:00Z",81,231,43017,43017,43017,16,2,6,1538,73,1611
"73",20200527,"IL",114306,689667,NA,3826,NA,1031,NA,592,NA,NA,"A","5/27/2020 00:00","31c5fbde7707eba98dfe6e9f556e4bcb7e294fd7","2020-05-27T20:00:00Z",5083,NA,803973,803973,803973,17,160,0,16068,1111,17179
"74",20200527,"IN",32437,202896,NA,1122,5285,400,1166,182,NA,NA,"A+","5/26/2020 23:59","8f5669159a67398fb74fcb82594b30b9a7c20e03","2020-05-27T20:00:00Z",2030,5285,235333,235333,235333,18,26,0,4225,359,4584
"75",20200527,"KS",9337,75151,NA,NA,822,NA,275,NA,122,534,"A","5/27/2020 10:00","bf5c3768e4fae390aa0c4c11f0f15b0c0c0f66aa","2020-05-27T20:00:00Z",205,822,84488,84488,84488,20,17,22,2970,119,3089
"76",20200527,"KY",9077,173024,NA,489,2136,78,897,NA,NA,3124,"A","5/27/2020 17:00","f3e038b796041f00e7b87771ed01e0f78dd83d52","2020-05-27T20:00:00Z",400,2136,182101,182101,182101,21,9,5,11739,506,12245
"77",20200527,"LA",38497,309150,NA,798,NA,NA,NA,100,NA,28700,"B","5/27/2020 13:00","a5c7446d5dcf9a818124a9308b0fb5d7b194a04e","2020-05-27T20:00:00Z",2722,NA,347647,347647,347647,22,21,0,6178,443,6621
"78",20200527,"MA",93693,451788,NA,2108,9388,560,NA,NA,NA,NA,"A","5/26/2020 10:00","30c1f694847a322505bb779d7a7c65ec7a9c731f","2020-05-27T20:00:00Z",6473,9388,545481,545481,545481,25,0,0,0,0,0
"79",20200527,"MD",48423,213632,NA,1338,8281,520,NA,NA,NA,3401,"B","5/27/2020 10:00","e9ee81c8a03c722322f025ed5968b95dcb0a8106","2020-05-27T20:00:00Z",2392,8281,262055,262055,262055,24,59,102,6832,736,7568
"80",20200527,"ME",2137,43480,NA,59,260,25,NA,14,NA,1357,"B","5/26/2020 23:59","4d71c59de014824416ecb35e811d2e943dce1a42","2020-05-27T20:00:00Z",81,260,45617,45617,45617,23,2,2,8030,28,8058
"81",20200527,"MI",55608,438644,NA,882,NA,388,NA,272,NA,33168,"A+","5/27/2020 11:00","408a63885bfe5e3f2d3ac417b1feb2f294d879ce","2020-05-27T20:00:00Z",5334,NA,494252,494252,494252,26,68,0,9469,504,9973
"82",20200527,"MN",22464,194068,NA,598,2796,260,902,NA,NA,16314,"A","5/26/2020 17:00","60318f2c460c44bff3a4fd9d5e89bd6d36b36d82","2020-05-27T20:00:00Z",942,2796,216532,216532,216532,27,34,87,6130,504,6634
"83",20200527,"MO",12492,153029,NA,644,NA,NA,NA,84,NA,NA,"B","5/27/2020 15:00","55267de0960ddcacc5dd5d60dc68d07a82483714","2020-05-27T20:00:00Z",696,NA,165521,165521,165521,29,10,0,5022,201,5223
"84",20200527,"MP",22,5178,NA,NA,NA,NA,NA,NA,NA,13,"D","5/27/2020 00:00","136190157399edb8bca0a239d79c7198c1a4d9ce","2020-05-27T20:00:00Z",2,NA,5200,5200,5200,69,0,0,260,0,260
"85",20200527,"MS",14044,134088,NA,547,2106,127,NA,73,NA,9401,"A","5/26/2020 19:00","3bc9a7d11e07f88557b35565f582b64dbea34b2b","2020-05-27T20:00:00Z",670,2106,148132,148132,148132,28,18,36,0,313,313
"86",20200527,"MT",481,35162,NA,2,66,NA,NA,NA,NA,444,"C","5/27/2020 00:00","248b5c1752b86a9c32fcbd95f46bbf16c118acbb","2020-05-27T20:00:00Z",17,66,35643,35643,35643,30,0,1,1807,2,1809
"87",20200527,"NC",24628,339528,NA,702,NA,NA,NA,NA,NA,14954,"A","5/27/2020 11:00","f7fe78dec635fc1c34f18762bbeab2c1b4edf460","2020-05-27T20:00:00Z",794,NA,364156,364156,364156,37,28,0,11337,488,11825
"88",20200527,"ND",2439,64901,NA,40,161,NA,NA,NA,NA,1762,"C","5/27/2020 00:00","e867cf3bb0e6f63d3c3c3b46ad6e81bc13840bca","2020-05-27T20:00:00Z",56,161,67340,67340,67340,38,2,5,469,17,486
"89",20200527,"NE",12619,77802,NA,NA,NA,NA,NA,NA,NA,NA,"D","5/26/2020 19:00","5f17275594d34c547a01ed03a86974ccdf94f5e8","2020-05-27T20:00:00Z",153,NA,90421,90421,90421,31,3,0,2115,264,2379
"90",20200527,"NH",4231,60001,1370,91,421,NA,120,NA,NA,2550,"B","5/26/2020 09:00","62088c259930ad53a32b9a2b78bdd8ae8e330afb","2020-05-27T20:00:00Z",214,421,65602,64232,64232,33,4,1,1159,34,1193
"91",20200527,"NJ",156628,503697,NA,2761,16597,768,NA,583,NA,25552,"A+","5/27/2020 13:00","b8a006657f612d96627cda2d971ba6b7c7deda6b","2020-05-27T20:00:00Z",11339,16597,660325,660325,660325,34,148,224,23569,864,24433
"92",20200527,"NM",7130,173516,NA,211,1282,NA,NA,NA,NA,2564,"C","5/27/2020 00:32","1513b48e16eb45423a6f7ee2358c5048c5c9a0a3","2020-05-27T20:00:00Z",325,1282,180646,180646,180646,35,5,18,3181,104,3285
"93",20200527,"NV",8113,120446,NA,435,NA,108,NA,48,NA,401,"A+","5/27/2020 11:00","368712086be8243f690c62f0a8bfb5d397877543","2020-05-27T20:00:00Z",396,NA,128559,128559,128559,32,0,0,5076,116,5192
"94",20200527,"NY",364965,1446579,NA,4208,77838,1261,NA,988,NA,64632,"A","5/27/2020 00:00","ef0111f55ed61fc61f7990fdcc115cde9a224382","2020-05-27T20:00:00Z",23643,77838,1811544,1811544,1811544,36,79,201,36287,1129,37416
"95",20200527,"OH",33439,316286,NA,885,5700,313,1492,217,NA,NA,"B","5/27/2020 14:00","bcb1ea15889639d07545b46aee11ddfc28281f1f","2020-05-27T20:00:00Z",2044,5700,349725,349725,349725,39,42,121,9892,433,10325
"96",20200527,"OK",6229,172409,NA,156,941,74,NA,NA,NA,5135,"A+","5/27/2020 00:00","8e95120d844b96e520253e9bca59920ba22ede81","2020-05-27T20:00:00Z",322,941,178638,178638,178638,40,4,0,18605,92,18697
"97",20200527,"OR",4038,112954,NA,146,759,35,NA,16,NA,1795,"A+","5/27/2020 03:01","6261c171b314350e086417699657e92de7a62b2c","2020-05-27T20:00:00Z",148,759,116992,116992,116992,41,0,7,1383,71,1454
"98",20200527,"PA",69417,349990,NA,1493,NA,NA,NA,351,NA,43038,"A","5/27/2020 00:00","ef91bc5870e0d3bb98e33deb283b54857fd341f2","2020-05-27T20:00:00Z",5265,NA,419407,419407,419407,42,113,0,10155,780,10935
"99",20200527,"PR",3397,NA,NA,105,NA,8,NA,4,NA,NA,"B","5/27/2020 06:30","08951a850b61440223bca88bf289138bbe8866ff","2020-05-27T20:00:00Z",129,NA,3397,3397,3397,72,0,0,0,73,73
"100",20200527,"RI",14353,124030,NA,218,1624,49,NA,35,NA,1175,"A+","5/27/2020 00:00","a5d2f13a5c2715af19b21509234da0c473ba44de","2020-05-27T20:00:00Z",655,1624,138383,138383,138383,44,21,11,2877,143,3020
"101",20200527,"SC",10623,165060,NA,398,1618,NA,NA,NA,NA,6102,"A","5/26/2020 16:02","0d92e1c0094e6d40507ef3700d16043d205e7338","2020-05-27T20:00:00Z",466,1618,175683,175683,175683,45,20,0,2742,207,2949
"102",20200527,"SD",4710,33296,NA,101,391,NA,NA,NA,NA,3619,"B","5/26/2020 18:00","b66114ad929207f2b4e8824ada59fa0c3c749ca3","2020-05-27T20:00:00Z",54,391,38006,38006,38006,46,4,13,911,57,968
"103",20200527,"TN",21306,388324,NA,NA,1647,NA,NA,NA,NA,13916,"B","5/27/2020 15:00","b9b7bb156b21a3a137ecff99d122e1c876f3eed9","2020-05-27T20:00:00Z",353,1647,409630,409630,409630,47,10,38,5785,341,6126
"104",20200527,"TX",57921,797753,NA,1645,NA,NA,NA,NA,NA,37626,"B","5/27/2020 16:40","c348ed067ec1a15ee93fa85e8aef7910c4da5a85","2020-05-27T20:00:00Z",1562,NA,855674,855674,855674,48,26,0,33080,1361,34441
"105",20200527,"UT",8706,191920,NA,127,716,NA,223,NA,94,5499,"B","5/27/2020 11:04","03746f86c830503f7561f8a9bff6cecd939ec0e5","2020-05-27T20:00:00Z",105,716,200626,200626,200626,49,4,20,1948,86,2034
"106",20200527,"VA",40249,236798,444,1459,6826,390,NA,203,NA,5367,"A+","5/26/2020 17:00","d851d7ab8e2ad726a5e63eebb78557a60ad93284","2020-05-27T20:00:00Z",1281,6826,277491,277047,277047,51,45,196,8959,907,9866
"107",20200527,"VI",69,1442,28,NA,NA,NA,NA,NA,NA,61,"C","5/26/2020 11:12","848cc5e58f9058ef02c242c818cdf710d0de4693","2020-05-27T20:00:00Z",6,NA,1539,1511,1511,78,0,0,17,0,17
"108",20200527,"VT",971,30028,NA,21,NA,NA,NA,NA,NA,849,"B","5/27/2020 00:00","2838337b19122e7ee0886e42974974398e604308","2020-05-27T20:00:00Z",54,NA,30999,30999,30999,50,0,0,572,4,576
"109",20200527,"WA",20181,312610,NA,241,3338,NA,NA,53,NA,NA,"B","5/26/2020 02:59","cd1348fd8cbdbdf463ad5b9427d3e3630f88f65d","2020-05-27T20:00:00Z",1078,3338,332791,332791,332791,53,8,48,2077,116,2193
"110",20200527,"WI",16462,210605,335,748,2411,139,550,NA,NA,9846,"A+","5/27/2020 16:00","6e358f64458d51b93e8fdbf7492bf92ce73e789f","2020-05-27T20:00:00Z",539,2411,227402,227067,227067,55,22,49,9731,599,10330
"111",20200527,"WV",1867,86594,NA,36,NA,13,NA,6,NA,1191,"B","5/27/2020 10:00","47d536327b873dfb078e34368d1245c7163e57b7","2020-05-27T20:00:00Z",74,NA,88461,88461,88461,54,0,0,637,13,650
"112",20200527,"WY",850,20652,NA,12,82,NA,NA,NA,NA,607,"C","5/27/2020 00:00","6868fe99626738fd1577bff5c1d262b48a8a864d","2020-05-27T20:00:00Z",13,82,21502,21502,21502,56,0,0,0,0,0
"113",20200526,"AK",411,44553,NA,12,NA,NA,NA,NA,NA,362,"C","5/26/2020 00:00","fcbd34ff6bfcac99304f454a7b90279f03e04f9e","2020-05-26T20:00:00Z",10,NA,44964,44964,44964,2,0,0,490,2,492
"114",20200526,"AL",15396,178363,NA,NA,1671,NA,551,NA,327,7951,"B","5/26/2020 00:00","1e5b99a08b1aee7651ff7e22ef5f59f6e520f490","2020-05-26T20:00:00Z",575,1671,193759,193759,193759,1,13,42,2778,666,3444
"115",20200526,"AR",6180,105593,NA,107,617,NA,NA,18,114,4332,"A","5/26/2020 15:29","0babe89e62d07070dae7aa9a81b624454faa0dfa","2020-05-26T20:00:00Z",119,617,111773,111773,111773,5,2,12,0,151,151
"116",20200526,"AS",0,124,NA,NA,NA,NA,NA,NA,NA,NA,"C","5/19/2020 00:00","5fffca38aa0cc8ce98ed465e19d7391ab5a2efdd","2020-05-26T20:00:00Z",0,NA,124,124,124,60,0,0,0,0,0
"117",20200526,"AZ",16783,173948,NA,818,1988,336,NA,208,NA,4297,"A+","5/25/2020 00:00","531b8893bc6a2a401f0bea90f7f135bf799eb893","2020-05-26T20:00:00Z",807,1988,190731,190731,190731,4,1,27,2727,222,2949
"118",20200526,"CA",96733,1599663,NA,4404,NA,1392,NA,NA,NA,NA,"B","5/26/2020 00:00","c10019a47267304cfdeb7b73c433186046e6dd1f","2020-05-26T20:00:00Z",3814,NA,1696396,1696396,1696396,6,19,0,50119,2175,52294
"119",20200526,"CO",24269,131742,NA,507,4128,NA,NA,NA,NA,3702,"A","5/26/2020 00:00","a39112f057bb85b6dd799ae71b776ee4efcec07c","2020-05-26T20:00:00Z",1333,4128,156011,156011,156011,8,1,9,5608,95,5703
"120",20200526,"CT",41303,184059,NA,694,12538,NA,NA,NA,NA,7127,"B","5/25/2020 20:30","51a3b08ad597fe504bc896fcbafb666bbe04dfd0","2020-05-26T20:00:00Z",3769,12538,225362,225362,225362,9,27,0,3206,430,3636
"121",20200526,"DC",8334,33721,NA,353,NA,113,NA,76,NA,1080,"A+","5/25/2020 00:00","927b3ee8fc950cd5365b2ce4f4a81dad76ec0554","2020-05-26T20:00:00Z",440,NA,42055,42055,42055,11,0,0,1143,109,1252
"122",20200526,"DE",9066,45848,NA,201,NA,NA,NA,NA,NA,4802,"B","5/25/2020 18:00","b4b92e4084cfe1777d8f32360b502d2d352ac35e","2020-05-26T20:00:00Z",335,NA,54914,54914,54914,10,3,0,917,101,1018
"123",20200526,"FL",52255,870969,901,NA,9740,NA,NA,NA,NA,NA,"A","5/26/2020 11:01","7e7018215112fc4fe2122579b4b4d0834e9b9b97","2020-05-26T20:00:00Z",2338,9740,924125,923224,923224,12,7,59,14480,509,14989
"124",20200526,"GA",43730,471215,NA,854,7547,NA,1703,NA,NA,NA,"A","5/26/2020 13:00","77590ce73032128ed12afc9274246df03533fcd4","2020-05-26T20:00:00Z",1871,7547,514945,514945,514945,13,41,72,1014,386,1400
"125",20200526,"GU",169,5515,NA,NA,NA,NA,NA,NA,NA,139,"C","5/26/2020 06:30","97447cb86b1561f81c5786ba001ca4ccedd63b13","2020-05-26T20:00:00Z",5,NA,5684,5684,5684,66,0,0,112,3,115
"126",20200526,"HI",643,49728,NA,NA,84,NA,NA,NA,NA,592,"C","5/25/2020 18:00","7d70d0affde6fefe16a6fe318f305fedc8c9d3a5","2020-05-26T20:00:00Z",17,84,50371,50371,50371,15,0,0,0,0,0
"127",20200526,"IA",17703,117301,NA,379,NA,115,NA,65,NA,9791,"A+","5/26/2020 00:00","925614dd25789c2619381058ca4a2a863ceaf569","2020-05-26T20:00:00Z",478,NA,135004,135004,135004,19,19,0,2163,126,2289
"128",20200526,"ID",2626,38780,NA,NA,225,NA,94,NA,NA,1755,"A","5/23/2020 19:00","ac526cc453dcb705d39a35b4ba083a10e544bdab","2020-05-26T20:00:00Z",79,225,41406,41406,41406,16,0,0,0,0,0
"129",20200526,"IL",113195,673599,NA,3788,NA,1035,NA,590,NA,NA,"A","5/26/2020 00:00","e7ba505f3fe73b7424d1668ac6e1537c5bb169fe","2020-05-26T20:00:00Z",4923,NA,786794,786794,786794,17,39,0,16052,1178,17230
"130",20200526,"IN",32078,198671,NA,1088,5285,365,1166,163,NA,NA,"A+","5/26/2020 14:40","872f84c6163287f2cca7b0551463a3e3a435a081","2020-05-26T20:00:00Z",2004,5285,230749,230749,230749,18,28,0,4135,363,4498
"131",20200526,"KS",9218,72181,NA,NA,800,NA,271,NA,120,493,"A+","5/25/2020 10:00","496db17c5763009a26e4aa4922494f87fcd4a4d2","2020-05-26T20:00:00Z",188,800,81399,81399,81399,20,0,0,0,0,0
"132",20200526,"KY",8571,161285,NA,484,2131,89,897,NA,NA,3102,"A","5/23/2020 17:00","8a9db655e615bfc788836fe03db7837432430b7e","2020-05-26T20:00:00Z",391,2131,169856,169856,169856,21,0,0,0,0,0
"133",20200526,"LA",38054,302972,NA,831,NA,NA,NA,103,NA,28700,"B","5/26/2020 13:00","4cbc01fe71d0527a970db7b7227c7f951ddea9fa","2020-05-26T20:00:00Z",2701,NA,341026,341026,341026,22,11,0,9883,245,10128
"134",20200526,"MA",93693,451788,NA,2108,9388,560,NA,NA,NA,NA,"A","5/26/2020 10:00","bceb8b156427d676b1127aa532e8ce4336967491","2020-05-26T20:00:00Z",6473,9388,545481,545481,545481,25,57,49,4498,422,4920
"135",20200526,"MD",47687,206800,NA,1315,8179,520,NA,NA,NA,3334,"B","5/26/2020 10:00","a020318de769f008178eb7c79ac458d2bcec2ec0","2020-05-26T20:00:00Z",2333,8179,254487,254487,254487,24,31,87,4375,535,4910
"136",20200526,"ME",2109,35450,NA,60,258,26,NA,13,NA,1318,"B","5/25/2020 23:59","de0090a0d53aade294f55aaa314573b467c46f00","2020-05-26T20:00:00Z",79,258,37559,37559,37559,23,1,1,0,35,35
"137",20200526,"MI",55104,429175,NA,953,NA,449,NA,319,NA,33168,"A+","5/26/2020 11:00","763d972e772dada03b1d94ae62aae73572d7e0e9","2020-05-26T20:00:00Z",5266,NA,484279,484279,484279,26,26,0,11196,223,11419
"138",20200526,"MN",21960,187938,NA,570,2709,258,886,NA,NA,15523,"A","5/25/2020 17:00","17ae7b8036fd496e93b479609057afb6ed65cdf6","2020-05-26T20:00:00Z",908,2709,209898,209898,209898,27,18,33,5194,645,5839
"139",20200526,"MO",12291,148007,NA,500,NA,NA,NA,82,NA,NA,"B","5/26/2020 15:00","0b1d283be8990c6ffb768ee98feb3f5afb45cc27","2020-05-26T20:00:00Z",686,NA,160298,160298,160298,29,1,0,2789,124,2913
"140",20200526,"MP",22,4918,NA,NA,NA,NA,NA,NA,NA,13,"D","5/26/2020 00:00","96db3cbe05dadb2cd860461ab5878dd1d1024006","2020-05-26T20:00:00Z",2,NA,4940,4940,4940,69,0,0,183,0,183
"141",20200526,"MS",13731,134088,NA,561,2070,134,NA,81,NA,9401,"A","5/25/2020 19:00","9697ea5085d2d420137d5adc4701ab85e8af9afc","2020-05-26T20:00:00Z",652,2070,147819,147819,147819,28,17,24,3629,273,3902
"142",20200526,"MT",479,33355,NA,2,65,NA,NA,NA,NA,441,"C","5/26/2020 00:00","cced4a8562c907cf34741692905acad2b3e09382","2020-05-26T20:00:00Z",17,65,33834,33834,33834,30,1,0,152,0,152
"143",20200526,"NC",24140,328191,NA,621,NA,NA,NA,NA,NA,14954,"A","5/26/2020 11:00","96618bfd0f14ac09fdc237904c3f3f99b683e094","2020-05-26T20:00:00Z",766,NA,352331,352331,352331,37,12,0,7465,176,7641
"144",20200526,"ND",2422,64432,NA,40,156,NA,NA,NA,NA,1701,"C","5/26/2020 13:06","003d018334f6ef4843f2e0ad1d4fec003e424cb4","2020-05-26T20:00:00Z",54,156,66854,66854,66854,38,0,2,539,-35,504
"145",20200526,"NE",12355,75687,NA,NA,NA,NA,NA,NA,NA,NA,"D","5/25/2020 19:00","30a77b619fcb73accbd93be7aff70ef5951cea2f","2020-05-26T20:00:00Z",150,NA,88042,88042,88042,31,0,0,2089,221,2310
"146",20200526,"NH",4197,58842,NA,91,420,NA,120,NA,NA,2434,"B","5/25/2020 09:00","86c3b4278923e9e9e2d93c907478225988d626cb","2020-05-26T20:00:00Z",210,420,63039,63039,63039,33,1,1,1605,48,1653
"147",20200526,"NJ",155764,480128,NA,2723,16373,786,NA,578,NA,25384,"A+","5/26/2020 13:00","ea17a949009b2fa3975a4aff06e196bb5ff02c61","2020-05-26T20:00:00Z",11191,16373,635892,635892,635892,34,47,16373,11423,672,12095
"148",20200526,"NM",7026,170335,NA,216,1264,NA,NA,NA,NA,2522,"C","5/25/2020 19:49","c04c205fda62214e5252ce431f51f7db05488ed8","2020-05-26T20:00:00Z",320,1264,177361,177361,177361,35,3,21,3797,83,3880
"149",20200526,"NV",7997,115370,NA,390,NA,91,NA,46,NA,374,"A+","5/26/2020 12:00","9848094f2bcec1a2d9c7074f32bd7fd9b52272be","2020-05-26T20:00:00Z",396,NA,123367,123367,123367,32,2,0,8518,118,8636
"150",20200526,"NY",363836,1410292,NA,4265,77637,1273,NA,1002,NA,64443,"A","5/26/2020 00:00","8aea51ece90604111c8a92b2fe633aae06e6a4b5","2020-05-26T20:00:00Z",23564,77637,1774128,1774128,1774128,36,76,112,33607,1072,34679
"151",20200526,"OH",33006,306394,NA,937,5579,351,1450,232,NA,NA,"B","5/26/2020 14:00","71e5473bee7cdc45df22fe6054452ea2e8225e8b","2020-05-26T20:00:00Z",2002,5579,339400,339400,339400,39,15,68,8537,529,9066
"152",20200526,"OK",6137,153804,NA,174,941,78,NA,NA,NA,4823,"A+","5/26/2020 00:00","1d7950b8ecf74cf4fd123b246e4e3949373f5281","2020-05-26T20:00:00Z",318,941,159941,159941,159941,40,5,3,-1139,47,-1092
"153",20200526,"OR",3967,111571,NA,149,752,40,NA,17,NA,1795,"A+","5/26/2020 03:01","8f0567d2fac28a78d6ada6255186c5f52bd3b0ee","2020-05-26T20:00:00Z",148,752,115538,115538,115538,41,0,5,1662,18,1680
"154",20200526,"PA",68637,339835,NA,1493,NA,NA,NA,334,NA,41868,"A","5/26/2020 11:15","d0f2c7287e2a9d2788b1d4f9d7b124654d7cccf2","2020-05-26T20:00:00Z",5152,NA,408472,408472,408472,42,13,0,4907,451,5358
"155",20200526,"PR",3324,NA,NA,104,NA,14,NA,4,NA,NA,"B","5/26/2020 05:53","3a12c332b72db8fbd5a5e8c2120a2da97449e0f8","2020-05-26T20:00:00Z",129,NA,3324,3324,3324,72,0,0,0,64,64
"156",20200526,"RI",14210,121153,NA,226,1613,50,NA,36,NA,1158,"A+","5/26/2020 12:00","fd914a21fa58b86f64ed5dfba2958e6567d45174","2020-05-26T20:00:00Z",634,1613,135363,135363,135363,44,26,33,2517,145,2662
"157",20200526,"SC",10416,162318,NA,433,1618,NA,NA,NA,NA,6102,"A+","5/26/2020 16:18","9ac52973514bb3aad9f1fff79a8d8fa12f79e437","2020-05-26T20:00:00Z",446,1618,172734,172734,172734,45,6,84,6476,238,6714
"158",20200526,"SD",4653,32385,NA,106,378,NA,NA,NA,NA,3528,"C","5/25/2020 18:00","ba48b2dc0bab6c781fbeb6528ddc64c7cf28b0cc","2020-05-26T20:00:00Z",50,378,37038,37038,37038,46,0,8,1688,67,1755
"159",20200526,"TN",20965,382539,NA,NA,1609,NA,NA,NA,NA,13344,"B","5/26/2020 15:00","10734ab4c174237f09d676ee847727c84367b1d2","2020-05-26T20:00:00Z",343,1609,403504,403504,403504,47,5,15,6927,358,7285
"160",20200526,"TX",56560,764673,NA,1534,NA,NA,NA,NA,NA,36375,"B","5/26/2020 17:00","43f349e06ae22b77f2ffe0c4947a8894ab439877","2020-05-26T20:00:00Z",1536,NA,821233,821233,821233,48,9,0,14990,589,15579
"161",20200526,"UT",8620,189972,NA,134,696,NA,217,NA,89,5346,"B","5/26/2020 10:19","0adcf0c6d702b42e4da80c1ac92711915ee1c5ad","2020-05-26T20:00:00Z",101,696,198592,198592,198592,49,3,4,2025,99,2124
"162",20200526,"VA",39342,227839,412,1403,6630,366,NA,190,NA,5227,"A+","5/25/2020 17:00","d94b534540e7564047027ed2d8ae9a40588e0c0f","2020-05-26T20:00:00Z",1236,6630,267593,267181,267181,51,28,109,6816,1615,8431
"163",20200526,"VI",69,1425,18,NA,NA,NA,NA,NA,NA,61,"C","5/26/2020 07:48","5a4707ab7d4d1982154379926520002de562759d","2020-05-26T20:00:00Z",6,NA,1512,1494,1494,78,0,0,82,0,82
"164",20200526,"VT",967,29456,NA,25,NA,NA,NA,NA,NA,848,"B","5/26/2020 00:00","ef4f70d85e2c5a5cf6e112f12518b40a7e41abca","2020-05-26T20:00:00Z",54,NA,30423,30423,30423,50,0,0,749,5,754
"165",20200526,"WA",20065,310533,NA,267,3290,NA,NA,51,NA,NA,"B","5/25/2020 02:59","7f360551b0ef1d3ba7c1548146604e6e39257123","2020-05-26T20:00:00Z",1070,3290,330598,330598,330598,53,9,3,3768,237,4005
"166",20200526,"WI",15863,200874,218,640,2362,135,544,NA,NA,9405,"A+","5/26/2020 00:00","ef2aa88bd44e18a7e9d27601e17a1a8bcfa48a9c","2020-05-26T20:00:00Z",517,2362,216955,216737,216737,55,3,23,7495,279,7774
"167",20200526,"WV",1854,85957,NA,35,NA,9,NA,7,NA,1180,"B","5/26/2020 17:00","8d4bb251df691de88cecacf5ba412e72e01545c2","2020-05-26T20:00:00Z",74,NA,87811,87811,87811,54,2,0,1406,80,1486
"168",20200526,"WY",850,20652,NA,14,82,NA,NA,NA,NA,607,"C","5/26/2020 00:00","605d511811246d7536128de30433c5a593bfb719","2020-05-26T20:00:00Z",13,82,21502,21502,21502,56,1,3,1101,12,1113
"169",20200525,"AK",409,44063,NA,10,NA,NA,NA,NA,NA,361,"C","5/25/2020 00:00","fa6ca45dae7dccbecf29001b7f8e4014652af677","2020-05-25T20:00:00Z",10,NA,44472,44472,44472,2,0,0,964,1,965
"170",20200525,"AL",14730,175585,NA,NA,1629,NA,543,NA,323,7951,"B","5/25/2020 00:00","48370c9c719bb9ba5e85861705dbc13216d40158","2020-05-25T20:00:00Z",562,1629,190315,190315,190315,1,11,17,4113,403,4516
"171",20200525,"AR",6029,105593,NA,92,605,NA,NA,17,111,4249,"A","5/25/2020 00:00","712d6752a2efa1e644d28c220b65694d25f9fe29","2020-05-25T20:00:00Z",117,605,111622,111622,111622,5,1,7,2934,107,3041
"172",20200525,"AS",0,124,NA,NA,NA,NA,NA,NA,NA,NA,"C","5/19/2020 00:00","82e5339de1426930a260a9e3acd24d7f30a55b03","2020-05-25T20:00:00Z",0,NA,124,124,124,60,0,0,0,0,0
"173",20200525,"AZ",16561,171221,NA,833,1961,334,NA,212,NA,4204,"A+","5/25/2020 00:00","4ad51611c5e2994947dd17e379bd77c4cfb707f3","2020-05-25T20:00:00Z",806,1961,187782,187782,187782,4,6,16,3919,222,4141
"174",20200525,"CA",94558,1549544,NA,4306,NA,1301,NA,NA,NA,NA,"B","5/25/2020 00:00","750e15df84d5983b3826fb0df9b1f236c50a4017","2020-05-25T20:00:00Z",3795,NA,1644102,1644102,1644102,6,21,0,59509,1848,61357
"175",20200525,"CO",24174,126134,NA,560,4119,NA,NA,NA,NA,3666,"A","5/25/2020 00:00","dfece7175306db9710fabb81e36dadb7f06e54c9","2020-05-25T20:00:00Z",1332,4119,150308,150308,150308,8,5,14,47,210,257
"176",20200525,"CT",40873,180853,NA,706,12538,NA,NA,NA,NA,7127,"B","5/24/2020 20:30","20989d0da1fc25af843c43fa422f321818107e1b","2020-05-25T20:00:00Z",3742,12538,221726,221726,221726,9,49,0,7185,405,7590
"177",20200525,"DC",8225,32578,NA,331,NA,106,NA,70,NA,1080,"A+","5/24/2020 00:00","dc8bfc48b56cfcdf9a2de9cbd6aea27aba174ec2","2020-05-25T20:00:00Z",440,NA,40803,40803,40803,11,13,0,-11447,259,-11188
"178",20200525,"DE",8965,44931,NA,205,NA,NA,NA,NA,NA,4693,"B","5/24/2020 18:00","79f3c62b87a3626da5da01d8f378ea7788c72a1b","2020-05-25T20:00:00Z",332,NA,53896,53896,53896,10,6,0,1870,156,2026
"179",20200525,"FL",51746,856489,988,NA,9681,NA,NA,NA,NA,NA,"A","5/25/2020 10:04","a816b7c2a87d4c07ed664db6e7edc5c6b5603fb4","2020-05-25T20:00:00Z",2331,9681,909223,908235,908235,12,15,43,36121,879,37000
"180",20200525,"GA",43344,470201,NA,892,7475,NA,1686,NA,NA,NA,"A","5/25/2020 13:00","3bb86e6c029256066c58a795f5e0b81034a0a2d7","2020-05-25T20:00:00Z",1830,7475,513545,513545,513545,13,6,36,31085,506,31591
"181",20200525,"GU",166,5403,NA,NA,NA,NA,NA,NA,NA,138,"C","5/25/2020 00:15","74196c40f73399845de475d39fce3bab5d1ac046","2020-05-25T20:00:00Z",5,NA,5569,5569,5569,66,0,0,0,0,0
"182",20200525,"HI",643,49728,NA,NA,84,NA,NA,NA,NA,591,"C","5/24/2020 18:00","de4c93ac80f338850967aed807ad24b3ab48cb25","2020-05-25T20:00:00Z",17,84,50371,50371,50371,15,0,0,799,0,799
"183",20200525,"IA",17577,115138,NA,377,NA,118,NA,66,NA,9377,"A+","5/25/2020 00:00","d9952c738d68e83a9178c539ace4a20e3c166d18","2020-05-25T20:00:00Z",459,NA,132715,132715,132715,19,5,0,4634,325,4959
"184",20200525,"ID",2626,38780,NA,NA,225,NA,94,NA,NA,1755,"A","5/23/2020 19:00","cc76b6df0ef7b4e25cfcf99bedb48c7a45779896","2020-05-25T20:00:00Z",79,225,41406,41406,41406,16,0,0,0,0,0
"185",20200525,"IL",112017,657547,NA,3762,NA,1025,NA,605,NA,NA,"A","5/25/2020 00:00","85a23a9229402532cdb4bb83f787adbf41886dcb","2020-05-25T20:00:00Z",4884,NA,769564,769564,769564,17,28,0,19930,1713,21643
"186",20200525,"IN",31715,194536,NA,1102,5285,365,1166,169,NA,NA,"A+","5/24/2020 23:59","003c0d76775f7256c0a09f8ada0ff8c2cec057ea","2020-05-25T20:00:00Z",1976,5285,226251,226251,226251,18,0,0,5111,339,5450
"187",20200525,"KS",9218,72181,NA,NA,800,NA,271,NA,120,493,"A+","5/25/2020 10:00","17fd2cfccc25b4b63f83c469a686fb614a430644","2020-05-25T20:00:00Z",188,800,81399,81399,81399,20,3,13,4705,260,4965
"188",20200525,"KY",8571,161285,NA,484,2131,89,897,NA,NA,3102,"A","5/23/2020 00:00","485b26f3c3e5f10d649287cdeb85686e566a2c6a","2020-05-25T20:00:00Z",391,2131,169856,169856,169856,21,0,0,0,0,0
"189",20200525,"LA",37809,293089,NA,847,NA,NA,NA,102,NA,28700,"B","5/25/2020 13:00","7801cf68375fdc1948504311a0a5766e0c22f2f4","2020-05-25T20:00:00Z",2690,NA,330898,330898,330898,22,0,0,14222,640,14862
"190",20200525,"MA",93271,447290,NA,2132,9339,576,NA,NA,NA,NA,"A","5/25/2020 10:00","db95c8a890c23bc9c1b179f4276f131340a2799b","2020-05-25T20:00:00Z",6416,9339,540561,540561,540561,25,44,31,7592,596,8188
"191",20200525,"MD",47152,202425,NA,1279,8092,517,NA,NA,NA,3329,"B","5/25/2020 10:00","05183bfc72f536e6265520d627620ecbf508447b","2020-05-25T20:00:00Z",2302,8092,249577,249577,249577,24,25,153,8376,839,9215
"192",20200525,"ME",2074,35450,NA,59,257,27,NA,13,NA,1290,"B","5/25/2020 11:30","1e6a7353ae7e7e367cc64e56f811bca115796384","2020-05-25T20:00:00Z",78,257,37524,37524,37524,23,0,5,0,19,19
"193",20200525,"MI",54881,417979,NA,953,NA,449,NA,319,NA,33168,"A+","5/25/2020 11:00","72067928fe58f0b71c5f4b28ac2473af6cb8c163","2020-05-25T20:00:00Z",5240,NA,472860,472860,472860,26,12,0,21426,202,21628
"194",20200525,"MN",21315,182744,NA,605,2676,248,869,NA,NA,14816,"A","5/24/2020 17:00","71ce4f0950cfe74ebaf23740fde80ee41eebb5b0","2020-05-25T20:00:00Z",890,2676,204059,204059,204059,27,12,88,5353,742,6095
"195",20200525,"MO",12167,145218,NA,729,NA,NA,NA,93,NA,NA,"B","5/25/2020 15:00","aa856b89a50c14bf456df2fb49e223426f73d4e4","2020-05-25T20:00:00Z",685,NA,157385,157385,157385,29,4,0,5587,179,5766
"196",20200525,"MP",22,4735,NA,NA,NA,NA,NA,NA,NA,13,"D","5/24/2020 00:07","503910ccf4aaf40572c96be4af623d2fb99764c5","2020-05-25T20:00:00Z",2,NA,4757,4757,4757,69,0,0,0,0,0
"197",20200525,"MS",13458,130459,NA,566,2046,152,NA,94,NA,9401,"A","5/24/2020 19:00","8002c1ec93f8c12f3a179f2900f3433785ca2017","2020-05-25T20:00:00Z",635,2046,143917,143917,143917,28,10,23,5809,206,6015
"198",20200525,"MT",479,33203,NA,3,65,NA,NA,NA,NA,441,"C","5/25/2020 00:00","dc90672e487753268ac9f5f72315b8bb8173f702","2020-05-25T20:00:00Z",16,65,33682,33682,33682,30,0,0,301,0,301
"199",20200525,"NC",23964,320726,NA,627,NA,NA,NA,NA,NA,14954,"A","5/25/2020 10:55","a6daf052399bf5d136601e9a451c64f00582e750","2020-05-25T20:00:00Z",754,NA,344690,344690,344690,37,10,0,7292,742,8034
"200",20200525,"ND",2457,63893,NA,41,154,NA,NA,NA,NA,1551,"C","5/24/2020 13:00","83bdfa768a988dfd5de5b9f95321c2b812d9cf60","2020-05-25T20:00:00Z",54,154,66350,66350,66350,38,1,2,823,39,862
"201",20200525,"NE",12134,73598,NA,NA,NA,NA,NA,NA,NA,NA,"D","5/24/2020 19:55","7955da6759a1ef6f41738f615c23d145ecc819f1","2020-05-25T20:00:00Z",150,NA,85732,85732,85732,31,3,0,2382,145,2527
"202",20200525,"NH",4149,57237,1714,92,419,NA,120,NA,NA,2204,"B","5/24/2020 09:00","f083c984443c2e848be512a087efa54f83cdbf39","2020-05-25T20:00:00Z",209,419,63100,61386,61386,33,1,0,1787,60,1847
"203",20200525,"NJ",155092,468705,NA,2755,NA,719,NA,540,NA,25253,"A+","5/25/2020 13:00","dc7bcd00a0c9c44ed90871902524295370fa9b7c","2020-05-25T20:00:00Z",11144,NA,623797,623797,623797,34,11,0,19052,938,19990
"204",20200525,"NM",6943,166538,NA,213,1243,NA,NA,NA,NA,2464,"C","5/24/2020 18:03","04c3e5aef2dc179a029153be66fcae6c5bfb5383","2020-05-25T20:00:00Z",317,1243,173481,173481,173481,35,9,104,4214,148,4362
"205",20200525,"NV",7879,106852,NA,380,NA,91,NA,45,NA,359,"A+","5/25/2020 10:25","911968ca2cabe23f9a4275423677333e9093f8c6","2020-05-25T20:00:00Z",394,NA,114731,114731,114731,32,2,0,4341,109,4450
"206",20200525,"NY",362764,1376685,NA,4348,77525,1366,NA,1058,NA,64280,"A","5/25/2020 00:00","f5abe5b7a5a69b77910f151653b6145277aede01","2020-05-25T20:00:00Z",23488,77525,1739449,1739449,1739449,36,97,230,38374,1249,39623
"207",20200525,"OH",32477,297857,NA,872,5511,323,1443,211,NA,NA,"B","5/25/2020 14:00","6f1592d87ad894f1d9ab399ebe2916b3df0b88a9","2020-05-25T20:00:00Z",1987,5511,330334,330334,330334,39,18,35,5215,566,5781
"208",20200525,"OK",6090,154943,NA,NA,938,78,NA,NA,NA,4714,"A+","5/25/2020 12:30","dd7fed064567f37f0fadcde4a1295c29a9ea696d","2020-05-25T20:00:00Z",313,938,161033,161033,161033,40,2,0,0,53,53
"209",20200525,"OR",3949,109909,NA,125,747,35,NA,23,NA,1376,"A+","5/25/2020 03:01","51b844ee62e6d9cb5dfeda803d0264a9d44ee740","2020-05-25T20:00:00Z",148,747,113858,113858,113858,41,0,5,1641,22,1663
"210",20200525,"PA",68186,334928,NA,1628,NA,NA,NA,324,NA,40911,"A","5/25/2020 00:00","a1f2f03dd0b90ae8d5efe8f9c4e8a4f6fda8ae42","2020-05-25T20:00:00Z",5139,NA,403114,403114,403114,42,15,0,6546,473,7019
"211",20200525,"PR",3260,NA,NA,112,NA,16,NA,8,NA,NA,"B","5/25/2020 06:30","39859dc9d880c7562c6705fb892d376fc87e7105","2020-05-25T20:00:00Z",129,NA,3260,3260,3260,72,2,0,0,71,71
"212",20200525,"RI",14065,118636,NA,240,1580,49,NA,32,NA,1119,"A+","5/24/2020 12:00","7e54c2a1b730a35ae9266055c8936010dd5c7552","2020-05-25T20:00:00Z",608,1580,132701,132701,132701,44,0,0,0,0,0
"213",20200525,"SC",10178,155842,NA,407,1534,NA,NA,NA,NA,6063,"A+","5/25/2020 15:30","bf7e88f8bd240610953314ccd4dd5bdce7934658","2020-05-25T20:00:00Z",440,1534,166020,166020,166020,45,5,0,1991,82,2073
"214",20200525,"SD",4586,30697,NA,99,370,NA,NA,NA,NA,3415,"C","5/24/2020 18:00","38d86f2481675c11ed5a84fbd01cdae77e145e06","2020-05-25T20:00:00Z",50,370,35283,35283,35283,46,0,6,355,23,378
"215",20200525,"TN",20607,375612,NA,NA,1594,NA,NA,NA,NA,13073,"B","5/25/2020 15:00","63c91331716454aec5ed6ec223dad31e60b39161","2020-05-25T20:00:00Z",338,1594,396219,396219,396219,47,2,11,12181,462,12643
"216",20200525,"TX",55971,749683,NA,1511,NA,NA,NA,NA,NA,35292,"B","5/25/2020 04:30","67090fbf1dbc9080e64c0543f0b674e3b55172a7","2020-05-25T20:00:00Z",1527,NA,805654,805654,805654,48,21,0,41486,623,42109
"217",20200525,"UT",8521,187947,NA,131,692,NA,215,NA,88,5218,"B","5/25/2020 10:15","8349bfd5604977dbad7c0ecc346b41c90ef261b4","2020-05-25T20:00:00Z",98,692,196468,196468,196468,49,1,4,1906,129,2035
"218",20200525,"VA",37727,221023,414,1376,6521,349,NA,182,NA,5145,"A+","5/24/2020 17:00","3ef574d301323f17e293e26b47bcb8e251ab264e","2020-05-25T20:00:00Z",1208,6521,259164,258750,258750,51,37,68,13182,1483,14665
"219",20200525,"VI",69,1343,45,NA,NA,NA,NA,NA,NA,61,"C","5/22/2020 07:29","9316a618c42d41faec00d1120091a05c4f53e0b5","2020-05-25T20:00:00Z",6,NA,1457,1412,1412,78,0,0,0,0,0
"220",20200525,"VT",962,28707,NA,19,NA,NA,NA,NA,NA,843,"B","5/25/2020 00:00","93bff04beece345345d98ce9540cb8eb99c5f612","2020-05-25T20:00:00Z",54,NA,29669,29669,29669,50,0,0,1073,6,1079
"221",20200525,"WA",19828,306765,NA,207,3287,NA,NA,47,NA,NA,"B","5/24/2020 02:59","7698fd4c2e3c934eba3d7d022c9711d971cdefdd","2020-05-25T20:00:00Z",1061,3287,326593,326593,326593,53,6,31,10074,243,10317
"222",20200525,"WI",15584,193379,207,606,2339,126,543,NA,NA,9207,"A+","5/25/2020 00:00","6b92e456b083c43f7b4bde56072e36714c18f42a","2020-05-25T20:00:00Z",514,2339,209170,208963,208963,55,4,24,7173,307,7480
"223",20200525,"WV",1774,84551,NA,36,NA,13,NA,7,NA,1135,"B","5/25/2020 10:00","f489b815d4c4aeb3d1af45fb571cb2c00695d1a8","2020-05-25T20:00:00Z",72,NA,86325,86325,86325,54,0,0,616,15,631
"224",20200525,"WY",838,19551,NA,10,79,NA,NA,NA,NA,575,"C","5/24/2020 00:00","c71a4752d890f2cb0e7e27a45f374bcca75c1268","2020-05-25T20:00:00Z",12,79,20389,20389,20389,56,0,1,330,25,355
"225",20200524,"AK",408,43099,NA,10,NA,NA,NA,NA,NA,358,"C","5/24/2020 00:00","e2bf82610e6160d238c8d4885a1613e574c8c78e","2020-05-24T20:00:00Z",10,NA,43507,43507,43507,2,0,0,1156,0,1156
"226",20200524,"AL",14327,171472,NA,NA,1612,NA,537,NA,320,7951,"B","5/24/2020 00:00","f24e300d8ade0e897be7b30508ab3eb9770c6269","2020-05-24T20:00:00Z",551,1612,185799,185799,185799,1,5,23,2734,389,3123
"227",20200524,"AR",5922,102659,NA,86,598,NA,NA,17,111,4148,"A","5/24/2020 00:00","c1d90ab3a24aa7d620cfc0a574a67ad29ec6e3e9","2020-05-24T20:00:00Z",116,598,108581,108581,108581,5,3,8,5224,310,5534
"228",20200524,"AS",0,124,NA,NA,NA,NA,NA,NA,NA,NA,"C","5/19/2020 00:00","336f9f200e3019162e3a3b91f2a05c29a15f2a16","2020-05-24T20:00:00Z",0,NA,124,124,124,60,0,0,0,0,0
"229",20200524,"AZ",16339,167302,NA,804,1945,322,NA,201,NA,4132,"A+","5/24/2020 00:00","e89c395bcd3de8e0e9dcf896489649497155c576","2020-05-24T20:00:00Z",800,1945,183641,183641,183641,4,1,15,2902,300,3202
"230",20200524,"CA",92710,1490035,NA,4300,NA,1315,NA,NA,NA,NA,"B","5/24/2020 00:00","63d7d8536ac6b7ca394af4d2fc4bdc016ccc8109","2020-05-24T20:00:00Z",3774,NA,1582745,1582745,1582745,6,66,0,65360,2079,67439
"231",20200524,"CO",23964,126087,NA,538,4105,NA,NA,NA,NA,3640,"A","5/23/2020 00:00","ed681562a81a98ca1efd9dcb5920b8bd5c5a9348","2020-05-24T20:00:00Z",1327,4105,150051,150051,150051,8,3,23,4622,477,5099
"232",20200524,"CT",40468,173668,NA,701,12538,NA,NA,NA,NA,7127,"B","5/23/2020 20:30","78fa79e41aa82eed11a77b4365f95d8b12d833f6","2020-05-24T20:00:00Z",3693,12538,214136,214136,214136,9,18,0,5323,446,5769
"233",20200524,"DC",7966,44025,NA,324,NA,110,NA,73,NA,1075,"A+","5/22/2020 00:00","799b032984eb36386cd59a7cdff555755bbc0a35","2020-05-24T20:00:00Z",427,NA,51991,51991,51991,11,0,0,0,0,0
"234",20200524,"DE",8809,43061,NA,211,NA,NA,NA,NA,NA,4598,"B","5/23/2020 18:00","6ed676e46ab479bc6fe2286a484f92a646d7dac9","2020-05-24T20:00:00Z",326,NA,51870,51870,51870,10,2,0,1217,119,1336
"235",20200524,"FL",50867,820368,1337,NA,9638,NA,NA,NA,NA,NA,"A","5/24/2020 10:04","9d7af86768f8fae66405fd7406c66fab407e0c06","2020-05-24T20:00:00Z",2316,9638,872572,871235,871235,12,4,71,14058,740,14798
"236",20200524,"GA",42838,439116,NA,848,7439,NA,1683,NA,NA,NA,"A","5/24/2020 13:00","abb9f94260bfa7519aa98b5ba1d1e0ed92c14212","2020-05-24T20:00:00Z",1824,7439,481954,481954,481954,13,13,28,27711,706,28417
"237",20200524,"GU",166,5403,NA,NA,NA,NA,NA,NA,NA,138,"C","5/23/2020 18:00","f99074f025da74ceec05f7db69849b349642de73","2020-05-24T20:00:00Z",5,NA,5569,5569,5569,66,0,0,209,1,210
"238",20200524,"HI",643,48929,NA,NA,84,NA,NA,NA,NA,589,"C","5/23/2020 18:00","8a8308b3648b52ffc97ae2a41a1be47add6bc53d","2020-05-24T20:00:00Z",17,84,49572,49572,49572,15,0,0,750,1,751
"239",20200524,"IA",17252,110504,NA,363,NA,114,NA,61,NA,9318,"A+","5/24/2020 00:00","0574d5158aab79247b742159f7b5fa08d9310206","2020-05-24T20:00:00Z",454,NA,127756,127756,127756,19,10,0,3456,359,3815
"240",20200524,"ID",2626,38780,NA,NA,225,NA,94,NA,NA,1755,"A","5/23/2020 19:00","e01a59902232cb8b6b186597b03b9a211fb29c36","2020-05-24T20:00:00Z",79,225,41406,41406,41406,16,0,0,766,31,797
"241",20200524,"IL",110304,637617,NA,3667,NA,1007,NA,632,NA,NA,"A","5/24/2020 00:00","85e08efb7576f429016d4cc2c21d8e298c869a6e","2020-05-24T20:00:00Z",4856,NA,747921,747921,747921,17,66,0,23166,2508,25674
"242",20200524,"IN",31376,189425,NA,1112,5285,396,1166,173,NA,NA,"A+","5/23/2020 23:59","ed5ea3fa0a667435cb2753ff6debdb9dc04fcbcc","2020-05-24T20:00:00Z",1976,5285,220801,220801,220801,18,33,0,5393,475,5868
"243",20200524,"KS",8958,67476,NA,NA,787,NA,269,NA,120,485,"A+","5/22/2020 10:00","184a858adfd67bb28348ffa844637c46bfeb9d2b","2020-05-24T20:00:00Z",185,787,76434,76434,76434,20,0,0,0,0,0
"244",20200524,"KY",8571,161285,NA,484,2131,89,897,NA,NA,3102,"A","5/23/2020 00:00","4ce8e430d4a9d05f4373ccc6f6eedfab7bc2379e","2020-05-24T20:00:00Z",391,2131,169856,169856,169856,21,0,55,-1748,145,-1603
"245",20200524,"LA",37169,278867,NA,813,NA,NA,NA,102,NA,26249,"B","5/24/2020 13:00","74162acfc6620ccecde3c53897ec22767c0d90b6","2020-05-24T20:00:00Z",2690,NA,316036,316036,316036,22,22,0,1460,129,1589
"246",20200524,"MA",92675,439698,NA,2169,9308,558,NA,NA,NA,NA,"A","5/24/2020 10:00","3634f229b8aba3cf304aa5b3083fa20d8ae5e1a1","2020-05-24T20:00:00Z",6372,9308,532373,532373,532373,25,68,48,10374,1013,11387
"247",20200524,"MD",46313,194049,NA,1290,7939,503,NA,NA,NA,3319,"B","5/24/2020 10:00","1b14a599b54cdecbf7204bd1f1fc3dc4867f6faf","2020-05-24T20:00:00Z",2277,7939,240362,240362,240362,24,34,114,7217,818,8035
"248",20200524,"ME",2055,35450,NA,59,252,27,NA,13,NA,1263,"B","5/24/2020 13:00","6deedaf1509bf086ac9c603b464a6bf836c8f119","2020-05-24T20:00:00Z",78,252,37505,37505,37505,23,1,9,0,42,42
"249",20200524,"MI",54679,396553,NA,953,NA,449,NA,319,NA,33168,"A+","5/24/2020 11:00","4b13e73a7fd1f79ef1c6f6013ac1bb54eaf712c1","2020-05-24T20:00:00Z",5228,NA,451232,451232,451232,26,5,0,0,314,314
"250",20200524,"MN",20573,177391,NA,553,2588,207,841,NA,NA,14115,"A","5/23/2020 17:00","4fc1803ba15b839a2efdfb2d0d97de97290fbda6","2020-05-24T20:00:00Z",878,2588,197964,197964,197964,27,17,54,7743,728,8471
"251",20200524,"MO",11988,139631,NA,742,NA,NA,NA,94,NA,NA,"B","5/24/2020 15:00","978b7c851e1f51e5ef95ae425deee1e5869f0c0f","2020-05-24T20:00:00Z",681,NA,151619,151619,151619,29,5,0,3079,236,3315
"252",20200524,"MP",22,4735,NA,NA,NA,NA,NA,NA,NA,13,"D","5/24/2020 00:00","b5e47f613bfdd301b3b2ce15f3b2811081a044a6","2020-05-24T20:00:00Z",2,NA,4757,4757,4757,69,0,0,439,0,439
"253",20200524,"MS",13252,124650,NA,512,2023,150,NA,73,NA,7681,"A","5/23/2020 19:00","922b39078ce169d4e4abcdea367b4f4c9d625bf5","2020-05-24T20:00:00Z",625,2023,137902,137902,137902,28,9,27,3435,247,3682
"254",20200524,"MT",479,32902,NA,3,65,NA,NA,NA,NA,441,"C","5/24/2020 11:58","316d0f751c9a728314a9746cf9d33a9c47161838","2020-05-24T20:00:00Z",16,65,33381,33381,33381,30,0,0,729,0,729
"255",20200524,"NC",23222,313434,NA,587,NA,NA,NA,NA,NA,11637,"A","5/24/2020 11:15","92f0e0c193ac611a28de8c77a2baa19a93e13c1e","2020-05-24T20:00:00Z",744,NA,336656,336656,336656,37,7,0,6577,497,7074
"256",20200524,"ND",2418,63070,NA,40,152,NA,NA,NA,NA,1496,"C","5/24/2020 13:00","fc92eee02ceaa8742316a23b15def169a0fd961b","2020-05-24T20:00:00Z",53,152,65488,65488,65488,38,1,2,1287,53,1340
"257",20200524,"NE",11989,71216,NA,NA,NA,NA,NA,NA,NA,NA,"D","5/23/2020 16:15","3d304501087f8af887f6a53bfd2a3b4fb18d109f","2020-05-24T20:00:00Z",147,NA,83205,83205,83205,31,0,0,2896,327,3223
"258",20200524,"NH",4089,55450,1844,93,419,NA,120,NA,NA,2197,"B","5/23/2020 09:00","688b5b39f196a5198a5c19afa4512df2c76bc27b","2020-05-24T20:00:00Z",208,419,61383,59539,59539,33,0,0,0,0,0
"259",20200524,"NJ",154154,449653,NA,2857,NA,760,NA,639,NA,25040,"A+","5/24/2020 13:00","dab3bba187896cc21a3e3731fcb01010492ff4c9","2020-05-24T20:00:00Z",11133,NA,603807,603807,603807,34,52,0,24022,1050,25072
"260",20200524,"NM",6795,162324,NA,208,1139,NA,NA,NA,NA,2357,"C","5/23/2020 20:01","bc484db314ee53516eaa39769b377101190032dc","2020-05-24T20:00:00Z",308,1139,169119,169119,169119,35,6,0,10566,170,10736
"261",20200524,"NV",7770,102511,NA,373,NA,92,NA,51,NA,359,"A+","5/24/2020 10:00","dc26d03d6d7b7d439b33a199e0f9b11e09ee953f","2020-05-24T20:00:00Z",392,NA,110281,110281,110281,32,4,0,3160,74,3234
"262",20200524,"NY",361515,1338311,NA,4393,77295,1406,NA,1067,NA,64080,"A","5/24/2020 00:00","0721a0530e6e28aae34941837949d2a83acf4048","2020-05-24T20:00:00Z",23391,77295,1699826,1699826,1699826,36,109,261,46176,1589,47765
"263",20200524,"OH",31911,292642,NA,864,5476,317,1438,205,NA,NA,"B","5/23/2020 14:00","dce927ecd0c4dbc2e509f0962a04e384b6d6f70a","2020-05-24T20:00:00Z",1969,5476,324553,324553,324553,39,13,39,7556,503,8059
"264",20200524,"OK",6037,154943,NA,174,938,78,NA,NA,NA,4688,"A+","5/23/2020 00:00","f8ff278f4ad71a98d3a9209ce5ea5a993bf7b83a","2020-05-24T20:00:00Z",311,938,160980,160980,160980,40,0,12,0,77,77
"265",20200524,"OR",3927,108268,NA,117,742,35,NA,18,NA,1376,"A+","5/24/2020 03:01","cfeed309f76316d1b570d7fcb43be1a71340b8d3","2020-05-24T20:00:00Z",148,742,112195,112195,112195,41,1,2,1949,39,1988
"266",20200524,"PA",67713,328382,NA,1533,NA,NA,NA,336,NA,40627,"A","5/24/2020 12:00","7b2af0564835c7314d49778217ce64e718511a41","2020-05-24T20:00:00Z",5124,NA,396095,396095,396095,42,28,0,6913,730,7643
"267",20200524,"PR",3189,NA,NA,106,NA,13,NA,7,NA,NA,"B","5/24/2020 06:30","edb59ece31f024c6892855609e06d22adb506cef","2020-05-24T20:00:00Z",127,NA,3189,3189,3189,72,0,0,0,89,89
"268",20200524,"RI",14065,118636,NA,240,1580,49,NA,32,NA,1119,"A+","5/24/2020 12:00","24e4daa32d6d9fddc520bc75853c0af239623f6b","2020-05-24T20:00:00Z",608,1580,132701,132701,132701,44,11,23,2456,113,2569
"269",20200524,"SC",10096,153851,NA,461,1534,NA,NA,NA,NA,5743,"A+","5/24/2020 15:33","785c930d599d80d5d1b8b255d071e3e02f672ba4","2020-05-24T20:00:00Z",435,1534,163947,163947,163947,45,10,0,4836,201,5037
"270",20200524,"SD",4563,30342,NA,85,364,NA,NA,NA,NA,3371,"C","5/23/2020 18:00","b8ba4e597a5fd8265243d9ad7171d46e087b51f8","2020-05-24T20:00:00Z",50,364,34905,34905,34905,46,0,6,1282,95,1377
"271",20200524,"TN",20145,363431,NA,NA,1583,NA,NA,NA,NA,12837,"B","5/24/2020 15:00","5dbf21da39cf6934d51e148e4bda654accf786ef","2020-05-24T20:00:00Z",336,1583,383576,383576,383576,47,7,10,9462,356,9818
"272",20200524,"TX",55348,708197,NA,1572,NA,NA,NA,NA,NA,33385,"B","5/23/2020 04:45","1d657876d60d0d5bed266fa3c0afedeaf07ce41e","2020-05-24T20:00:00Z",1506,NA,763545,763545,763545,48,0,0,0,839,839
"273",20200524,"UT",8392,186041,NA,128,688,NA,215,NA,88,5081,"B","5/24/2020 10:39","c0789037031d9e5a1837ae58555e59e66c84bf52","2020-05-24T20:00:00Z",97,688,194433,194433,194433,49,0,-365,3522,132,3654
"274",20200524,"VA",36244,207841,411,1351,6453,354,NA,192,NA,5102,"A+","5/23/2020 17:00","d8b2e1421c44f15457fa92306a4bd36a32c70ade","2020-05-24T20:00:00Z",1171,6453,244496,244085,244085,51,12,22,11120,495,11615
"275",20200524,"VI",69,1343,45,NA,NA,NA,NA,NA,NA,61,"C","5/22/2020 07:29","bb8db82e25b7634d42663790106f303814632cb4","2020-05-24T20:00:00Z",6,NA,1457,1412,1412,78,0,0,0,0,0
"276",20200524,"VT",956,27634,NA,25,NA,NA,NA,NA,NA,839,"B","5/24/2020 00:00","1562490ecff53fb2f9b4bc99dddbced421c0d06a","2020-05-24T20:00:00Z",54,NA,28590,28590,28590,50,0,0,1164,2,1166
"277",20200524,"WA",19585,296691,NA,313,3256,NA,NA,74,NA,NA,"B","5/23/2020 02:59","d611d64f6f8d7516e81f04196f5c4bdbb65833bf","2020-05-24T20:00:00Z",1055,3256,316276,316276,316276,53,5,26,7598,320,7918
"278",20200524,"WI",15277,186206,223,611,2315,128,541,NA,NA,8999,"A+","5/24/2020 00:00","449a418f0e720ec0472d935ced071563ca9e73b2","2020-05-24T20:00:00Z",510,2315,201706,201483,201483,55,3,23,6877,400,7277
"279",20200524,"WV",1759,83935,NA,23,NA,8,NA,4,NA,1121,"B","5/24/2020 10:00","e407485ec18b9f45ab22b0e1c7251017019ba062","2020-05-24T20:00:00Z",72,NA,85694,85694,85694,54,0,0,1908,42,1950
"280",20200524,"WY",813,19221,NA,10,78,NA,NA,NA,NA,556,"C","5/23/2020 00:00","4b9ec071fe4834598c65410766c28cdab06af96a","2020-05-24T20:00:00Z",12,78,20034,20034,20034,56,0,1,0,0,0
"281",20200523,"AK",408,41943,NA,10,NA,NA,NA,NA,NA,358,"C","5/23/2020 15:00","078f2242d7eae1fdde12af6639e71547e42a2eec","2020-05-23T20:00:00Z",10,NA,42351,42351,42351,2,0,0,901,4,905
"282",20200523,"AL",13938,168738,NA,NA,1589,NA,538,NA,319,7951,"B","5/23/2020 00:00","50ba341d7ff0c6f5414394fd09c29fa6c6328ca0","2020-05-23T20:00:00Z",546,1589,182676,182676,182676,1,9,28,4533,375,4908
"283",20200523,"AR",5612,97435,NA,81,590,NA,NA,14,111,4029,"A","5/23/2020 00:00","5566f1f5b3f3a62fc217112558dbe275215a8421","2020-05-23T20:00:00Z",113,590,103047,103047,103047,5,0,6,0,0,0
"284",20200523,"AS",0,124,NA,NA,NA,NA,NA,NA,NA,NA,"C","5/19/2020 00:00","8d08a3458f89ee855b1b2f2b98c478918b297f05","2020-05-23T20:00:00Z",0,NA,124,124,124,60,0,0,0,0,0
"285",20200523,"AZ",16039,164400,NA,784,1930,309,NA,193,NA,4033,"A+","5/23/2020 00:00","9050d1fa58c603a06de22fdf2b38b6b58828e2ea","2020-05-23T20:00:00Z",799,1930,180439,180439,180439,4,24,51,4005,431,4436
"286",20200523,"CA",90631,1424675,NA,4342,NA,1312,NA,NA,NA,NA,"B","5/23/2020 00:00","20128faf3570bf009677bb6b6ddff9ec44ed2ad1","2020-05-23T20:00:00Z",3708,NA,1515306,1515306,1515306,6,78,0,46346,2187,48533
"287",20200523,"CO",23487,121465,NA,571,4082,NA,NA,NA,NA,3612,"A","5/22/2020 00:00","627601033d644542b3621568d402e972c66d2676","2020-05-23T20:00:00Z",1324,4082,144952,144952,144952,8,14,45,2431,296,2727
"288",20200523,"CT",40022,168345,NA,724,12538,NA,NA,NA,NA,7127,"B","5/22/2020 20:30","a2fe0cfc9da997ae224c3f3f8278732d599f50fb","2020-05-23T20:00:00Z",3675,12538,208367,208367,208367,9,38,0,5657,382,6039
"289",20200523,"DC",7966,44025,NA,324,NA,110,NA,73,NA,1075,"A+","5/22/2020 00:00","b8f19e27165d22981b8e12ef87be7d3a43007a2b","2020-05-23T20:00:00Z",427,NA,51991,51991,51991,11,9,0,8925,73,8998
"290",20200523,"DE",8690,41844,NA,210,NA,NA,NA,NA,NA,4454,"B","5/22/2020 18:00","9543176754e81fc65a95d1f441d147c4a625b198","2020-05-23T20:00:00Z",324,NA,50534,50534,50534,10,2,0,1387,161,1548
"291",20200523,"FL",50127,806310,1563,NA,9567,NA,NA,NA,NA,NA,"A","5/23/2020 10:00","a74764bb31492ec0dcdd04fee54ff5d57e762a3f","2020-05-23T20:00:00Z",2312,9567,858000,856437,856437,12,44,195,20265,676,20941
"292",20200523,"GA",42132,411405,NA,848,7411,NA,1678,NA,NA,NA,"A","5/23/2020 13:00","4b3c4e997a08a6eb46114c729d10613145f5faea","2020-05-23T20:00:00Z",1811,7411,453537,453537,453537,13,26,98,25374,914,26288
"293",20200523,"GU",165,5194,NA,NA,NA,NA,NA,NA,NA,134,"C","5/23/2020 02:35","96763fc7826ec9192831d3ac2319ffd938f264bb","2020-05-23T20:00:00Z",5,NA,5359,5359,5359,66,0,0,80,0,80
"294",20200523,"HI",642,48179,NA,NA,84,NA,NA,NA,NA,585,"C","5/22/2020 18:00","7accc8906c1c6a0e43b03463e133b99801d717bc","2020-05-23T20:00:00Z",17,84,48821,48821,48821,15,0,1,841,-5,836
"295",20200523,"IA",16893,107048,NA,362,NA,111,NA,70,NA,9254,"A+","5/23/2020 00:00","1835371485e509f34148b243ec5026840e5f7af6","2020-05-23T20:00:00Z",444,NA,123941,123941,123941,19,19,0,3302,389,3691
"296",20200523,"ID",2595,38014,NA,NA,225,NA,94,NA,NA,1735,"A","5/22/2020 19:00","1bc200ffd29adba1bb7907c86f8b74662bec59b3","2020-05-23T20:00:00Z",79,225,40609,40609,40609,16,2,2,953,61,1014
"297",20200523,"IL",107796,614451,NA,3753,NA,1027,NA,607,NA,NA,"A","5/22/2020 00:00","5053de635ec1f8f012dd6fd49232926f88b357c1","2020-05-23T20:00:00Z",4790,NA,722247,722247,722247,17,75,0,22762,2352,25114
"298",20200523,"IN",30901,184032,NA,1138,5285,403,1166,173,NA,NA,"A+","5/22/2020 23:59","df7f2d61912ee6e616b2d90ecc31ba13a21593c8","2020-05-23T20:00:00Z",1943,5285,214933,214933,214933,18,2,0,5880,492,6372
"299",20200523,"KS",8958,67476,NA,NA,787,NA,269,NA,120,485,"A+","5/22/2020 10:00","b8a21019d4ab13c13e4964c1dfd97c4794464c05","2020-05-23T20:00:00Z",185,787,76434,76434,76434,20,0,0,0,0,0
"300",20200523,"KY",8426,163033,NA,477,2076,90,889,NA,NA,3069,"A","5/22/2020 17:00","76763da0a3066c21caddb7758055945b1e595495","2020-05-23T20:00:00Z",391,2076,171459,171459,171459,21,5,35,5079,140,5219
"301",20200523,"LA",37040,277407,NA,836,NA,NA,NA,112,NA,26249,"B","5/23/2020 13:00","8c7fd09006ff7c90f1f2a2b3fe452294884ba3f4","2020-05-23T20:00:00Z",2668,NA,314447,314447,314447,22,0,0,2524,115,2639
"302",20200523,"MA",91662,429324,NA,2237,9260,610,NA,NA,NA,NA,"A","5/23/2020 10:00","5923343ed237cf3138824774e54f72b1a9de9172","2020-05-23T20:00:00Z",6304,9260,520986,520986,520986,25,76,98,8569,773,9342
"303",20200523,"MD",45495,186832,NA,1320,7825,524,NA,NA,NA,3283,"B","5/23/2020 10:00","2d76e5b39b1c8c1bb8aa4e7d394cf57a751dd663","2020-05-23T20:00:00Z",2243,7825,232327,232327,232327,24,36,191,3354,1071,4425
"304",20200523,"ME",2013,35450,NA,50,243,26,NA,11,NA,1232,"B","5/23/2020 11:00","d99dcee5d5d9d6ead66cf84f8742333b2e6c98d0","2020-05-23T20:00:00Z",77,243,37463,37463,37463,23,2,3,0,65,65
"305",20200523,"MI",54365,396553,NA,953,NA,449,NA,319,NA,33168,"A+","5/22/2020 11:00","6c1f72fd08fba7a9291de04925ab6e894bd326a3","2020-05-23T20:00:00Z",5223,NA,450918,450918,450918,26,65,0,-21318,452,-20866
"306",20200523,"MN",19845,169648,NA,568,2534,215,832,NA,NA,13485,"A","5/22/2020 17:00","dc42441d818b24a6162f1696bc6033a463b798dc","2020-05-23T20:00:00Z",861,2534,189493,189493,189493,27,10,102,7682,840,8522
"307",20200523,"MO",11752,136552,NA,742,NA,NA,NA,94,NA,NA,"B","5/23/2020 15:00","dbf12fe0ca801ae8cc181d71eb96f0e838ce82e8","2020-05-23T20:00:00Z",676,NA,148304,148304,148304,29,5,0,-24836,194,-24642
"308",20200523,"MP",22,4296,NA,NA,NA,NA,NA,NA,NA,13,"D","5/22/2020 00:00","8d2310f319a00c34376f2e842cd8da24d77b3e83","2020-05-23T20:00:00Z",2,NA,4318,4318,4318,69,0,0,0,0,0
"309",20200523,"MS",13005,121215,NA,590,1996,154,NA,93,NA,7681,"A","5/22/2020 19:00","4930dfca82770985239d56c771c15bdab045314e","2020-05-23T20:00:00Z",616,1996,134220,134220,134220,28,20,30,-4134,381,-3753
"310",20200523,"MT",479,32173,NA,3,65,NA,NA,NA,NA,441,"C","5/23/2020 00:00","7f0f5f57cd383c3604e88ed71822b59ed35152f9","2020-05-23T20:00:00Z",16,65,32652,32652,32652,30,0,0,795,0,795
"311",20200523,"NC",22725,306857,NA,589,NA,NA,NA,NA,NA,11637,"A","5/23/2020 11:33","1413424793b38579a0212610a786d19df0d781ed","2020-05-23T20:00:00Z",737,NA,329582,329582,329582,37,9,0,25251,1107,26358
"312",20200523,"ND",2365,61783,NA,39,150,NA,NA,NA,NA,1451,"C","5/23/2020 13:00","6c63814efb82b749ad368459ec216f053e2e59e7","2020-05-23T20:00:00Z",52,150,64148,64148,64148,38,0,3,1270,48,1318
"313",20200523,"NE",11662,68320,NA,NA,NA,NA,NA,NA,NA,NA,"D","5/22/2020 19:45","f7ea29edcd357f85a64f085ad128e61b435c6930","2020-05-23T20:00:00Z",147,NA,79982,79982,79982,31,4,0,1326,237,1563
"314",20200523,"NH",4089,55450,1844,93,419,NA,120,NA,NA,2197,"B","5/23/2020 09:00","46b7b56fbbc836696c556f4aa9f93408ef863c52","2020-05-23T20:00:00Z",208,419,61383,59539,59539,33,9,26,4285,154,4439
"315",20200523,"NJ",153104,425631,NA,2974,NA,806,NA,611,NA,24762,"A+","5/23/2020 13:00","316bc46d169cf4b9d49c0c34d2096dbd3a757db3","2020-05-23T20:00:00Z",11081,NA,578735,578735,578735,34,96,0,23036,385,23421
"316",20200523,"NM",6625,151758,NA,206,1139,NA,NA,NA,NA,2149,"C","5/22/2020 17:58","acb4c3e1b6d450e7be0da8b845702786ef37c504","2020-05-23T20:00:00Z",302,1139,158383,158383,158383,35,8,0,5463,153,5616
"317",20200523,"NV",7696,99351,NA,402,NA,99,NA,53,NA,359,"A+","5/23/2020 13:00","421b5bb1db29e1d99873ef90440085d6e1b08c4e","2020-05-23T20:00:00Z",388,NA,107047,107047,107047,32,7,0,6811,295,7106
"318",20200523,"NY",359926,1292135,NA,4844,77034,1581,NA,1254,NA,63292,"A","5/22/2020 00:00","08b90b4fcd7078b163aba6b8daddc1b930ec41a9","2020-05-23T20:00:00Z",23282,77034,1652061,1652061,1652061,36,87,191,49496,1772,51268
"319",20200523,"OH",31408,285086,NA,858,5437,333,1429,223,NA,NA,"B","5/23/2020 14:00","d69f19c16c1d31d974ec00953f870dd5b32ebcc7","2020-05-23T20:00:00Z",1956,5437,316494,316494,316494,39,84,58,8080,614,8694
"320",20200523,"OK",5960,154943,NA,174,926,78,NA,NA,NA,4645,"A+","5/23/2020 00:00","715818f7b9006d0b9899e5ae6230887fbf9f2a88","2020-05-23T20:00:00Z",311,926,160903,160903,160903,40,4,0,7625,111,7736
"321",20200523,"OR",3888,106319,NA,102,740,41,NA,15,NA,1376,"A+","5/23/2020 03:01","529006289d92df1f4a1121382c7f2096282bb49b","2020-05-23T20:00:00Z",147,740,110207,110207,110207,41,0,3,2344,24,2368
"322",20200523,"PA",66983,321469,NA,1560,NA,NA,NA,348,NA,39519,"A","5/23/2020 00:00","44c6570307dfc169c9ce9ca670dbb3e5e38efba6","2020-05-23T20:00:00Z",5096,NA,388452,388452,388452,42,112,0,8726,725,9451
"323",20200523,"PR",3100,NA,NA,106,NA,14,NA,5,NA,NA,"B","5/23/2020 06:30","891d77a311ca2fdf3d2ac8dc17ceaacc668a22b3","2020-05-23T20:00:00Z",127,NA,3100,3100,3100,72,1,0,0,70,70
"324",20200523,"RI",13952,116180,NA,233,1557,51,NA,34,NA,1106,"A+","5/23/2020 00:00","8a35af730de20d1d45bdcf6e497b09d0430c1f47","2020-05-23T20:00:00Z",597,1557,130132,130132,130132,44,18,20,2777,216,2993
"325",20200523,"SC",9895,149015,NA,430,1534,NA,NA,NA,NA,5743,"A+","5/23/2020 15:31","b84ae1035ee168b1f3007c2837c319dcef0693b7","2020-05-23T20:00:00Z",425,1534,158910,158910,158910,45,6,0,8630,257,8887
"326",20200523,"SD",4468,29060,NA,90,358,NA,NA,NA,NA,3336,"C","5/22/2020 18:00","2a9a3b58fe32e21cd829c7b2ea346ef0b446b0b6","2020-05-23T20:00:00Z",50,358,33528,33528,33528,46,0,7,1072,112,1184
"327",20200523,"TN",19789,353969,NA,NA,1573,NA,NA,NA,NA,12745,"B","5/23/2020 15:00","b2389591810894ef929882ed2399aa126ce744f4","2020-05-23T20:00:00Z",329,1573,373758,373758,373758,47,14,13,12347,395,12742
"328",20200523,"TX",54509,708197,NA,1688,NA,NA,NA,NA,NA,32277,"B","5/22/2020 17:00","d960480252322ed377682d0e4589b8c9206226f7","2020-05-23T20:00:00Z",1506,NA,762706,762706,762706,48,26,0,20284,1060,21344
"329",20200523,"UT",8260,182519,NA,165,1053,NA,213,NA,88,4898,"B","5/23/2020 11:28","e41f13764e0f96d2eb79641e9cf4210035039b3c","2020-05-23T20:00:00Z",97,1053,190779,190779,190779,49,4,17,3742,203,3945
"330",20200523,"VA",35749,196721,409,1384,6431,330,NA,213,NA,5047,"A+","5/22/2020 17:00","a29b8a1e5bf6ac402f1d5d402ed221c038054fa3","2020-05-23T20:00:00Z",1159,6431,232879,232470,232470,51,23,9,6496,799,7295
"331",20200523,"VI",69,1343,45,NA,NA,NA,NA,NA,NA,61,"C","5/22/2020 07:29","5065c38d5f23d27c34ce8b5ef6272c2b3e8d2c85","2020-05-23T20:00:00Z",6,NA,1457,1412,1412,78,0,0,0,0,0
"332",20200523,"VT",954,26470,NA,21,NA,NA,NA,NA,NA,837,"B","5/23/2020 00:00","838bebb4013220084d417e320bcff6290df5a1c4","2020-05-23T20:00:00Z",54,NA,27424,27424,27424,50,0,0,1689,2,1691
"333",20200523,"WA",19265,289093,NA,332,3230,NA,NA,96,NA,NA,"B","5/22/2020 02:59","10b506609b16c8b508bb29228916770284b06ddc","2020-05-23T20:00:00Z",1050,3230,308358,308358,308358,53,6,74,5283,148,5431
"334",20200523,"WI",14877,179329,223,611,2292,128,542,NA,NA,8688,"A+","5/23/2020 00:00","6deb311be6c4aab97dfc310cc6a2899633d6a8cd","2020-05-23T20:00:00Z",507,2292,194429,194206,194206,55,11,33,6626,481,7107
"335",20200523,"WV",1717,82027,NA,39,NA,11,NA,9,NA,1110,"B","5/23/2020 10:00","69859c868d6f967c2083093fbab429d23b92f66b","2020-05-23T20:00:00Z",72,NA,83744,83744,83744,54,1,0,-1186,101,-1085
"336",20200523,"WY",813,19221,NA,10,77,NA,NA,NA,NA,551,"C","5/23/2020 00:00","f285c33fd09c3d3c8c4e81de7e0d515df045c652","2020-05-23T20:00:00Z",12,77,20034,20034,20034,56,0,1,600,10,610
"337",20200522,"AK",404,41042,NA,15,NA,NA,NA,NA,NA,356,"C","5/22/2020 00:00","d0241cc63b3eb3c281a53407602d52fb27cdaa8d","2020-05-22T20:00:00Z",10,NA,41446,41446,41446,2,0,0,1899,2,1901
"338",20200522,"AL",13563,164205,NA,NA,1561,NA,531,NA,315,7951,"B","5/22/2020 00:00","7eda0dcc4aba996231685a7a080b53f03cf69bc4","2020-05-22T20:00:00Z",537,1561,177768,177768,177768,1,8,33,6585,444,7029
"339",20200522,"AR",5612,97435,NA,86,584,NA,NA,14,110,4029,"A","5/22/2020 00:00","35e60394d2d416b144d5be68a958715520a80245","2020-05-22T20:00:00Z",113,584,103047,103047,103047,5,3,49,3617,154,3771
"340",20200522,"AS",0,124,NA,NA,NA,NA,NA,NA,NA,NA,"C","5/19/2020 00:00","5e2cdb42c23fc0ec6df07e1ceaa71cce399fe6ab","2020-05-22T20:00:00Z",0,NA,124,124,124,60,0,0,0,0,0
"341",20200522,"AZ",15608,160395,NA,796,1879,311,NA,203,NA,3949,"A+","5/22/2020 00:00","41983f9684279d8ba339a586feafdacc56d1f04b","2020-05-22T20:00:00Z",775,1879,176003,176003,176003,4,12,49,4083,293,4376
"342",20200522,"CA",88444,1378329,NA,4762,NA,1317,NA,NA,NA,NA,"B","5/21/2020 00:00","f191cda4632c6bfdfab3cda971a53607f6beaf43","2020-05-22T20:00:00Z",3630,NA,1466773,1466773,1466773,6,88,0,43399,2247,45646
"343",20200522,"CO",23191,119034,NA,620,4037,NA,NA,NA,NA,3580,"A","5/22/2020 00:00","fafc772e346a43f7b61744856865c36f2c17538f","2020-05-22T20:00:00Z",1310,4037,142225,142225,142225,8,11,47,6220,394,6614
"344",20200522,"CT",39640,162688,NA,740,12538,NA,NA,NA,NA,7127,"B","5/21/2020 20:30","de762b56a19e6a81483cc45bdba16f0bb1c9aeae","2020-05-22T20:00:00Z",3637,12538,202328,202328,202328,9,55,1592,5449,432,5881
"345",20200522,"DC",7893,35100,NA,342,NA,112,NA,74,NA,1069,"A+","5/21/2020 00:00","8cc4d805a1ccafd06b8992ce77a566f54610ca74","2020-05-22T20:00:00Z",418,NA,42993,42993,42993,11,6,0,1132,105,1237
"346",20200522,"DE",8529,40457,NA,221,NA,NA,NA,NA,NA,4296,"B","5/21/2020 18:00","5e403f13b059e1d69b0a247ff1b1fd8175194a96","2020-05-22T20:00:00Z",322,NA,48986,48986,48986,10,5,0,1301,143,1444
"347",20200522,"FL",49451,786045,1487,NA,9372,NA,NA,NA,NA,NA,"A","5/22/2020 09:39","d4f8674830f73e8cb541aad73bae822394db151f","2020-05-22T20:00:00Z",2268,9372,836983,835496,835496,12,46,172,20791,776,21567
"348",20200522,"GA",41218,386031,NA,889,7313,NA,1658,NA,NA,NA,"A","5/22/2020 13:00","3a1ac8ce386b8d52d2bf8eff389183e7c125b7d0","2020-05-22T20:00:00Z",1785,7313,427249,427249,427249,13,31,78,18705,813,19518
"349",20200522,"GU",165,5114,NA,NA,NA,NA,NA,NA,NA,125,"C","5/22/2020 05:35","ad1d4f56dea3f39e368bc567673c2ffefd1ad1cc","2020-05-22T20:00:00Z",5,NA,5279,5279,5279,66,0,0,215,0,215
"350",20200522,"HI",647,47338,NA,NA,83,NA,NA,NA,NA,579,"C","5/21/2020 00:00","fa8fb757457a7ced85c7297141c0e2658e073420","2020-05-22T20:00:00Z",17,83,47985,47985,47985,15,0,1,832,4,836
"351",20200522,"IA",16504,103746,NA,362,NA,123,NA,79,NA,9079,"A+","5/22/2020 00:00","012236c6ebb2c0eec965a614999fc28ff88ca43a","2020-05-22T20:00:00Z",425,NA,120250,120250,120250,19,19,0,3351,334,3685
"352",20200522,"ID",2534,37061,NA,NA,223,NA,92,NA,NA,1720,"A","5/21/2020 19:00","ec40205991c3f09a5f03f16793be3f4c0f2e4223","2020-05-22T20:00:00Z",77,223,39595,39595,39595,16,0,2,679,28,707
"353",20200522,"IL",105444,591689,NA,3928,NA,1060,NA,589,NA,NA,"A","5/22/2020 00:00","798096ecc1907d2bd4de3b45b84a96ca5a50e48b","2020-05-22T20:00:00Z",4715,NA,697133,697133,697133,17,108,0,22355,2758,25113
"354",20200522,"IN",30409,178152,NA,1203,5285,416,1166,173,NA,NA,"A+","5/21/2020 23:59","7794ed06ad45df5d6af76f26772c681ba8a2d375","2020-05-22T20:00:00Z",1941,5285,208561,208561,208561,18,28,896,5093,473,5566
"355",20200522,"KS",8958,67476,NA,NA,787,NA,269,NA,120,485,"A+","5/22/2020 10:00","71da73c493d5e5149fe8b5fef03cbcd597370033","2020-05-22T20:00:00Z",185,787,76434,76434,76434,20,7,27,4812,419,5231
"356",20200522,"KY",8286,157954,NA,475,2041,92,886,NA,NA,3008,"A","5/21/2020 17:00","ef2e99815d928b0de737889e27a365adca3d2f30","2020-05-22T20:00:00Z",386,2041,166240,166240,166240,21,10,25,7449,119,7568
"357",20200522,"LA",36925,274883,NA,867,NA,NA,NA,104,NA,26249,"B","5/22/2020 13:00","3fe32f1ed1f11247a57d8a7d4baef8b595fb43b9","2020-05-22T20:00:00Z",2668,NA,311808,311808,311808,22,39,0,6006,421,6427
"358",20200522,"MA",90889,420755,NA,2323,9162,628,NA,NA,NA,NA,"A","5/22/2020 10:00","b9b7162848a82c080d7098c9c00341cdb3cf83f7","2020-05-22T20:00:00Z",6228,9162,511644,511644,511644,25,80,122,9353,805,10158
"359",20200522,"MD",44424,183478,NA,1329,7634,506,NA,NA,NA,3243,"B","5/22/2020 10:00","cf03630b587337d67dcce7ed185648d2a2d57f34","2020-05-22T20:00:00Z",2207,7634,227902,227902,227902,24,48,149,6776,893,7669
"360",20200522,"ME",1948,35450,NA,45,240,21,NA,12,NA,1192,"B","5/22/2020 12:30","3e69a3d100f55a18302ddd2e922011e23f91d801","2020-05-22T20:00:00Z",75,240,37398,37398,37398,23,2,5,0,71,71
"361",20200522,"MI",53913,417871,NA,955,NA,470,NA,348,NA,28234,"A+","5/22/2020 11:00","ba9230a269f38923057aecf3e5eb3f21ee4b7eb9","2020-05-22T20:00:00Z",5158,NA,471784,471784,471784,26,29,0,16641,403,17044
"362",20200522,"MN",19005,161966,NA,534,2432,233,806,NA,NA,12696,"A","5/21/2020 17:00","946e5fb83209950d8797896b5fdb01ad096fce66","2020-05-22T20:00:00Z",851,2432,180971,180971,180971,27,33,52,6610,805,7415
"363",20200522,"MO",11558,161388,NA,711,NA,NA,NA,93,NA,NA,"B","5/22/2020 15:00","d52d2c063b683fbf5074dc25cc68b5c39edc3344","2020-05-22T20:00:00Z",671,NA,172946,172946,172946,29,10,0,10636,218,10854
"364",20200522,"MP",22,4296,NA,NA,NA,NA,NA,NA,NA,13,"D","5/22/2020 00:00","7f11d155e5c3103a4d0511615c033c3bfe2801ad","2020-05-22T20:00:00Z",2,NA,4318,4318,4318,69,0,0,229,0,229
"365",20200522,"MS",12624,125349,NA,557,1966,159,NA,85,NA,7681,"A","5/21/2020 19:00","1c6e893d0476d64e1c68ed63b4d7e28638e75277","2020-05-22T20:00:00Z",596,1966,137973,137973,137973,28,16,34,11601,402,12003
"366",20200522,"MT",479,31378,NA,3,65,NA,NA,NA,NA,441,"C","5/22/2020 12:05","b41a4537a10f197ec81175fe9571c61fd0b9845d","2020-05-22T20:00:00Z",16,65,31857,31857,31857,30,0,0,1333,0,1333
"367",20200522,"NC",21618,281606,NA,568,NA,NA,NA,NA,NA,11637,"A","5/22/2020 10:51","3bec9b266254164e12de8f31a17f2a42ec738af8","2020-05-22T20:00:00Z",728,NA,303224,303224,303224,37,12,0,11821,758,12579
"368",20200522,"ND",2317,60513,NA,39,147,NA,NA,NA,NA,1405,"C","5/22/2020 13:00","e71548eb4f151c14963f7087ecfabc63a41cefb3","2020-05-22T20:00:00Z",52,147,62830,62830,62830,38,1,3,1463,88,1551
"369",20200522,"NE",11425,66994,NA,NA,NA,NA,NA,NA,NA,NA,"D","5/21/2020 19:50","90cf0c618887cb4bbf28747bba4ba937ac692b0f","2020-05-22T20:00:00Z",143,NA,78419,78419,78419,31,5,0,2476,303,2779
"370",20200522,"NH",3935,51165,1526,97,393,NA,120,NA,NA,1767,"B","5/21/2020 09:00","82d7819ccd3da61de0ecf7b4a5154234ca5d4cd3","2020-05-22T20:00:00Z",199,393,56626,55100,55100,33,9,8,2203,67,2270
"371",20200522,"NJ",152719,402595,NA,3049,NA,846,NA,674,NA,24491,"A+","5/22/2020 13:00","bbd4cb6e09dbbb1bab39a0694510d211894b4f66","2020-05-22T20:00:00Z",10985,NA,555314,555314,555314,34,142,0,9793,1247,11040
"372",20200522,"NM",6472,146295,NA,205,1139,NA,NA,NA,NA,2041,"C","5/21/2020 18:00","0a660aa79b1d9ed1f570b5c45ebc519172f6568b","2020-05-22T20:00:00Z",294,1139,152767,152767,152767,35,11,0,5268,155,5423
"373",20200522,"NV",7401,92540,NA,404,NA,90,NA,51,NA,339,"A+","5/22/2020 09:30","0ad638a1c800d8829e07a664fc969c71397d99aa","2020-05-22T20:00:00Z",381,NA,99941,99941,99941,32,3,0,5413,146,5559
"374",20200522,"NY",358154,1242639,NA,4844,76843,1581,NA,1254,NA,63292,"A","5/22/2020 00:00","7a868b50c6d1915aad6db991e67706058d43cec8","2020-05-22T20:00:00Z",23195,76843,1600793,1600793,1600793,36,112,235,44042,1696,45738
"375",20200522,"OH",30794,277006,NA,879,5379,362,1416,232,NA,NA,"B","5/22/2020 14:00","d66d9b143df0ba49db072a5b9eccaefab2ae7bb9","2020-05-22T20:00:00Z",1872,5379,307800,307800,307800,39,36,84,8095,627,8722
"376",20200522,"OK",5849,147318,NA,190,926,94,NA,NA,NA,4533,"A+","5/22/2020 00:00","c01a72c8ec8c639a65d6a1aff995def5db4af699","2020-05-22T20:00:00Z",307,926,153167,153167,153167,40,3,9,3403,169,3572
"377",20200522,"OR",3864,103975,NA,146,737,47,NA,16,NA,1376,"A+","5/22/2020 11:00","7b81b3f2982b91d62683cd689ddd8ccefb075397","2020-05-22T20:00:00Z",147,737,107839,107839,107839,41,2,5,2568,47,2615
"378",20200522,"PA",66258,312743,NA,1580,NA,NA,NA,368,NA,37767,"A","5/22/2020 00:00","35051d54837bd81b2250a973576d66546500c536","2020-05-22T20:00:00Z",4984,NA,379001,379001,379001,42,115,0,9229,866,10095
"379",20200522,"PR",3030,NA,NA,96,NA,12,NA,6,NA,NA,"B","5/22/2020 05:51","340ae58f0365cfe5afbb6ad453272ca1a5673438","2020-05-22T20:00:00Z",126,NA,3030,3030,3030,72,0,0,0,117,117
"380",20200522,"RI",13736,113403,NA,242,1537,56,NA,40,NA,1084,"A+","5/22/2020 00:00","8540d1bf91dccde56e8ae3d7c6bf612abe805e19","2020-05-22T20:00:00Z",579,1537,127139,127139,127139,44,23,31,3607,165,3772
"381",20200522,"SC",9638,140385,NA,429,1534,NA,NA,NA,NA,5743,"A+","5/22/2020 16:00","64e52d6a0d09aa614256b7848d12687474e8c2eb","2020-05-22T20:00:00Z",419,1534,150023,150023,150023,45,12,90,11322,463,11785
"382",20200522,"SD",4356,27988,NA,83,351,NA,NA,NA,NA,3267,"C","5/21/2020 18:00","29e6c7fd137c8ea33fa0d0991c9f2526c378efad","2020-05-22T20:00:00Z",50,351,32344,32344,32344,46,2,9,937,106,1043
"383",20200522,"TN",19394,341622,NA,NA,1560,NA,NA,NA,NA,12566,"B","5/22/2020 15:00","2cc0bf95b79e25a878746f49aa12aa424ef6076f","2020-05-22T20:00:00Z",315,1560,361016,361016,361016,47,2,21,0,433,433
"384",20200522,"TX",53449,687913,NA,1578,NA,NA,NA,NA,NA,31223,"B","5/21/2020 17:55","18420710e4f014e795c2f3cb6dcf89cedff5375d","2020-05-22T20:00:00Z",1480,NA,741362,741362,741362,48,40,0,0,1181,1181
"385",20200522,"UT",8057,178777,NA,163,1036,NA,210,NA,88,4748,"B","5/22/2020 15:00","9aa724dfa9dd7a3699916b14f25b1b6a65674dfe","2020-05-22T20:00:00Z",93,1036,186834,186834,186834,49,1,389,3777,183,3960
"386",20200522,"VA",34950,190225,464,1459,6422,366,NA,207,NA,4963,"A+","5/21/2020 17:00","9de0228b77d68a072e17353bd790bd7b766b19ad","2020-05-22T20:00:00Z",1136,6422,225639,225175,225175,51,37,153,5763,813,6576
"387",20200522,"VI",69,1343,45,NA,NA,NA,NA,NA,NA,61,"C","5/22/2020 07:29","c1ad5ea77503889b7a8141df481e910cee1ee3a4","2020-05-22T20:00:00Z",6,NA,1457,1412,1412,78,0,0,29,0,29
"388",20200522,"VT",952,24781,NA,16,NA,NA,NA,NA,NA,834,"B","5/22/2020 00:00","87641665873216ec509dda0dd03e4ca261710b17","2020-05-22T20:00:00Z",54,NA,25733,25733,25733,50,0,0,30,2,32
"389",20200522,"WA",19117,283810,NA,332,3156,NA,NA,85,NA,NA,"B","5/21/2020 02:59","6139d5856f8f5180a139595adf0a2abf6670cc88","2020-05-22T20:00:00Z",1044,3156,302927,302927,302927,53,7,31,48,21,69
"390",20200522,"WI",14396,172703,187,583,2259,133,535,NA,NA,8362,"A+","5/22/2020 00:00","838301dac73de710422fa797be7240f3d7a6e464","2020-05-22T20:00:00Z",496,2259,187286,187099,187099,55,9,41,9465,511,9976
"391",20200522,"WV",1616,83213,NA,47,NA,13,NA,9,NA,983,"B","5/22/2020 10:00","492049babe1b48e3bbdb850bc0449c39b2e0c333","2020-05-22T20:00:00Z",71,NA,84829,84829,84829,54,1,0,1665,23,1688
"392",20200522,"WY",803,18621,NA,10,76,NA,NA,NA,NA,551,"C","5/21/2020 18:02","1a003a109d66ab9aefae21bcb3630e63a61857ce","2020-05-22T20:00:00Z",12,76,19424,19424,19424,56,1,1,568,16,584
"393",20200521,"AK",402,39143,NA,19,NA,NA,NA,NA,NA,356,"C","5/21/2020 00:00","5bc24af23271e1a3dea99c5b7b10ae9ac2260f06","2020-05-21T20:00:00Z",10,NA,39545,39545,39545,2,0,0,2500,0,2500
"394",20200521,"AL",13119,157620,NA,NA,1528,NA,526,NA,311,NA,"B","5/21/2020 00:00","87ebfdf347cf94d0e2e6a2f39c764efa8472452b","2020-05-21T20:00:00Z",529,1528,170739,170739,170739,1,12,35,5914,375,6289
"395",20200521,"AR",5458,93818,NA,78,535,NA,NA,14,101,3915,"A","5/21/2020 00:00","9be3a11ce678c3e9386bd86aeb7b33b5645fd78a","2020-05-21T20:00:00Z",110,535,99276,99276,99276,5,3,0,2563,455,3018
"396",20200521,"AS",0,124,NA,NA,NA,NA,NA,NA,NA,NA,"D","5/19/2020 00:00","15ed7a7684f942eceb9f62d5e5c296d42def4c19","2020-05-21T20:00:00Z",0,NA,124,124,124,60,0,0,0,0,0
"397",20200521,"AZ",15315,156312,NA,812,1830,299,NA,197,NA,3872,"A+","5/21/2020 00:00","88d0f72c2c4dd7f2e477f898eb3c52b2185ab864","2020-05-21T20:00:00Z",763,1830,171627,171627,171627,4,16,38,5774,418,6192
"398",20200521,"CA",86197,1334930,NA,4735,NA,1310,NA,NA,NA,NA,"B","5/21/2020 00:00","21f1a097d2a21256e6cd031933e78f8813587e4e","2020-05-21T20:00:00Z",3542,NA,1421127,1421127,1421127,6,106,0,38867,2140,41007
"399",20200521,"CO",22797,112814,NA,613,3990,NA,NA,NA,NA,3532,"A","5/21/2020 00:00","ae548fb4d38924eb3397f394fbbb871f22c3be41","2020-05-21T20:00:00Z",1299,3990,135611,135611,135611,8,42,35,3459,315,3774
"400",20200521,"CT",39208,157239,NA,816,10946,NA,NA,NA,NA,6264,"B","5/20/2020 08:30","350854d08e7690e0c4d4782a47db1aaaa8ed4dcf","2020-05-21T20:00:00Z",3582,10946,196447,196447,196447,9,53,0,5538,191,5729
"401",20200521,"DC",7788,33968,NA,336,NA,NA,NA,74,NA,1061,"A","5/20/2020 00:00","f9e7cc07d606acb8893ae83e77202ed781bc42be","2020-05-21T20:00:00Z",412,NA,41756,41756,41756,11,5,0,1100,237,1337
"402",20200521,"DE",8386,39156,NA,220,NA,NA,NA,NA,NA,4130,"B","5/20/2020 18:00","751f3d54a727ad4864a7a8d576363396707f0919","2020-05-21T20:00:00Z",317,NA,47542,47542,47542,10,7,0,1938,192,2130
"403",20200521,"FL",48675,765254,1471,NA,9200,NA,NA,NA,NA,NA,"A","5/21/2020 10:09","24acf54e11582f66e8735de1707c17de3ce5c439","2020-05-21T20:00:00Z",2222,9200,815400,813929,813929,12,49,266,41377,1204,42581
"404",20200521,"GA",40405,367326,NA,959,7235,NA,1642,NA,NA,NA,"A","5/21/2020 13:00","841c92514580dd8034edcb6f268811b843816a88","2020-05-21T20:00:00Z",1754,7235,407731,407731,407731,13,67,128,4033,758,4791
"405",20200521,"GU",165,4899,NA,NA,NA,NA,NA,NA,NA,125,"C","5/21/2020 08:00","16ebd0e8d361e7758bc0ea2105013281cdfce22a","2020-05-21T20:00:00Z",5,NA,5064,5064,5064,66,0,0,92,0,92
"406",20200521,"HI",643,46506,NA,NA,82,NA,NA,NA,NA,578,"C","5/20/2020 18:00","fe6bf4c813fe13a542d7709967b2678608b030bc","2020-05-21T20:00:00Z",17,82,47149,47149,47149,15,0,0,843,2,845
"407",20200521,"IA",16170,100395,NA,376,NA,125,NA,80,NA,8672,"A+","5/21/2020 00:00","2dd1b8bd73b25adc155a3fb41c38343e370b2606","2020-05-21T20:00:00Z",406,NA,116565,116565,116565,19,18,0,5261,556,5817
"408",20200521,"ID",2506,36382,NA,NA,221,NA,91,NA,NA,1688,"B","5/20/2020 19:00","9f4d46dfa5cb4cea19d4d1d926ee43bddaf0bcd8","2020-05-21T20:00:00Z",77,221,38888,38888,38888,16,0,6,291,30,321
"409",20200521,"IL",102686,569334,NA,4107,NA,1088,NA,609,NA,NA,"A","5/21/2020 00:00","3d142da9971e8be450fec3a4c0e21c17d8b103a3","2020-05-21T20:00:00Z",4607,NA,672020,672020,672020,17,82,0,27039,2268,29307
"410",20200521,"IN",29936,173059,NA,1166,4389,409,990,175,NA,NA,"A+","5/20/2020 23:59","26ccacf5afa83acaaa19a2b0f36c69949c34aa80","2020-05-21T20:00:00Z",1913,4389,202995,202995,202995,18,49,0,6595,662,7257
"411",20200521,"KS",8539,62664,NA,NA,760,NA,258,NA,116,473,"A+","5/20/2020 10:00","626666b38d0b59dd538677296218309d9675ddd9","2020-05-21T20:00:00Z",178,760,71203,71203,71203,20,0,0,0,0,0
"412",20200521,"KY",8167,150505,NA,474,2016,98,879,NA,NA,2919,"A","5/20/2020 17:00","83f24d7104acb10518efe11b535382ccf4493674","2020-05-21T20:00:00Z",376,2016,158672,158672,158672,21,10,6,4588,98,4686
"413",20200521,"LA",36504,268877,NA,884,NA,NA,NA,107,NA,26249,"B","5/21/2020 13:00","4678aff3cdd254e20318753f4e7d68c3ce5f2bec","2020-05-21T20:00:00Z",2629,NA,305381,305381,305381,22,21,0,18223,1188,19411
"414",20200521,"MA",90084,411402,NA,2396,9040,647,NA,NA,NA,NA,"A","5/21/2020 10:00","0e7bc320a926fcfef12e04e2168f447e94f9cebc","2020-05-21T20:00:00Z",6148,9040,501486,501486,501486,25,82,143,10419,1114,11533
"415",20200521,"MD",43531,176702,NA,1374,7485,526,NA,NA,NA,3099,"B","5/21/2020 10:00","75f3ec74cbd4dfcde9f0afa37aa2022b11cc8b77","2020-05-21T20:00:00Z",2159,7485,220233,220233,220233,24,36,92,3695,1208,4903
"416",20200521,"ME",1877,35450,NA,41,235,21,NA,12,NA,1145,"B","5/21/2020 12:00","c1cf73ecc2d5cf88c254316a3d68f2a58686f3ec","2020-05-21T20:00:00Z",73,235,37327,37327,37327,23,0,4,0,58,58
"417",20200521,"MI",53510,401230,NA,1054,NA,472,NA,361,NA,28234,"A+","5/21/2020 11:00","b16f8c24c013fcafb64e3730c67c4912b4f8b3cd","2020-05-21T20:00:00Z",5129,NA,454740,454740,454740,26,69,0,17167,501,17668
"418",20200521,"MN",18200,155356,NA,566,2380,229,787,NA,NA,12488,"A","5/20/2020 17:00","8bc3ccb2aa02ef646d1d1f3fa1c18a509046bc14","2020-05-21T20:00:00Z",818,2380,173556,173556,173556,27,32,72,5688,530,6218
"419",20200521,"MO",11340,150752,NA,697,NA,NA,NA,99,NA,NA,"B","5/21/2020 15:00","58a28730eec21788141b0c5103dc56a1d2f3a0b0","2020-05-21T20:00:00Z",661,NA,162092,162092,162092,29,30,0,0,108,108
"420",20200521,"MP",22,4067,NA,NA,NA,NA,NA,NA,NA,13,"D","5/21/2020 00:00","b6b4a4a6c1581cfd51584a7e201cb371332ebc73","2020-05-21T20:00:00Z",2,NA,4089,4089,4089,69,0,0,271,1,272
"421",20200521,"MS",12222,113748,NA,638,1932,158,NA,92,NA,7681,"A","5/20/2020 19:00","0f579959d7d347b05ee5532fa3b2d8ce0f5b5898","2020-05-21T20:00:00Z",580,1932,125970,125970,125970,28,10,31,5035,255,5290
"422",20200521,"MT",479,30045,NA,3,65,NA,NA,NA,NA,440,"C","5/21/2020 00:00","fcfcb1304d4d1f7b07b37b6c3693f1ceba3ac1e9","2020-05-21T20:00:00Z",16,65,30524,30524,30524,30,0,0,797,1,798
"423",20200521,"NC",20860,269785,NA,578,NA,NA,NA,NA,NA,11637,"A","5/21/2020 13:50","1ab0915bdcb27abc0c678ac56c564a54947b5db4","2020-05-21T20:00:00Z",716,NA,290645,290645,290645,37,14,0,12304,738,13042
"424",20200521,"ND",2229,59050,NA,39,144,NA,NA,NA,NA,1340,"C","5/21/2020 01:59","afb948360fc7e62d070e8dcbd0f199bfb6401e25","2020-05-21T20:00:00Z",51,144,61279,61279,61279,38,2,2,1945,134,2079
"425",20200521,"NE",11122,64518,NA,NA,NA,NA,NA,NA,NA,NA,"D","5/20/2020 19:55","e17aedcd9fefaae0e5c2260a0d30fcb3817a7418","2020-05-21T20:00:00Z",138,NA,75640,75640,75640,31,6,0,3229,276,3505
"426",20200521,"NH",3868,48962,1434,103,385,NA,109,NA,NA,1388,"B","5/20/2020 09:00","8db185e85abe975fdc96ca58067e6cefd32afe99","2020-05-21T20:00:00Z",190,385,54264,52830,52830,33,8,2,1795,147,1942
"427",20200521,"NJ",151472,392802,NA,3208,NA,896,NA,700,NA,24236,"A+","5/21/2020 13:00","fffea701a74faf65d45e1fff0e8c902e6ab8ba27","2020-05-21T20:00:00Z",10843,NA,544274,544274,544274,34,96,0,11858,1073,12931
"428",20200521,"NM",6317,141027,NA,206,1139,NA,NA,NA,NA,1985,"C","5/20/2020 18:35","083622de90a9568999d01563caca8c820895e463","2020-05-21T20:00:00Z",283,1139,147344,147344,147344,35,7,0,4973,125,5098
"429",20200521,"NV",7255,87127,NA,410,NA,92,NA,52,NA,339,"A+","5/21/2020 10:30","74c4a8e7956c91d3b808412f147b246a614961cc","2020-05-21T20:00:00Z",378,NA,94382,94382,94382,32,5,0,3122,89,3211
"430",20200521,"NY",356458,1198597,NA,5187,76608,1695,NA,1345,NA,62826,"A","5/21/2020 00:00","0db2236bc53fc87b0d78b9fb5a05f949a1923575","2020-05-21T20:00:00Z",23083,76608,1555055,1555055,1555055,36,107,198,47131,2088,49219
"431",20200521,"OH",30167,268911,NA,892,5295,349,1397,258,NA,NA,"B","5/21/2020 14:00","9159d7824e3afaf8c3bd894d7d146673be8221fc","2020-05-21T20:00:00Z",1836,5295,299078,299078,299078,39,55,97,8819,731,9550
"432",20200521,"OK",5680,143915,NA,201,917,78,NA,NA,NA,4361,"A+","5/21/2020 00:00","91de2a3c05e8d762829a9b0bfea9067fd6310b54","2020-05-21T20:00:00Z",304,917,149595,149595,149595,40,5,12,5076,148,5224
"433",20200521,"OR",3817,101407,NA,140,732,40,NA,14,NA,1406,"A+","5/21/2020 11:00","c00c835f72562e0dcb8b3787090d2296e815124c","2020-05-21T20:00:00Z",145,732,105224,105224,105224,41,1,9,3059,16,3075
"434",20200521,"PA",65392,303514,NA,1654,NA,NA,NA,361,NA,NA,"B","5/21/2020 00:00","c929ade84d96ca7756c6bcedd03a2aef032844b8","2020-05-21T20:00:00Z",4869,NA,368906,368906,368906,42,245,0,17480,1726,19206
"435",20200521,"PR",2913,NA,NA,NA,NA,13,NA,7,NA,NA,"C","5/21/2020 05:54","620028b85e5cb65181adc1a0ada37c0fa08cef60","2020-05-21T20:00:00Z",126,NA,2913,2913,2913,72,1,0,0,47,47
"436",20200521,"RI",13571,109796,NA,254,1506,56,NA,41,NA,1047,"A+","5/21/2020 12:00","7fb1ef209d531907160625c025888fe2ac156a11","2020-05-21T20:00:00Z",556,1506,123367,123367,123367,44,18,20,2624,215,2839
"437",20200521,"SC",9175,129063,NA,414,1444,NA,NA,NA,NA,5451,"A+","5/20/2020 17:55","931ffe010124d6a9c2ec31b28bfec18dc7aaffff","2020-05-21T20:00:00Z",407,1444,138238,138238,138238,45,8,0,3056,119,3175
"438",20200521,"SD",4250,27051,NA,91,342,NA,NA,NA,NA,3145,"C","5/21/2020 11:23","64e4e927c5599edcd73b7feb5c2223660799fb2c","2020-05-21T20:00:00Z",48,342,31301,31301,31301,46,2,9,839,73,912
"439",20200521,"TN",18961,341622,NA,NA,1539,NA,NA,NA,NA,12191,"B","5/21/2020 15:00","f7984b612ac52d8e4f51ec1772634e9586e40214","2020-05-21T20:00:00Z",313,1539,360583,360583,360583,47,4,24,6141,429,6570
"440",20200521,"TX",52268,687913,NA,1680,NA,NA,NA,NA,NA,30341,"B","5/20/2020 16:50","afa354697cd24b89805710f7a9b5fbfc00d1b038","2020-05-21T20:00:00Z",1440,NA,740181,740181,740181,48,21,0,18308,945,19253
"441",20200521,"UT",7874,175000,NA,169,647,NA,207,NA,88,4596,"B","5/21/2020 10:45","723f533a24f75b39b192d1a5c4410189ef12b00b","2020-05-21T20:00:00Z",92,647,182874,182874,182874,49,2,16,3046,164,3210
"442",20200521,"VA",34137,184462,490,1491,6269,351,NA,191,NA,4778,"A+","5/21/2020 17:00","7649521ce6a92c7b41fe61936c16d340ca931283","2020-05-21T20:00:00Z",1099,6269,219089,218599,218599,51,25,210,4744,1229,5973
"443",20200521,"VI",69,1314,26,NA,NA,NA,NA,NA,NA,61,"C","5/20/2020 07:09","de2620a9b174e49bcd105a048752e1479cc85705","2020-05-21T20:00:00Z",6,NA,1409,1383,1383,78,0,0,0,0,0
"444",20200521,"VT",950,24751,NA,14,NA,NA,NA,NA,NA,827,"B","5/21/2020 00:00","49dedc29e6cd1711b83442b9d3c938274f52181b","2020-05-21T20:00:00Z",54,NA,25701,25701,25701,50,0,0,637,6,643
"445",20200521,"WA",19096,283762,NA,242,3125,NA,NA,70,NA,NA,"B","5/20/2020 02:59","b55f79cf413def6ba153cbee19c7be28e82045ce","2020-05-21T20:00:00Z",1037,3125,302858,302858,302858,53,6,3125,0,0,0
"446",20200521,"WI",13885,163238,220,524,2218,126,526,NA,NA,8012,"A+","5/21/2020 00:00","74da8338ea02a296c8ea821a578000b0e20b8119","2020-05-21T20:00:00Z",487,2218,177343,177123,177123,55,6,57,8938,472,9410
"447",20200521,"WV",1593,81548,NA,46,NA,12,NA,9,NA,983,"B","5/21/2020 10:00","6d5334fe23d02a60f308e5d7d7dedf223b4e2d92","2020-05-21T20:00:00Z",70,NA,83141,83141,83141,54,1,0,2452,48,2500
"448",20200521,"WY",787,18053,NA,8,75,NA,NA,NA,NA,534,"C","5/20/2020 16:54","826453639397402a24c8ec49107d80d94ca07cdc","2020-05-21T20:00:00Z",11,75,18840,18840,18840,56,0,1,0,0,0
"449",20200520,"AK",402,36643,NA,16,NA,NA,NA,NA,NA,352,"C","5/20/2020 00:00","fbd2c4d7f2f9bb5886519ca013a5582d05a2322c","2020-05-20T20:00:00Z",10,NA,37045,37045,37045,2,0,0,662,3,665
"450",20200520,"AL",12744,151706,NA,NA,1493,NA,524,NA,309,NA,"B","5/19/2020 00:00","fc74b5a0d85554eb568628788cfab89828235631","2020-05-20T20:00:00Z",517,1493,164450,164450,164450,1,13,40,6516,368,6884
"451",20200520,"AR",5003,91255,NA,78,535,NA,NA,14,101,3852,"A","5/20/2020 00:00","8cf09ad59fe07fd22c8d7872f13e6a89e2330024","2020-05-20T20:00:00Z",107,535,96258,96258,96258,5,5,0,2477,80,2557
"452",20200520,"AS",0,124,NA,NA,NA,NA,NA,NA,NA,NA,"D","5/19/2020 00:00","b17187aa654adddc868eec1438cbfceb53964c13","2020-05-20T20:00:00Z",0,NA,124,124,124,60,0,0,0,0,0
"453",20200520,"AZ",14897,150538,NA,810,1792,298,NA,208,NA,3773,"A+","5/20/2020 00:00","b1b84c773495f600cdad6b1e420d1c25d58354cc","2020-05-20T20:00:00Z",747,1792,165435,165435,165435,4,43,46,3533,331,3864
"454",20200520,"CA",84057,1296063,NA,4681,NA,1345,NA,NA,NA,NA,"B","5/20/2020 00:00","6be7a20ccb8deab94178b9db3e70d2c1cf2147c7","2020-05-20T20:00:00Z",3436,NA,1380120,1380120,1380120,6,102,0,38542,2262,40804
"455",20200520,"CO",22482,109355,NA,626,3955,NA,NA,NA,NA,3478,"A","5/20/2020 00:00","f1e624518c3e0cbb8a82aeffa19010138d94fbfe","2020-05-20T20:00:00Z",1257,3955,131837,131837,131837,8,33,56,224,280,504
"456",20200520,"CT",39017,151701,NA,887,10946,NA,NA,NA,NA,6264,"B","5/20/2020 16:00","09a1fb75d7a153b27aff1fabc601dc6f894b5e33","2020-05-20T20:00:00Z",3529,10946,190718,190718,190718,9,57,0,4611,587,5198
"457",20200520,"DC",7551,32868,NA,336,NA,NA,NA,74,NA,1059,"A","5/19/2020 00:00","c104161c3fde2a6cf053ad4c9dfcf42bd6a30c39","2020-05-20T20:00:00Z",407,NA,40419,40419,40419,11,7,0,928,117,1045
"458",20200520,"DE",8194,37218,NA,220,NA,NA,NA,NA,NA,3965,"B","5/19/2020 18:00","1238d97d6d08b453fa60c798055bd71e6968c2f6","2020-05-20T20:00:00Z",310,NA,45412,45412,45412,10,6,0,1123,157,1280
"459",20200520,"FL",47471,723877,1357,472,8934,232,NA,NA,NA,NA,"A+","5/20/2020 09:42","3c953fc1fec5361f16fc7dc42c9d79dbbe821cb0","2020-05-20T20:00:00Z",2173,8934,772705,771348,771348,12,44,190,54966,527,55493
"460",20200520,"GA",39647,363293,NA,959,7107,NA,1617,NA,NA,NA,"A","5/20/2020 13:00","0e81a8dafae0910fd2fa794a2031d49b427820c6","2020-05-20T20:00:00Z",1687,7107,402940,402940,402940,13,23,80,23858,926,24784
"461",20200520,"GU",165,4807,NA,NA,NA,NA,NA,NA,NA,125,"C","5/20/2020 06:30","a25b34e32099b899780c58630867d556d1d1e3f9","2020-05-20T20:00:00Z",5,NA,4972,4972,4972,66,0,0,134,11,145
"462",20200520,"HI",641,45663,NA,NA,82,NA,NA,NA,NA,578,"C","5/19/2020 18:00","36131a820aace240dada1a2ccb5933bbab899fa0","2020-05-20T20:00:00Z",17,82,46304,46304,46304,15,0,0,1280,1,1281
"463",20200520,"IA",15614,95134,NA,381,NA,126,NA,84,NA,8362,"A+","5/20/2020 00:00","351c63004cc136c1d76db041c07915f83bc9e45e","2020-05-20T20:00:00Z",388,NA,110748,110748,110748,19,16,0,2835,265,3100
"464",20200520,"ID",2476,36091,NA,NA,215,NA,89,NA,NA,1668,"B","5/19/2020 19:00","1c1bf50759875898ad6a6ebe8db57d27236cba19","2020-05-20T20:00:00Z",77,215,38567,38567,38567,16,3,2,477,21,498
"465",20200520,"IL",100418,542295,NA,3914,NA,1005,NA,554,NA,NA,"A","5/20/2020 00:00","e9662e68250154ce3144193073d08e9fdb4272cc","2020-05-20T20:00:00Z",4525,NA,642713,642713,642713,17,146,0,18641,2388,21029
"466",20200520,"IN",29274,166464,NA,1288,4389,431,990,197,NA,NA,"A+","5/19/2020 23:59","75cb7f6a63e07b80d2754800059960dd752bdb0e","2020-05-20T20:00:00Z",1864,4389,195738,195738,195738,18,40,0,5839,569,6408
"467",20200520,"KS",8539,62664,NA,NA,760,NA,258,NA,116,473,"A+","5/20/2020 10:00","239f7a0ad07da70297fe5eca1a62cf53404dcb1e","2020-05-20T20:00:00Z",178,760,71203,71203,71203,20,5,20,4014,199,4213
"468",20200520,"KY",8069,145917,NA,443,2010,269,875,NA,NA,2826,"A","5/19/2020 17:00","75c889317de52b4219bf1f3fdeb47314e48fcc97","2020-05-20T20:00:00Z",366,2010,153986,153986,153986,21,0,30,0,0,0
"469",20200520,"LA",35316,250654,NA,931,NA,NA,NA,110,NA,26249,"B","5/20/2020 13:00","4ebe431eb0773c78da2988a42f34370d0e67f6c9","2020-05-20T20:00:00Z",2608,NA,285970,285970,285970,22,27,0,7619,278,7897
"470",20200520,"MA",88970,400983,NA,2518,8897,675,NA,NA,NA,NA,"A","5/20/2020 10:00","dc7f6504182e05be1016791a23d13850fe30b54c","2020-05-20T20:00:00Z",6066,8897,489953,489953,489953,25,128,131,11968,1045,13013
"471",20200520,"MD",42323,173007,NA,1410,7393,539,NA,NA,NA,2993,"B","5/20/2020 10:00","55839020a767a06e23e9ff6b0cfb4de9cfbfc995","2020-05-20T20:00:00Z",2123,7393,215330,215330,215330,24,42,194,5895,777,6672
"472",20200520,"ME",1819,35450,NA,43,231,24,NA,12,NA,1100,"B","5/20/2020 12:30","6841cbc18f413f5e98ec420d21c42b7feb1774bd","2020-05-20T20:00:00Z",73,231,37269,37269,37269,23,0,6,13358,78,13436
"473",20200520,"MI",53009,384063,NA,1066,NA,492,NA,332,NA,28234,"A+","5/20/2020 11:00","9ed106ed0c86b787c8dc359de7ca9ce7a2ea1fe7","2020-05-20T20:00:00Z",5060,NA,437072,437072,437072,26,43,0,13509,659,14168
"474",20200520,"MN",17670,149668,NA,550,2308,212,773,NA,NA,12227,"A","5/19/2020 17:00","690fdbcf2ba8608cbc8354c36acc8f0964bde1c9","2020-05-20T20:00:00Z",786,2308,167338,167338,167338,27,29,87,4862,641,5503
"475",20200520,"MO",11232,150752,NA,546,NA,NA,NA,103,NA,NA,"B","5/20/2020 15:00","59c63344f909faedc336a6f4ddbb045ca5af86fe","2020-05-20T20:00:00Z",631,NA,161984,161984,161984,29,15,0,7722,152,7874
"476",20200520,"MP",21,3796,NA,NA,NA,NA,NA,NA,NA,13,"D","5/20/2020 00:00","f4d221a70d23824b1748360f53c42cd204089fab","2020-05-20T20:00:00Z",2,NA,3817,3817,3817,69,0,0,0,0,0
"477",20200520,"MS",11967,108713,NA,644,1901,157,NA,89,NA,7681,"A","5/19/2020 19:00","a4bc97dd1cd3490d15cf952d63c36adfa9f22697","2020-05-20T20:00:00Z",570,1901,120680,120680,120680,28,16,61,2657,263,2920
"478",20200520,"MT",478,29248,NA,3,65,NA,NA,NA,NA,440,"C","5/20/2020 00:00","2f3881f0a568e83a0c15c272c4bc075eeda1211f","2020-05-20T20:00:00Z",16,65,29726,29726,29726,30,0,0,769,7,776
"479",20200520,"NC",20122,257481,NA,554,NA,NA,NA,NA,NA,11637,"A","5/20/2020 12:15","f1570109d8fcd76a1d363b2c41d9a0ab7bfc387a","2020-05-20T20:00:00Z",702,NA,277603,277603,277603,37,11,0,12173,422,12595
"480",20200520,"ND",2095,57105,NA,38,142,NA,NA,NA,NA,1302,"C","5/20/2020 01:59","40a29c111a2b27e46383d54173de85d184681ef1","2020-05-20T20:00:00Z",49,142,59200,59200,59200,38,4,7,1368,101,1469
"481",20200520,"NE",10846,61289,NA,NA,NA,NA,NA,NA,NA,NA,"D","5/19/2020 19:00","d6b6f2ef9b9710b1f1929af124f35f2d1048a919","2020-05-20T20:00:00Z",132,NA,72135,72135,72135,31,7,0,1930,221,2151
"482",20200520,"NH",3721,47167,861,105,383,NA,109,NA,NA,1275,"B","5/19/2020 09:00","a959302f6fca6e30d64cde469662fde2a6739267","2020-05-20T20:00:00Z",182,383,51749,50888,50888,33,10,15,1345,69,1414
"483",20200520,"NJ",150399,380944,NA,3405,NA,969,NA,750,NA,23945,"A+","5/20/2020 13:00","76a32369f16763bc8b9c6061998dde4298477d12","2020-05-20T20:00:00Z",10747,NA,531343,531343,531343,34,161,0,9775,1386,11161
"484",20200520,"NM",6192,136054,NA,204,1139,NA,NA,NA,NA,1882,"C","5/20/2020 14:25","6e4040eba43846e8714e2f3695e0a0b39c055ede","2020-05-20T20:00:00Z",276,1139,142246,142246,142246,35,6,253,4530,96,4626
"485",20200520,"NV",7166,84005,NA,437,NA,107,NA,60,NA,336,"A","5/20/2020 09:00","def1df55e0dc0ea2e0e82bc5215fd24ea3259444","2020-05-20T20:00:00Z",373,NA,91171,91171,91171,32,8,0,3496,120,3616
"486",20200520,"NY",354370,1151466,NA,5570,76410,1836,NA,1421,NA,61886,"A","5/20/2020 00:00","00a412db192eec4248dc52194da0117cc8819e2a","2020-05-20T20:00:00Z",22976,76410,1505836,1505836,1505836,36,133,242,36572,1525,38097
"487",20200520,"OH",29436,260092,NA,902,5198,333,1369,248,NA,NA,"B","5/20/2020 14:00","f4e3a67b373cd29bc1ed42d8c469a2b5ef10c28a","2020-05-20T20:00:00Z",1781,5198,289528,289528,289528,39,61,81,11442,484,11926
"488",20200520,"OK",5532,138839,NA,209,905,92,NA,NA,NA,4266,"A+","5/20/2020 00:00","4857c838770da31518dbb551e1f6a31e13b4ff06","2020-05-20T20:00:00Z",299,905,144371,144371,144371,40,5,8,5181,43,5224
"489",20200520,"OR",3801,98348,NA,152,723,42,NA,17,NA,1406,"A+","5/20/2020 11:00","58fa223ca9b5c41b430e41eef5e3542bc4f9d4fb","2020-05-20T20:00:00Z",144,723,102149,102149,102149,41,4,9,2354,75,2429
"490",20200520,"PA",63666,286034,NA,1818,NA,NA,NA,377,NA,NA,"B","5/19/2020 00:00","1de580fd8a6da3353e1d1866ead2e9f6f3ea15d5","2020-05-20T20:00:00Z",4624,NA,349700,349700,349700,42,0,0,0,0,0
"491",20200520,"PR",2866,NA,NA,NA,NA,20,NA,5,NA,NA,"C","5/20/2020 06:30","2b90fda9806c71e1d4e7b9ec74535b0cff050187","2020-05-20T20:00:00Z",125,NA,2866,2866,2866,72,1,0,0,61,61
"492",20200520,"RI",13356,107172,NA,257,1486,58,NA,45,NA,1030,"A+","5/20/2020 12:00","6439d6ba25e9e0cbb3dc3dc8a40c65376ec15416","2020-05-20T20:00:00Z",538,1486,120528,120528,120528,44,6,22,2877,405,3282
"493",20200520,"SC",9056,126007,NA,NA,1444,NA,NA,NA,NA,5451,"A+","5/19/2020 16:00","4841aeea3388848e2b0cc7d34e71e216705b6bac","2020-05-20T20:00:00Z",399,1444,135063,135063,135063,45,0,0,0,0,0
"494",20200520,"SD",4177,26212,NA,81,333,NA,NA,NA,NA,3023,"C","5/19/2020 18:00","b9123eda67bb5f394fdedfec7dbb22455ec8ca35","2020-05-20T20:00:00Z",46,333,30389,30389,30389,46,0,6,588,92,680
"495",20200520,"TN",18532,335481,NA,NA,1515,NA,NA,NA,NA,11783,"B","5/20/2020 15:00","535b55c09bfa37309c56d0f1fdaa8962190742a3","2020-05-20T20:00:00Z",309,1515,354013,354013,354013,47,4,17,7736,154,7890
"496",20200520,"TX",51323,669605,NA,1791,NA,NA,NA,NA,NA,30341,"B","5/19/2020 16:50","e08936667ad336eed0d6b81f170b7ed49167440e","2020-05-20T20:00:00Z",1419,NA,720928,720928,720928,48,50,0,19371,1411,20782
"497",20200520,"UT",7710,171954,NA,144,631,NA,200,NA,87,4423,"B","5/20/2020 10:15","4f48b4dd9dbe40e357c32d4261a90c4acc96da90","2020-05-20T20:00:00Z",90,631,179664,179664,179664,49,10,36,5316,326,5642
"498",20200520,"VA",32908,179718,518,1536,6059,370,NA,202,NA,4523,"A+","5/19/2020 17:00","623fba5248459f3e195740bc92de6bb2c9f50d71","2020-05-20T20:00:00Z",1074,6059,213144,212626,212626,51,33,291,9074,763,9837
"499",20200520,"VI",69,1314,26,NA,NA,NA,NA,NA,NA,61,"C","5/20/2020 07:09","78bf900590db3972c95202b282811d356b3a3da3","2020-05-20T20:00:00Z",6,NA,1409,1383,1383,78,0,0,16,0,16
"500",20200520,"VT",944,24114,NA,15,NA,NA,NA,NA,NA,824,"B","5/20/2020 00:00","8890a2114f65acc0fcf736b0bb25e53c8c321cd2","2020-05-20T20:00:00Z",54,NA,25058,25058,25058,50,0,0,0,0,0
"501",20200520,"WA",19096,283762,NA,168,NA,52,NA,NA,NA,NA,"B","5/19/2020 02:59","61e028f9d0d72bbed073cd771ba35f003d29143d","2020-05-20T20:00:00Z",1031,NA,302858,302858,302858,53,29,0,563,11,574
"502",20200520,"WI",13413,154300,211,609,2161,129,515,NA,NA,7728,"A+","5/20/2020 00:00","f40d43177d7454c3db8819cf8793f45efb4938de","2020-05-20T20:00:00Z",481,2161,167924,167713,167713,55,14,51,6063,528,6591
"503",20200520,"WV",1545,79096,NA,58,NA,16,NA,9,NA,950,"B","5/20/2020 10:00","99c810aa6e8572f1b532c8248b73e3f55b6e080e","2020-05-20T20:00:00Z",69,NA,80641,80641,80641,54,1,0,2304,36,2340
"504",20200520,"WY",787,18053,NA,9,74,NA,NA,NA,NA,528,"C","5/20/2020 16:15","11ca928b33afd498211d12ff699ac8a9fff6b55b","2020-05-20T20:00:00Z",11,74,18840,18840,18840,56,1,1,969,21,990
"505",20200519,"AK",399,35981,NA,16,NA,NA,NA,NA,NA,348,"B","5/19/2020 00:00","a6e64be0dcdb35ea2f5116f626fb9e26da9d98ba","2020-05-19T20:00:00Z",10,NA,36380,36380,36380,2,0,0,769,0,769
"506",20200519,"AL",12376,145190,NA,NA,1453,NA,517,NA,306,NA,"B","5/18/2020 00:00","da768efac6b967b10afef712b89563d433bfa593","2020-05-19T20:00:00Z",504,1453,157566,157566,157566,1,15,37,153,290,443
"507",20200519,"AR",4923,88778,NA,78,535,NA,NA,14,101,3739,"A","5/19/2020 00:00","31b7e799d1d456ef327a06e12e0866aabb9dbad3","2020-05-19T20:00:00Z",102,535,93701,93701,93701,5,2,5,8352,110,8462
"508",20200519,"AS",0,124,NA,NA,NA,NA,NA,NA,NA,NA,"C","5/19/2020 00:00","a6faa2e1ef283fcc8a86234ee19662c95c93290f","2020-05-19T20:00:00Z",0,NA,124,124,124,60,0,0,19,0,19
"509",20200519,"AZ",14566,147005,NA,792,1746,318,NA,201,NA,3693,"A+","5/19/2020 00:00","93c83b05b7ed3f501b76fc8061f3ada8638d5a69","2020-05-19T20:00:00Z",704,1746,161571,161571,161571,4,18,29,4702,396,5098
"510",20200519,"CA",81795,1257521,NA,4363,NA,1307,NA,NA,NA,NA,"B","5/19/2020 00:00","ad1044e4a2c384424aa492acbe2154e655566e10","2020-05-19T20:00:00Z",3334,NA,1339316,1339316,1339316,6,32,0,45279,1365,46644
"511",20200519,"CO",22202,109131,NA,626,3899,NA,NA,NA,NA,3431,"A","5/17/2020 00:00","e4a425151a1d0a17152bd23664a733f14b192e08","2020-05-19T20:00:00Z",1224,3899,131333,131333,131333,8,9,27,2574,264,2838
"512",20200519,"CT",38430,147090,NA,914,10946,NA,NA,NA,NA,6264,"B","5/18/2020 19:00","cc8f6030f80826a8035e5c71331e9d8073a4d3e2","2020-05-19T20:00:00Z",3472,10946,185520,185520,185520,9,23,0,7527,314,7841
"513",20200519,"DC",7434,31940,NA,375,NA,NA,NA,77,NA,1040,"A","5/18/2020 00:00","92ad144f7eb2a87c86c646fddf34f3e3b0fbdbbf","2020-05-19T20:00:00Z",400,NA,39374,39374,39374,11,8,0,1385,164,1549
"514",20200519,"DE",8037,36095,NA,236,NA,NA,NA,NA,NA,3760,"B","5/18/2020 18:00","d80439e262f073e18134dfdb41751616dfd17a91","2020-05-19T20:00:00Z",304,NA,44132,44132,44132,10,7,0,1506,168,1674
"515",20200519,"FL",46944,668911,1369,472,8744,232,NA,NA,NA,NA,"A+","5/19/2020 10:31","1826220a864220a6e25b5be129044e26767d4af8","2020-05-19T20:00:00Z",2129,8744,717224,715855,715855,12,56,191,38941,502,39443
"516",20200519,"GA",38721,339435,NA,986,7027,NA,1589,NA,NA,NA,"A+","5/19/2020 13:00","00a226427f82aa9b1106e15d895458702a0fec3d","2020-05-19T20:00:00Z",1664,7027,378156,378156,378156,13,22,111,13227,640,13867
"517",20200519,"GU",154,4673,NA,NA,NA,NA,NA,NA,NA,126,"C","5/19/2020 05:45","939267589e5b9bb57a94e5d4093f3f660d1f843a","2020-05-19T20:00:00Z",5,NA,4827,4827,4827,66,0,0,104,0,104
"518",20200519,"HI",640,44383,NA,NA,82,NA,NA,NA,NA,574,"B","5/17/2020 00:00","341ed35a11901a989e75cae80527fe67e9525119","2020-05-19T20:00:00Z",17,82,45023,45023,45023,15,0,0,2978,0,2978
"519",20200519,"IA",15349,92299,NA,383,NA,126,NA,83,NA,8130,"A+","5/19/2020 00:00","b7d3b6bd3d0ec0b75537b7f0cc398d924cba1f20","2020-05-19T20:00:00Z",372,NA,107648,107648,107648,19,17,0,4106,394,4500
"520",20200519,"ID",2455,35614,NA,NA,213,NA,89,NA,NA,1649,"B","5/18/2020 19:00","7777263fde8a08771a5af00f9767259958a11d48","2020-05-19T20:00:00Z",74,213,38069,38069,38069,16,1,0,1361,36,1397
"521",20200519,"IL",98030,523654,NA,4002,NA,993,NA,576,NA,NA,"A","5/19/2020 00:00","20ee8a98aea8075e3e622fb394656c33e93c21e0","2020-05-19T20:00:00Z",4379,NA,621684,621684,621684,17,145,0,16898,1545,18443
"522",20200519,"IN",28705,160625,NA,1268,4389,421,990,206,NA,NA,"A+","5/18/2020 23:59","2ac16300adaff2df6ad4bbe17d2643c4bb6f257f","2020-05-19T20:00:00Z",1824,4389,189330,189330,189330,18,59,0,4968,450,5418
"523",20200519,"KS",8340,58650,NA,NA,740,NA,250,NA,115,465,"A","5/18/2020 10:00","a8cf4a1191996cbd2b935b592fed0541b97f242c","2020-05-19T20:00:00Z",173,740,66990,66990,66990,20,0,0,0,0,0
"524",20200519,"KY",8069,145917,NA,447,1980,277,866,NA,NA,2826,"A+","5/19/2020 17:00","79e80ea07072d2a9ad366228cdcd2474ab231b5a","2020-05-19T20:00:00Z",366,1980,153986,153986,153986,21,32,84,23920,381,24301
"525",20200519,"LA",35038,243035,NA,1004,NA,NA,NA,112,NA,26249,"B","5/19/2020 13:00","c648941afd18baa2fe5552138234362adaadd7e4","2020-05-19T20:00:00Z",2581,NA,278073,278073,278073,22,18,0,7996,329,8325
"526",20200519,"MA",87925,389015,NA,2472,8766,672,NA,NA,NA,NA,"A+","5/19/2020 10:00","fac9faee8e84a07de4fe7e5f336f3c7d5c7570ee","2020-05-19T20:00:00Z",5938,8766,476940,476940,476940,25,141,227,14199,1915,16114
"527",20200519,"MD",41546,167112,NA,1421,7199,537,NA,NA,NA,2868,"B","5/19/2020 10:00","1a9c8a84ffcead1a83ac36e4630345b6cac146b7","2020-05-19T20:00:00Z",2081,7199,208658,208658,208658,24,58,113,5368,1784,7152
"528",20200519,"ME",1741,22092,NA,44,225,19,NA,11,NA,1088,"B","5/19/2020 11:30","5490eaf2acab20db9c49b8f38af115e308c86540","2020-05-19T20:00:00Z",73,225,23833,23833,23833,23,2,2,0,28,28
"529",20200519,"MI",52350,370554,NA,1079,NA,486,NA,351,NA,28234,"A+","5/19/2020 11:00","91eb15cd9c5c3b030bf6eceb304e1f07edcf9ac0","2020-05-19T20:00:00Z",5017,NA,422904,422904,422904,26,102,0,12291,435,12726
"530",20200519,"MN",17029,144806,NA,545,2221,229,750,NA,NA,11540,"A+","5/18/2020 17:00","5a05e01d4f5cd85ba962df08829beb4bfb464206","2020-05-19T20:00:00Z",757,2221,161835,161835,161835,27,17,93,4572,657,5229
"531",20200519,"MO",11080,143030,NA,721,NA,NA,NA,103,NA,NA,"B","5/19/2020 15:00","b65c4dd135699e9167a6222a15f990b7e62b83e6","2020-05-19T20:00:00Z",616,NA,154110,154110,154110,29,11,0,2637,135,2772
"532",20200519,"MP",21,3796,NA,NA,NA,NA,NA,NA,NA,13,"D","5/19/2020 00:00","b6a3840e4b6f316ecabc721922d4aeffd5ce20df","2020-05-19T20:00:00Z",2,NA,3817,3817,3817,69,0,0,397,0,397
"533",20200519,"MS",11704,106056,NA,611,1840,153,NA,87,NA,7681,"A","5/18/2020 19:00","b0ef85c7dbd6395f2f3b20a36ba7a9a19e78d385","2020-05-19T20:00:00Z",554,1840,117760,117760,117760,28,26,35,1721,272,1993
"534",20200519,"MT",471,28479,NA,5,65,NA,NA,NA,NA,437,"B","5/19/2020 00:00","594a65cefc3118f5aaa66b60198a8c32892e5e5a","2020-05-19T20:00:00Z",16,65,28950,28950,28950,30,0,1,782,1,783
"535",20200519,"NC",19700,245308,NA,585,NA,NA,NA,NA,NA,11637,"A","5/19/2020 14:00","a72347562abef512e54cbe7193193d3db0ecf1e9","2020-05-19T20:00:00Z",691,NA,265008,265008,265008,37,30,0,8576,677,9253
"536",20200519,"ND",1994,55737,NA,32,135,NA,NA,NA,NA,1269,"C","5/19/2020 13:00","ef2518560bf19d40d014e7591ffd90126d437848","2020-05-19T20:00:00Z",45,135,57731,57731,57731,38,1,2,1107,63,1170
"537",20200519,"NE",10625,59359,NA,NA,NA,NA,NA,NA,NA,NA,"C","5/18/2020 20:00","7beac64c4470d7aba2cb6330532e3e4613e5c9b6","2020-05-19T20:00:00Z",125,NA,69984,69984,69984,31,2,0,2206,277,2483
"538",20200519,"NH",3652,45822,874,109,368,NA,109,NA,NA,1269,"B","5/18/2020 09:00","8c2b7fc889b12a4d87ad2183b3b6607932155e5b","2020-05-19T20:00:00Z",172,368,50348,49474,49474,33,0,9,4540,56,4596
"539",20200519,"NJ",149013,371169,NA,3481,NA,977,NA,789,NA,23657,"A+","5/19/2020 13:00","3c01d496dd178d7a0d9b550d33b3fb3266aa39e2","2020-05-19T20:00:00Z",10586,NA,520182,520182,520182,34,151,0,13639,974,14613
"540",20200519,"NM",6096,131524,NA,213,886,NA,NA,NA,NA,1796,"C","5/18/2020 18:05","01991644c041f5c342ee9f3c1d743be67b21a2bc","2020-05-19T20:00:00Z",270,886,137620,137620,137620,35,5,0,4209,158,4367
"541",20200519,"NV",7046,80509,NA,405,NA,106,NA,54,NA,334,"B","5/19/2020 10:00","2486aaec39f0323aa2aabd4d973c75d91113bfba","2020-05-19T20:00:00Z",365,NA,87555,87555,87555,32,15,0,5583,140,5723
"542",20200519,"NY",352845,1114894,NA,5818,76168,1836,NA,1481,NA,61886,"A","5/19/2020 00:00","84401a74545d19541faeed8beb09060d06a2d16d","2020-05-19T20:00:00Z",22843,76168,1467739,1467739,1467739,36,114,298,26708,1474,28182
"543",20200519,"OH",28952,248650,NA,913,5117,365,1357,234,NA,NA,"B","5/19/2020 14:00","4d85dd0867c5c446dab6497062672bec2aedfaef","2020-05-19T20:00:00Z",1720,5117,277602,277602,277602,39,63,119,5255,498,5753
"544",20200519,"OK",5489,133658,NA,167,897,77,NA,NA,NA,4135,"A+","5/19/2020 00:00","509000f13b9a0c756930d6be3edd3acf6205bfd5","2020-05-19T20:00:00Z",294,897,139147,139147,139147,40,6,12,15496,91,15587
"545",20200519,"OR",3726,95994,NA,137,714,43,NA,13,NA,1406,"A+","5/19/2020 11:00","222f371991a6b98dd31453521b89140625de29e8","2020-05-19T20:00:00Z",140,714,99720,99720,99720,41,2,6,2366,39,2405
"546",20200519,"PA",63666,286034,NA,1861,NA,NA,NA,380,NA,NA,"B","5/18/2020 00:00","d6cbdd3023cefde35bcdc7c96b95601cf362d3ee","2020-05-19T20:00:00Z",4624,NA,349700,349700,349700,42,119,0,8481,610,9091
"547",20200519,"PR",2805,NA,NA,NA,NA,20,NA,8,NA,NA,"C","5/19/2020 05:52","798325aa6fb04f713d3ed32cb15ed67b6fa91571","2020-05-19T20:00:00Z",124,NA,2805,2805,2805,72,0,0,0,95,95
"548",20200519,"RI",12951,104295,NA,247,1464,59,NA,44,NA,1023,"A+","5/19/2020 12:00","0b46513d6f108a6cb38e6e90376b9f572d006918","2020-05-19T20:00:00Z",532,1464,117246,117246,117246,44,26,26,1706,156,1862
"549",20200519,"SC",9056,126007,NA,NA,1444,NA,NA,NA,NA,5451,"A","5/19/2020 16:00","1012b6dcb4873da74e5d4b8f4b22a9c34b0ad1cd","2020-05-19T20:00:00Z",399,1444,135063,135063,135063,45,8,23,3390,114,3504
"550",20200519,"SD",4085,25624,NA,75,327,NA,NA,NA,NA,2914,"B","5/18/2020 18:00","065ca3add179e759db596b2e1101d59373f7ab47","2020-05-19T20:00:00Z",46,327,29709,29709,29709,46,2,11,606,58,664
"551",20200519,"TN",18378,327745,NA,NA,1498,NA,NA,NA,NA,10969,"A","5/19/2020 15:00","6c82d9ab5dc36e78f8b7ffd1203784f1e4bae7ac","2020-05-19T20:00:00Z",305,1498,346123,346123,346123,47,4,9,8328,367,8695
"552",20200519,"TX",49912,650234,NA,1732,NA,NA,NA,NA,NA,29359,"A","5/19/2020 16:50","92e5c7b09ddf973c465c1fea3fb28f7801109075","2020-05-19T20:00:00Z",1369,NA,700146,700146,700146,48,22,0,19082,1219,20301
"553",20200519,"UT",7384,166638,NA,179,595,NA,197,NA,84,4183,"B","5/18/2020 10:29","bc6bf9ba3246a5b5f06d2ecca5f260e956fa5fea","2020-05-19T20:00:00Z",80,595,174022,174022,174022,49,0,0,0,0,0
"554",20200519,"VA",32145,170644,473,1497,5768,377,NA,199,NA,4271,"A+","5/18/2020 17:00","227ab934ee80ad38289b9ea0e90f767fcf7af65c","2020-05-19T20:00:00Z",1041,5768,203262,202789,202789,51,27,159,5558,1005,6563
"555",20200519,"VI",69,1298,17,NA,NA,NA,NA,NA,NA,61,"C","5/19/2020 06:34","bdf2f85c14cb02420f24c84469a8e818ffe052c4","2020-05-19T20:00:00Z",6,NA,1384,1367,1367,78,0,0,20,0,20
"556",20200519,"VT",944,24114,NA,24,NA,NA,NA,NA,NA,820,"B","5/19/2020 00:00","c74d33160c94fb7cc78ed089de3b120c9086a6df","2020-05-19T20:00:00Z",54,NA,25058,25058,25058,50,0,0,567,0,567
"557",20200519,"WA",19085,283199,NA,168,NA,52,NA,NA,NA,NA,"A","5/18/2020 02:59","522e115c3bde8efc27810691c368c195e812e8d9","2020-05-19T20:00:00Z",1002,NA,302284,302284,302284,53,1,0,2960,66,3026
"558",20200519,"WI",12885,148237,211,609,2110,129,503,NA,NA,7371,"A+","5/19/2020 00:00","658370d99840ae09dd846a5040fd91fa70e508cb","2020-05-19T20:00:00Z",467,2110,161333,161122,161122,55,8,42,3735,198,3933
"559",20200519,"WV",1509,76792,NA,54,NA,18,NA,9,NA,922,"B","5/19/2020 10:00","9b7358d385ceac53b68bee8b0fc3d0e8791684f8","2020-05-19T20:00:00Z",68,NA,78301,78301,78301,54,1,0,2248,18,2266
"560",20200519,"WY",766,17084,NA,8,73,NA,NA,NA,NA,504,"B","5/18/2020 00:00","158314945e235e3e6033a906c941e5f3f92abbee","2020-05-19T20:00:00Z",10,73,17850,17850,17850,56,2,0,753,12,765
"561",20200518,"AK",399,35212,NA,9,NA,NA,NA,NA,NA,345,"B","5/18/2020 00:00","b3ccfa9231cf1d4225bef777e18aef9279196f72","2020-05-18T20:00:00Z",10,NA,35611,35611,35611,2,0,0,957,3,960
"562",20200518,"AL",12086,145037,NA,NA,1416,NA,512,NA,302,NA,"B","5/18/2020 00:00","5b2cfe9999f12edaaadf251db01027248479f4b9","2020-05-18T20:00:00Z",489,1416,157123,157123,157123,1,1,24,458,315,773
"563",20200518,"AR",4813,80426,NA,77,530,NA,NA,12,101,3645,"A","5/18/2020 00:00","a1fc38a56f67ed2a8ff4225276f3fd91a77308f4","2020-05-18T20:00:00Z",100,530,85239,85239,85239,5,2,10,0,54,54
"564",20200518,"AS",0,105,NA,NA,NA,NA,NA,NA,NA,NA,"C","5/10/2020 00:00","bb4faca167517d155c2456a9c9ab3db494c094b4","2020-05-18T20:00:00Z",0,NA,105,105,105,60,0,0,0,0,0
"565",20200518,"AZ",14170,142303,NA,820,1717,329,NA,200,NA,3570,"A+","5/18/2020 00:00","02c1b4f1b08529a66b998e389dec4466b306a4e6","2020-05-18T20:00:00Z",686,1717,156473,156473,156473,4,6,18,4479,233,4712
"566",20200518,"CA",80430,1212242,NA,4391,NA,1325,NA,NA,NA,NA,"B","5/17/2020 00:00","a4c726f97ca716cb19c945927806f45e0bb3cbea","2020-05-18T20:00:00Z",3302,NA,1292672,1292672,1292672,6,41,0,55838,1591,57429
"567",20200518,"CO",21938,106557,NA,650,3872,NA,NA,NA,NA,3346,"A","5/16/2020 00:00","6b63ab17f120d5e9edef21b5bbc109a21d330e97","2020-05-18T20:00:00Z",1215,3872,128495,128495,128495,8,23,6,2642,305,2947
"568",20200518,"CT",38116,139563,NA,920,10946,NA,NA,NA,NA,6264,"B","5/17/2020 20:30","61f61760e371fd4e3b08ceaf3b853f96858ec521","2020-05-18T20:00:00Z",3449,10946,177679,177679,177679,9,41,0,6375,697,7072
"569",20200518,"DC",7270,30555,NA,374,NA,NA,NA,70,NA,1028,"A","5/17/2020 00:00","85ce1b3271226f1eb141c4c81f1fa6cac6e441d1","2020-05-18T20:00:00Z",392,NA,37825,37825,37825,11,9,0,1152,147,1299
"570",20200518,"DE",7869,34589,NA,240,NA,NA,NA,NA,NA,3545,"B","5/17/2020 18:00","e1e7d0f5c4bd71480c90a3be930c23056bf6b6ff","2020-05-18T20:00:00Z",297,NA,42458,42458,42458,10,7,0,1394,199,1593
"571",20200518,"FL",46442,629970,1346,472,8553,232,NA,NA,NA,NA,"A+","5/18/2020 09:28","d655a24232ba199c8d3accf4c58fb3e343e7ae21","2020-05-18T20:00:00Z",2073,8553,677758,676412,676412,12,24,75,23766,854,24620
"572",20200518,"GA",38081,326208,NA,1025,6916,NA,1565,NA,NA,NA,"A+","5/18/2020 13:00","1e46a0334a6f47d211cdd2330e57601c566d3dc3","2020-05-18T20:00:00Z",1642,6916,364289,364289,364289,13,36,126,12734,380,13114
"573",20200518,"GU",154,4569,NA,NA,NA,NA,NA,NA,NA,126,"C","5/16/2020 04:30","b3894e885c0148326056081afdcfa2e6eabe079e","2020-05-18T20:00:00Z",5,NA,4723,4723,4723,66,0,0,119,0,119
"574",20200518,"HI",640,41405,NA,NA,82,NA,NA,NA,NA,573,"B","5/17/2020 00:00","74d86a5df0f1a48eff09b72d5052ec2ad6665abc","2020-05-18T20:00:00Z",17,82,42045,42045,42045,15,0,0,370,1,371
"575",20200518,"IA",14955,88193,NA,382,NA,121,NA,85,NA,7324,"A+","5/17/2020 13:00","f401b39ad0693c21562bdb03b414482fed33e182","2020-05-18T20:00:00Z",355,NA,103148,103148,103148,19,4,0,2603,304,2907
"576",20200518,"ID",2419,34253,NA,NA,213,NA,89,NA,NA,1612,"B","5/16/2020 19:00","2983fd157f7300a700929768358b22039cf5d916","2020-05-18T20:00:00Z",73,213,36672,36672,36672,16,0,0,0,0,0
"577",20200518,"IL",96485,506756,NA,4120,NA,1096,NA,636,NA,NA,"A","5/18/2020 00:59","b8244579a51ceaf3c75df057dfe600686fa83b4a","2020-05-18T20:00:00Z",4234,NA,603241,603241,603241,17,57,0,19003,2294,21297
"578",20200518,"IN",28255,155657,NA,1244,4389,426,990,212,NA,NA,"A+","5/17/2020 23:59","9f5ed277223fc4aeaa539e2398d3b72394fedd55","2020-05-18T20:00:00Z",1765,4389,183912,183912,183912,18,14,0,6192,477,6669
"579",20200518,"KS",8340,58650,NA,NA,740,NA,250,NA,115,465,"A","5/18/2020 10:00","57f5aa39168f003b464c8939e435089b21596a40","2020-05-18T20:00:00Z",173,740,66990,66990,66990,20,1,16,4944,454,5398
"580",20200518,"KY",7688,121997,NA,381,1896,218,797,NA,NA,2768,"A+","5/16/2020 17:19","bbc248dee1f365eb947a8c7e1533fd22e9e814b3","2020-05-18T20:00:00Z",334,1896,129685,129685,129685,21,0,0,0,0,0
"581",20200518,"LA",34709,235039,NA,1031,NA,NA,NA,118,NA,26249,"B","5/18/2020 13:00","262daea05432ee16b7615659a9c2211f852b79f6","2020-05-18T20:00:00Z",2563,NA,269748,269748,269748,22,72,0,4301,277,4578
"582",20200518,"MA",86010,374816,NA,2597,8539,702,NA,NA,NA,NA,"A+","5/17/2020 10:00","7d19fbf3be434c0bc4af0894ac0300d3731e1239","2020-05-18T20:00:00Z",5797,8539,460826,460826,460826,25,0,0,0,0,0
"583",20200518,"MD",39762,161744,NA,1447,7086,555,NA,NA,NA,2817,"B","5/18/2020 10:00","e369d504a5e54cdb5111d1869f3417bd95f5d015","2020-05-18T20:00:00Z",2023,7086,201506,201506,201506,24,31,93,5622,958,6580
"584",20200518,"ME",1713,22092,NA,42,223,16,NA,10,NA,1053,"B","5/18/2020 12:15","1dec2adb62139c5dd7f8f83d925ded3f4f1adea7","2020-05-18T20:00:00Z",71,223,23805,23805,23805,23,1,7,0,26,26
"585",20200518,"MI",51915,358263,NA,1075,NA,473,NA,418,NA,28234,"A+","5/18/2020 11:00","1c42e7d17a41be59313595a01a457da9bfd24551","2020-05-18T20:00:00Z",4915,NA,410178,410178,410178,26,24,0,12447,773,13220
"586",20200518,"MN",16372,140234,NA,488,2128,229,731,NA,NA,10764,"A+","5/17/2020 17:00","9da7fabf094cdfe74748f834aa430603c126c592","2020-05-18T20:00:00Z",740,2128,156606,156606,156606,27,9,38,5317,704,6021
"587",20200518,"MO",10945,140393,NA,570,NA,NA,NA,91,NA,NA,"B","5/18/2020 15:00","99b7dbaaf87d66c48cf6609e107c4fab00bf2cb1","2020-05-18T20:00:00Z",605,NA,151338,151338,151338,29,11,0,4927,156,5083
"588",20200518,"MP",21,3399,NA,NA,NA,NA,NA,NA,NA,12,"D","5/18/2020 00:00","503a9c4190cc900e012f12368b1c60946a23f0f8","2020-05-18T20:00:00Z",2,NA,3420,3420,3420,69,0,0,81,0,81
"589",20200518,"MS",11432,104335,NA,559,1805,141,NA,75,NA,7681,"A","5/17/2020 19:00","dec246c0223df492f414005653860e9047276f91","2020-05-18T20:00:00Z",528,1805,115767,115767,115767,28,7,32,2505,136,2641
"590",20200518,"MT",470,27697,NA,4,64,NA,NA,NA,NA,434,"B","5/18/2020 00:00","aedd55fbadfbe3d1e8ff4dad5c7a9dfc3124d940","2020-05-18T20:00:00Z",16,64,28167,28167,28167,30,0,1,1280,2,1282
"591",20200518,"NC",19023,236732,NA,511,NA,NA,NA,NA,NA,11637,"A","5/18/2020 11:00","513d24870fbaf0eb3f49e4b5da7298e4fc2ca05f","2020-05-18T20:00:00Z",661,NA,255755,255755,255755,37,2,0,6300,511,6811
"592",20200518,"ND",1931,54630,NA,32,133,NA,NA,NA,NA,1219,"C","5/18/2020 13:00","a066d02c602f753e043d52019887772dde64a142","2020-05-18T20:00:00Z",44,133,56561,56561,56561,38,1,3,1309,31,1340
"593",20200518,"NE",10348,57153,NA,NA,NA,NA,NA,NA,NA,NA,"C","5/17/2020 20:00","e13e73f97593d330d40ea184c240290509605ad4","2020-05-18T20:00:00Z",123,NA,67501,67501,67501,31,0,0,1733,128,1861
"594",20200518,"NH",3596,41282,1481,114,359,NA,109,NA,NA,1268,"B","5/18/2020 09:00","ee3c53d27dcbb35e8dae13cd8697c4077ca5ed09","2020-05-18T20:00:00Z",172,359,46359,44878,44878,33,1,12,86,40,126
"595",20200518,"NJ",148039,357530,NA,3509,NA,1053,NA,819,NA,23496,"A+","5/18/2020 13:00","9fd971392a15734029c07e9cd8e5b37935afb141","2020-05-18T20:00:00Z",10435,NA,505569,505569,505569,34,79,0,16299,1705,18004
"596",20200518,"NM",5938,127315,NA,211,886,NA,NA,NA,NA,1755,"C","5/17/2020 17:29","56b07b5a997fc8eaa080c32e1bbc9e91e1873e63","2020-05-18T20:00:00Z",265,886,133253,133253,133253,35,6,0,4588,81,4669
"597",20200518,"NV",6906,74926,NA,423,NA,105,NA,65,NA,355,"B","5/18/2020 11:00","cfe236e5059ddf193978f33d787dd38f82419077","2020-05-18T20:00:00Z",350,NA,81832,81832,81832,32,1,0,1146,49,1195
"598",20200518,"NY",351371,1088186,NA,5840,75870,1908,NA,1538,NA,61681,"A","5/18/2020 00:00","46fa5352dd39fe8d99308c648d0ba385f1fd5f4c","2020-05-18T20:00:00Z",22729,75870,1439557,1439557,1439557,36,110,345,24911,1250,26161
"599",20200518,"OH",28454,243395,NA,912,4998,367,1328,247,NA,NA,"B","5/18/2020 14:00","3be87dc6dc45a488db9574631a8f7e49e8e9f56e","2020-05-18T20:00:00Z",1657,4998,271849,271849,271849,39,32,77,6856,531,7387
"600",20200518,"OK",5398,118162,NA,76,885,45,NA,NA,NA,4008,"A+","5/18/2020 00:00","35edd4c0871466b93d9730ca049be2c5ad7c7ea7","2020-05-18T20:00:00Z",288,885,123560,123560,123560,40,0,5,0,88,88
"601",20200518,"OR",3687,93628,NA,137,708,43,NA,13,NA,1406,"A+","5/18/2020 11:00","76df4b3283b6de456af6ebbaa60d708ded327e06","2020-05-18T20:00:00Z",138,708,97315,97315,97315,41,1,5,2895,64,2959
"602",20200518,"PA",63056,277553,NA,1885,NA,NA,NA,397,NA,NA,"C","5/18/2020 00:00","2dd6c2680ac73b0f4d35d7442131b55ce6dc91a5","2020-05-18T20:00:00Z",4505,NA,340609,340609,340609,42,87,0,6883,822,7705
"603",20200518,"PR",2710,NA,NA,NA,NA,17,NA,4,NA,NA,"C","5/18/2020 06:30","9dcfdb48a759e73d65f2a9f94b6f909d67c4f774","2020-05-18T20:00:00Z",124,NA,2710,2710,2710,72,1,0,0,64,64
"604",20200518,"RI",12795,102589,NA,236,1438,62,NA,46,NA,1012,"A+","5/18/2020 12:00","97ab361477f2225295dbba0fdcff556235db102e","2020-05-18T20:00:00Z",506,1438,115384,115384,115384,44,7,20,2713,121,2834
"605",20200518,"SC",8942,122617,NA,NA,1421,NA,NA,NA,NA,5076,"A","5/18/2020 16:15","3a4d210f2121c07bb57c1f757389342753772472","2020-05-18T20:00:00Z",391,1421,131559,131559,131559,45,11,0,10947,126,11073
"606",20200518,"SD",4027,25018,NA,77,316,NA,NA,NA,NA,2784,"B","5/18/2020 11:30","2f3d1de74a0b1039b0fbd5af8bd753813ad4654c","2020-05-18T20:00:00Z",44,316,29045,29045,29045,46,0,4,446,40,486
"607",20200518,"TN",18011,319417,NA,NA,1489,NA,NA,NA,NA,9886,"A","5/18/2020 15:00","96485679354c2b9efe219694dad92b358bd9df9b","2020-05-18T20:00:00Z",301,1489,337428,337428,337428,47,3,7,11525,623,12148
"608",20200518,"TX",48693,631152,NA,1551,NA,NA,NA,NA,NA,28371,"A","5/18/2020 16:25","90ff8b922079b122a5819f4b1a240d7b98706490","2020-05-18T20:00:00Z",1347,NA,679845,679845,679845,48,11,0,28581,909,29490
"609",20200518,"UT",7384,166638,NA,179,595,NA,197,NA,84,4183,"B","5/18/2020 10:29","9c7fabdd050ddb48c0a603ea72a5b84a9016261a","2020-05-18T20:00:00Z",80,595,174022,174022,174022,49,0,9,3124,146,3270
"610",20200518,"VA",31140,165086,530,1502,5609,361,NA,194,NA,4107,"A+","5/17/2020 17:00","1e1fe4a432656ba6b5ba356a6ff1f3c68bf59ef3","2020-05-18T20:00:00Z",1014,5609,196756,196226,196226,51,5,92,5113,752,5865
"611",20200518,"VI",69,1278,45,NA,NA,NA,NA,NA,NA,61,"C","5/17/2020 18:35","92c7eb24a740b63009dd06d505b3636a9721b27e","2020-05-18T20:00:00Z",6,NA,1392,1347,1347,78,0,0,0,0,0
"612",20200518,"VT",944,23547,NA,22,NA,NA,NA,NA,NA,815,"B","5/18/2020 00:00","187e17dd85357c0273b6a4cf95f2ff7e78925109","2020-05-18T20:00:00Z",54,NA,24491,24491,24491,50,0,0,573,4,577
"613",20200518,"WA",19019,280239,NA,168,NA,52,NA,NA,NA,NA,"A","5/17/2020 02:59","9eef0b139c09c5641419b2d90a7927c5765cf922","2020-05-18T20:00:00Z",1001,NA,299258,299258,299258,53,1,0,4957,114,5071
"614",20200518,"WI",12687,144502,194,574,2068,128,496,NA,NA,6786,"A+","5/18/2020 00:00","a8710b6400500653e80c1ddfb0af62c2b6cb8d36","2020-05-18T20:00:00Z",459,2068,157383,157189,157189,55,6,30,4828,144,4972
"615",20200518,"WV",1491,74544,NA,48,NA,11,NA,7,NA,919,"B","5/18/2020 10:00","b3e5bf52466ac10031975091fd6e25c5da459f9a","2020-05-18T20:00:00Z",67,NA,76035,76035,76035,54,0,0,544,1,545
"616",20200518,"WY",754,16331,NA,8,73,NA,NA,NA,NA,498,"B","5/17/2020 00:00","94b760d56d11bb9d2988c9f7ec46894613abc7b4","2020-05-18T20:00:00Z",8,73,17085,17085,17085,56,0,3,0,0,0
"617",20200517,"AK",396,34255,NA,13,NA,NA,NA,NA,NA,344,"B","5/17/2020 00:00","65ce5b20ebcfe9a6260ba1d15a840072474f3924","2020-05-17T20:00:00Z",10,NA,34651,34651,34651,2,0,0,1366,4,1370
"618",20200517,"AL",11771,144579,NA,NA,1392,NA,504,NA,296,NA,"B","5/16/2020 00:00","540fc4ecea85eb597ddf161ce4bc54e4e9b780a6","2020-05-17T20:00:00Z",488,1392,156350,156350,156350,1,3,5,2608,248,2856
"619",20200517,"AR",4759,80426,NA,65,520,NA,NA,9,101,3590,"A","5/17/2020 00:00","28092115d4cbcaa02ed0184e52163f38412774e3","2020-05-17T20:00:00Z",98,520,85185,85185,85185,5,0,0,3360,181,3541
"620",20200517,"AS",0,105,NA,NA,NA,NA,NA,NA,NA,NA,"C","5/10/2020 00:00","25ede1d0f7b90a1989a45a025463b8d1a63f3ce3","2020-05-17T20:00:00Z",0,NA,105,105,105,60,0,0,0,0,0
"621",20200517,"AZ",13937,137824,NA,796,1699,337,NA,201,NA,3450,"A+","5/17/2020 00:00","cb43c97c57f170e9df1177fb0c9a53c6ba6a9fe6","2020-05-17T20:00:00Z",680,1699,151761,151761,151761,4,1,16,4667,306,4973
"622",20200517,"CA",78839,1156404,NA,4291,NA,1293,NA,NA,NA,NA,"B","5/17/2020 00:00","efe3d2e04569547fc50e7c3d8084f6f4ea4d4cc7","2020-05-17T20:00:00Z",3261,NA,1235243,1235243,1235243,6,57,0,54071,2046,56117
"623",20200517,"CO",21633,103915,NA,650,3866,NA,NA,NA,NA,3346,"A","5/15/2020 00:00","92fd0516c0ba23629efb451d09f1eace6475f37c","2020-05-17T20:00:00Z",1192,3866,125548,125548,125548,8,42,24,3307,401,3708
"624",20200517,"CT",37419,133188,NA,937,10946,NA,NA,NA,NA,6264,"B","5/16/2020 20:30","e39cea4086461938bd535d666b8175309784d70d","2020-05-17T20:00:00Z",3408,10946,170607,170607,170607,9,69,0,5136,716,5852
"625",20200517,"DC",7123,29403,NA,369,NA,NA,NA,74,NA,1023,"A","5/16/2020 00:00","0be2a2f3324c58b61fe672bc9083a47d5edfdc28","2020-05-17T20:00:00Z",383,NA,36526,36526,36526,11,8,0,913,81,994
"626",20200517,"DE",7670,33195,NA,229,NA,NA,NA,NA,NA,3478,"B","5/17/2020 11:57","af520571eed3b129bb32d06060325add7ab5135a","2020-05-17T20:00:00Z",290,NA,40865,40865,40865,10,4,0,984,123,1107
"627",20200517,"FL",45588,606204,1479,472,8478,232,NA,NA,NA,NA,"A+","5/17/2020 10:08","5b4835bb4b4216c78e687d24b8d1bd0bb87306aa","2020-05-17T20:00:00Z",2049,8478,653271,651792,651792,12,9,85,20968,777,21745
"628",20200517,"GA",37701,313474,NA,1010,6790,NA,1557,NA,NA,NA,"A+","5/17/2020 13:00","50c47abbf5882a9406b82bb459ac2f89ec742a27","2020-05-17T20:00:00Z",1606,6790,351175,351175,351175,13,14,55,29552,554,30106
"629",20200517,"GU",154,4450,NA,NA,NA,NA,NA,NA,NA,126,"C","5/16/2020 04:30","0e427eb8db13720a7d15bbd6191814b59a05e3fc","2020-05-17T20:00:00Z",5,NA,4604,4604,4604,66,0,0,85,0,85
"630",20200517,"HI",639,41035,NA,NA,82,NA,NA,NA,NA,572,"B","5/16/2020 18:00","76811d19b76495184c8d5e7da131d9466deb73fa","2020-05-17T20:00:00Z",17,82,41674,41674,41674,15,0,1,790,1,791
"631",20200517,"IA",14651,85590,NA,376,NA,124,NA,85,NA,7154,"A+","5/16/2020 13:00","f963862b996b61fb24eca2d72ccdce87ceff78fc","2020-05-17T20:00:00Z",351,NA,100241,100241,100241,19,5,0,3618,323,3941
"632",20200517,"ID",2419,34253,NA,NA,213,NA,89,NA,NA,1612,"B","5/16/2020 19:00","c02b7bdc243dcd84ced0a47a37b3447617718f05","2020-05-17T20:00:00Z",73,213,36672,36672,36672,16,0,0,954,30,984
"633",20200517,"IL",94191,487753,NA,4190,NA,1144,NA,735,NA,NA,"A","5/17/2020 00:00","066bf29c654c015e7a712884a37cbcf9ab02ee61","2020-05-17T20:00:00Z",4177,NA,581944,581944,581944,17,48,0,18561,1734,20295
"634",20200517,"IN",27778,149465,NA,1246,4389,441,990,205,NA,NA,"A+","5/16/2020 23:59","370425930245713eaf4ab036c5043c16ac39f0b7","2020-05-17T20:00:00Z",1751,4389,177243,177243,177243,18,10,0,5387,498,5885
"635",20200517,"KS",7886,53706,NA,NA,724,NA,246,NA,112,443,"A","5/15/2020 10:00","1ae19998b9836ea3a30dfa0a0245ec6d4a162ab8","2020-05-17T20:00:00Z",172,724,61592,61592,61592,20,0,0,0,0,0
"636",20200517,"KY",7688,121997,NA,381,1896,218,797,NA,NA,2768,"A+","5/16/2020 17:19","a864ee71b15b969194a8b89c5d36f95916bf3077","2020-05-17T20:00:00Z",334,1896,129685,129685,129685,21,2,0,1707,244,1951
"637",20200517,"LA",34432,230738,NA,1019,NA,NA,NA,111,NA,22608,"B","5/17/2020 13:00","0eb37699053395eeec68eef15a22eb7e17998941","2020-05-17T20:00:00Z",2491,NA,265170,265170,265170,22,12,0,5113,315,5428
"638",20200517,"MA",86010,374816,NA,2597,8539,702,NA,NA,NA,NA,"A+","5/17/2020 10:00","3ee5dc3a064857c633de13fcf0d4e9d3e80f262e","2020-05-17T20:00:00Z",5797,8539,460826,460826,460826,25,92,83,11660,1077,12737
"639",20200517,"MD",38804,156122,NA,1460,6993,562,NA,NA,NA,2816,"B","5/17/2020 10:00","1eda322e2fde28831e2b8c534d89c716cdfd041a","2020-05-17T20:00:00Z",1992,6993,194926,194926,194926,24,35,238,3915,836,4751
"640",20200517,"ME",1687,22092,NA,37,216,16,NA,11,NA,1028,"B","5/17/2020 11:30","019aefc12708232fd38f9a3c8250553b6ce8cfd0","2020-05-17T20:00:00Z",70,216,23779,23779,23779,23,0,2,0,39,39
"641",20200517,"MI",51142,345816,NA,1114,NA,488,NA,434,NA,28234,"A+","5/16/2020 11:00","afa5e6a23217b238cbf9b76fdb8e431afba9ba3f","2020-05-17T20:00:00Z",4891,NA,396958,396958,396958,26,11,0,38399,638,39037
"642",20200517,"MN",15668,134917,NA,487,2090,221,716,NA,NA,10175,"A+","5/16/2020 17:00","2b5d044039c4633ebd06cfc705cc607357ab6535","2020-05-17T20:00:00Z",731,2090,150585,150585,150585,27,22,51,6605,699,7304
"643",20200517,"MO",10789,135466,NA,775,NA,NA,NA,116,NA,NA,"B","5/17/2020 15:00","d53a5240bcbfd8ee5879991d1b8118413c7ec932","2020-05-17T20:00:00Z",594,NA,146255,146255,146255,29,5,0,6801,114,6915
"644",20200517,"MP",21,3318,NA,NA,NA,NA,NA,NA,NA,12,"D","5/16/2020 00:00","3bd2f352ea2d32d232e70ba958174c3eef76c1e1","2020-05-17T20:00:00Z",2,NA,3339,3339,3339,69,0,0,0,0,0
"645",20200517,"MS",11296,101830,NA,608,1773,158,NA,81,NA,6268,"A","5/16/2020 19:00","60b23dfc42bf80c51d2e94541429c32677047acc","2020-05-17T20:00:00Z",521,1773,113126,113126,113126,28,11,25,4477,173,4650
"646",20200517,"MT",468,26417,NA,3,63,NA,NA,NA,NA,431,"B","5/17/2020 00:00","ff771f7abaa79ff6458360c6f8af771dc6607f05","2020-05-17T20:00:00Z",16,63,26885,26885,26885,30,0,0,794,0,794
"647",20200517,"NC",18512,230432,NA,493,NA,NA,NA,NA,NA,9115,"A","5/17/2020 11:00","bcb44ec6dd0d583582c78f0f9b9da5660a8d8f08","2020-05-17T20:00:00Z",659,NA,248944,248944,248944,37,7,0,9828,530,10358
"648",20200517,"ND",1900,53321,NA,30,130,NA,NA,NA,NA,1178,"C","5/17/2020 13:00","a8d20aa9876b5d472628a95749091307c2117524","2020-05-17T20:00:00Z",43,130,55221,55221,55221,38,1,0,1682,52,1734
"649",20200517,"NE",10220,55420,NA,NA,NA,NA,NA,NA,NA,NA,"C","5/16/2020 18:15","7c50194650a79122ae543459a1168a556a82b27e","2020-05-17T20:00:00Z",123,NA,65640,65640,65640,31,4,0,5214,448,5662
"650",20200517,"NH",3556,41196,1216,115,347,NA,109,NA,NA,1258,"B","5/16/2020 09:00","bf07c588817b4f92aae46d71691ea63f79042571","2020-05-17T20:00:00Z",171,347,45968,44752,44752,33,12,12,1984,92,2076
"651",20200517,"NJ",146334,341231,NA,3411,NA,1030,NA,819,NA,23299,"A+","5/17/2020 13:00","7a422af8f551e1f526391977393630697a5f6e7e","2020-05-17T20:00:00Z",10356,NA,487565,487565,487565,34,107,0,11096,1245,12341
"652",20200517,"NM",5857,122727,NA,208,886,NA,NA,NA,NA,1739,"C","5/16/2020 18:05","2f144e87a3cb344b4b7ea05e40b724a4f61424c1","2020-05-17T20:00:00Z",259,886,128584,128584,128584,35,6,0,3931,195,4126
"653",20200517,"NV",6857,73780,NA,423,NA,105,NA,65,NA,272,"B","5/17/2020 11:00","453b9500d39ee3f54e47dd5880e6b0c5483bc03e","2020-05-17T20:00:00Z",349,NA,80637,80637,80637,32,4,0,6778,195,6973
"654",20200517,"NY",350121,1063275,NA,5897,75525,1981,NA,1601,NA,61381,"A","5/17/2020 00:00","dc9b0a8798647b7ae586f484f778baef168b1936","2020-05-17T20:00:00Z",22619,75525,1413396,1413396,1413396,36,141,362,32790,1889,34679
"655",20200517,"OH",27923,236539,NA,914,4921,343,1305,230,NA,NA,"B","5/17/2020 14:00","bc090dcb6a60e739bae718c2cac30897fa63cc2b","2020-05-17T20:00:00Z",1625,4921,264462,264462,264462,39,15,51,17311,449,17760
"656",20200517,"OK",5310,118162,NA,180,880,73,NA,NA,NA,3983,"A+","5/17/2020 00:00","7260960881fb8d20695c84bee427bab0fb53af00","2020-05-17T20:00:00Z",288,880,123472,123472,123472,40,0,2,0,73,73
"657",20200517,"OR",3623,90733,NA,156,703,37,NA,16,NA,1406,"A+","5/17/2020 11:00","c049266a675510772272907c4a9778e017dea12c","2020-05-17T20:00:00Z",137,703,94356,94356,94356,41,0,4,2146,11,2157
"658",20200517,"PA",62234,270670,NA,1821,NA,NA,NA,422,NA,NA,"C","5/17/2020 00:00","fe7fbf6fb00f11f6a7828b86fbf1bffc4dda9970","2020-05-17T20:00:00Z",4418,NA,332904,332904,332904,42,15,0,4445,623,5068
"659",20200517,"PR",2646,NA,NA,NA,NA,24,NA,5,NA,NA,"C","5/17/2020 05:51","67605ea1a500468d51da3fc7775fac72c0a325fd","2020-05-17T20:00:00Z",123,NA,2646,2646,2646,72,1,0,0,57,57
"660",20200517,"RI",12674,99876,NA,260,1418,64,NA,45,NA,972,"A+","5/17/2020 12:00","6e891e7a9f7d6cd357669e1540aa7ba26629361b","2020-05-17T20:00:00Z",499,1418,112550,112550,112550,44,10,15,3830,240,4070
"661",20200517,"SC",8816,111670,NA,NA,1421,NA,NA,NA,NA,5076,"A","5/16/2020 17:25","1b60326fb46b0f93063a639c2bb86aee7c2b0080","2020-05-17T20:00:00Z",380,1421,120486,120486,120486,45,0,0,10461,409,10870
"662",20200517,"SD",3987,24572,NA,77,312,NA,NA,NA,NA,2724,"B","5/16/2020 18:00","688472494bd14c90d2cdc4185cc9d44de253eda4","2020-05-17T20:00:00Z",44,312,28559,28559,28559,46,0,8,355,28,383
"663",20200517,"TN",17388,307892,NA,NA,1482,NA,NA,NA,NA,9652,"A","5/17/2020 15:00","f146085ec5fef1625e3a7c50e2e700778172070f","2020-05-17T20:00:00Z",298,1482,325280,325280,325280,47,3,8,4979,100,5079
"664",20200517,"TX",47784,602571,NA,1512,NA,NA,NA,NA,NA,27570,"A","5/17/2020 16:15","247bb8019873ab8d0666f832f929bc0d7db59ec5","2020-05-17T20:00:00Z",1336,NA,650355,650355,650355,48,31,0,10831,785,11616
"665",20200517,"UT",7238,163514,NA,181,586,NA,196,NA,84,4075,"B","5/17/2020 12:04","861349cb9918801e5e086538ec852b1efa3f1cde","2020-05-17T20:00:00Z",80,586,170752,170752,170752,49,2,8,3808,170,3978
"666",20200517,"VA",30388,159973,527,1524,5517,379,NA,195,NA,3993,"A+","5/16/2020 17:00","a59249718a1be16995c9fd9114a3cd8e2d5f1723","2020-05-17T20:00:00Z",1009,5517,190888,190361,190361,51,7,103,4088,705,4793
"667",20200517,"VI",69,1278,45,NA,NA,NA,NA,NA,NA,61,"C","5/16/2020 18:35","9d0fa5aad36b678f164781ae18d911cdb68c299c","2020-05-17T20:00:00Z",6,NA,1392,1347,1347,78,0,0,84,0,84
"668",20200517,"VT",940,22974,NA,14,NA,NA,NA,NA,NA,810,"B","5/17/2020 00:00","12740404bddb58f1d08c81e044a38492fa3be0b7","2020-05-17T20:00:00Z",54,NA,23914,23914,23914,50,1,0,777,0,777
"669",20200517,"WA",18905,275282,NA,168,NA,52,NA,NA,NA,NA,"A","5/17/2020 00:00","9304d1cb8df00ce560e73934fa4b906b6fdecf7b","2020-05-17T20:00:00Z",1000,NA,294187,294187,294187,53,8,0,1629,52,1681
"670",20200517,"WI",12543,139674,182,543,2038,129,494,NA,NA,6542,"A+","5/17/2020 00:00","1ba7105ffa819b4e137d4bd750a2bc46b43e5221","2020-05-17T20:00:00Z",453,2038,152399,152217,152217,55,0,20,5468,356,5824
"671",20200517,"WV",1490,74000,NA,48,NA,11,NA,7,NA,919,"B","5/17/2020 17:00","048ffd7f5d71a0e52da7a4670ec0bdba8d40e0c7","2020-05-17T20:00:00Z",67,NA,75490,75490,75490,54,3,0,2064,33,2097
"672",20200517,"WY",754,16331,NA,8,70,NA,NA,NA,NA,498,"B","5/16/2020 15:07","6fa6ad4d03a379e7434965db534859132fa6e45d","2020-05-17T20:00:00Z",8,70,17085,17085,17085,56,1,1,653,38,691
"673",20200516,"AK",392,32889,NA,10,NA,NA,NA,NA,NA,344,"B","5/16/2020 00:00","ebbc757dba7fd38b8459eb3908d4faa864d1d85a","2020-05-16T20:00:00Z",10,NA,33281,33281,33281,2,0,0,859,4,863
"674",20200516,"AL",11523,141971,NA,NA,1387,NA,501,NA,295,NA,"B","5/16/2020 00:00","b3b647c1555ac18188f23e454877c1b16b53caf2","2020-05-16T20:00:00Z",485,1387,153494,153494,153494,1,9,10,7124,307,7431
"675",20200516,"AR",4578,77066,NA,65,520,NA,NA,10,101,3472,"A","5/15/2020 16:20","2715a8779c1af1949901c1b256e0c7db130134ab","2020-05-16T20:00:00Z",98,520,81644,81644,81644,5,0,0,0,115,115
"676",20200516,"AS",0,105,NA,NA,NA,NA,NA,NA,NA,NA,"C","5/10/2020 00:00","b8a80308335510397208555fbb0dfad5bfc5416f","2020-05-16T20:00:00Z",0,NA,105,105,105,60,0,0,0,0,0
"677",20200516,"AZ",13631,133157,NA,791,1683,344,NA,210,NA,3357,"A+","5/16/2020 00:00","ed387914a563196c474d12d7bc518d1b58279ffd","2020-05-16T20:00:00Z",679,1683,146788,146788,146788,4,28,54,4325,462,4787
"678",20200516,"CA",76793,1102333,NA,4424,NA,1313,NA,NA,NA,NA,"B","5/16/2020 00:00","e335473bcecc2092fc63063fe12ed043c5f73751","2020-05-16T20:00:00Z",3204,NA,1179126,1179126,1179126,6,96,0,43363,1857,45220
"679",20200516,"CO",21232,100608,NA,671,3842,NA,NA,NA,NA,3312,"A","5/14/2020 00:00","37b3ee3bcc584865172e3bb459734380e800f6a0","2020-05-16T20:00:00Z",1150,3842,121840,121840,121840,8,59,53,3416,394,3810
"680",20200516,"CT",36703,128052,NA,994,10946,NA,NA,NA,NA,6264,"B","5/15/2020 20:15","b15eb6e4fb7fe44bff7ac2a1bfca9a81f05db0df","2020-05-16T20:00:00Z",3339,10946,164755,164755,164755,9,54,0,8229,618,8847
"681",20200516,"DC",7042,28490,NA,382,NA,NA,NA,79,NA,998,"A","5/15/2020 00:00","c2d074623d06cc96a1d5109a70bf3a1db3550010","2020-05-16T20:00:00Z",375,NA,35532,35532,35532,11,7,0,1022,171,1193
"682",20200516,"DE",7547,32211,NA,250,NA,NA,NA,NA,NA,3367,"B","5/15/2020 18:00","e72ebe9d44101938262f481c472ee49fb881d18d","2020-05-16T20:00:00Z",286,NA,39758,39758,39758,10,15,0,1306,174,1480
"683",20200516,"FL",44811,585236,1676,472,8393,232,NA,NA,NA,NA,"A+","5/16/2020 10:02","669f7208041dc4d6e3c36d45c4608ac05673f911","2020-05-16T20:00:00Z",2040,8393,631723,630047,630047,12,49,400,19609,1601,21210
"684",20200516,"GA",37147,283922,NA,1005,6735,NA,1554,NA,NA,NA,"A+","5/16/2020 13:00","615e1ffae8ef2421dc8edc71fbc764a7a684b8f2","2020-05-16T20:00:00Z",1592,6735,321069,321069,321069,13,35,297,18729,466,19195
"685",20200516,"GU",154,4365,NA,NA,NA,NA,NA,NA,NA,126,"C","5/16/2020 04:30","cd281610279644edd5b352fe4106638475dfa83c","2020-05-16T20:00:00Z",5,NA,4519,4519,4519,66,0,0,4,0,4
"686",20200516,"HI",638,40245,NA,NA,81,NA,NA,NA,NA,565,"B","5/15/2020 18:00","ddb1e7e615deedf0c450e518e7c0265994e0f8fd","2020-05-16T20:00:00Z",17,81,40883,40883,40883,15,0,0,2106,1,2107
"687",20200516,"IA",14328,81972,NA,387,NA,128,NA,83,NA,6927,"A+","5/15/2020 00:00","bbb10fc91d491208a93c64373e99ccec3e17c6f6","2020-05-16T20:00:00Z",346,NA,96300,96300,96300,19,10,0,2455,279,2734
"688",20200516,"ID",2389,33299,NA,NA,213,NA,89,NA,NA,1588,"B","5/15/2020 19:00","ef4072707fdc103bf83417a32f0b60302df4b06f","2020-05-16T20:00:00Z",73,213,35688,35688,35688,16,1,1,905,38,943
"689",20200516,"IL",92457,469192,NA,4306,NA,1135,NA,653,NA,NA,"A","5/16/2020 00:00","780a5f44f8f1f3fce54393f2ce9dff7dd8e1ab45","2020-05-16T20:00:00Z",4129,NA,561649,561649,561649,17,71,0,20959,2088,23047
"690",20200516,"IN",27280,144078,NA,1274,4389,426,990,199,NA,NA,"A+","5/15/2020 23:59","948b0408d66d5d1fd7c7ac97e005c135ad8f77cb","2020-05-16T20:00:00Z",1741,4389,171358,171358,171358,18,50,0,5285,625,5910
"691",20200516,"KS",7886,53706,NA,NA,724,NA,246,NA,112,443,"A","5/15/2020 10:00","a7e73dc4deed8f9c44f040b62b95d223eb7b911c","2020-05-16T20:00:00Z",172,724,61592,61592,61592,20,0,0,0,0,0
"692",20200516,"KY",7444,120290,NA,381,1896,218,797,NA,NA,2739,"A+","5/15/2020 17:00","a34e71d03d90952edfb034c5ad98c8870c0543be","2020-05-16T20:00:00Z",332,1896,127734,127734,127734,21,4,9,6237,219,6456
"693",20200516,"LA",34117,225625,NA,1028,NA,NA,NA,123,NA,22608,"B","5/16/2020 13:00","696861698bc263b7e289611adc9aeb453b785477","2020-05-16T20:00:00Z",2479,NA,259742,259742,259742,22,31,0,6273,280,6553
"694",20200516,"MA",84933,363156,NA,2692,8456,747,NA,NA,NA,NA,"A+","5/16/2020 10:00","c2aaf8eedf0b66b9dd89117cd1b5691dc0f8d815","2020-05-16T20:00:00Z",5705,8456,448089,448089,448089,25,113,142,10898,1512,12410
"695",20200516,"MD",37968,152207,NA,1500,6755,598,NA,NA,NA,2806,"B","5/16/2020 10:00","1eb7a6bed6afa4ccd2062face61d7e289d0f2716","2020-05-16T20:00:00Z",1957,6755,190175,190175,190175,24,46,76,6367,982,7349
"696",20200516,"ME",1648,22092,NA,37,214,19,NA,10,NA,1012,"B","5/16/2020 12:00","436d3613b3c416c8d4675e1c6aa98cf01ea5fea8","2020-05-16T20:00:00Z",70,214,23740,23740,23740,23,1,3,0,45,45
"697",20200516,"MI",50504,307417,NA,1256,NA,532,NA,440,NA,28234,"A+","5/16/2020 11:00","48990fdbfd5afd62d8c974307181622d7694d606","2020-05-16T20:00:00Z",4880,NA,357921,357921,357921,26,55,0,0,425,425
"698",20200516,"MN",14969,128312,NA,493,2039,225,700,NA,NA,9571,"A+","5/15/2020 17:00","f5b34f94adcca495e741bde78e5b190fcdaa9328","2020-05-16T20:00:00Z",709,2039,143281,143281,143281,27,17,54,7883,729,8612
"699",20200516,"MO",10675,128665,NA,775,NA,NA,NA,116,NA,NA,"B","5/16/2020 15:00","7c6502d1ae945fc1eb70302bce4477dfb2fe23ff","2020-05-16T20:00:00Z",589,NA,139340,139340,139340,29,13,0,4663,219,4882
"700",20200516,"MP",21,3318,NA,NA,NA,NA,NA,NA,NA,12,"D","5/16/2020 00:00","fe92d141e882ff840ef4edb479a0e4fb474c3992","2020-05-16T20:00:00Z",2,NA,3339,3339,3339,69,0,0,12,2,14
"701",20200516,"MS",11123,97353,NA,641,1748,170,NA,81,NA,6268,"A","5/15/2020 19:00","c25651155b534ad1142b20adb93fc65679cfb9a6","2020-05-16T20:00:00Z",510,1748,108476,108476,108476,28,17,36,1331,322,1653
"702",20200516,"MT",468,25623,NA,3,63,NA,NA,NA,NA,431,"B","5/16/2020 00:00","be317bee944f675389cdf640bba65cac8f659b97","2020-05-16T20:00:00Z",16,63,26091,26091,26091,30,0,0,671,2,673
"703",20200516,"NC",17982,220604,NA,481,NA,NA,NA,NA,NA,9115,"A","5/16/2020 11:00","2d07a8a77e59adfb616974b22f30fa7390268eda","2020-05-16T20:00:00Z",652,NA,238586,238586,238586,37,11,0,6186,853,7039
"704",20200516,"ND",1848,51639,NA,33,130,NA,NA,NA,NA,1111,"C","5/16/2020 13:00","7c167acf2eb3a0c18831eac7d26e3e1c5fe067ca","2020-05-16T20:00:00Z",42,130,53487,53487,53487,38,0,0,1685,87,1772
"705",20200516,"NE",9772,50206,NA,NA,NA,NA,NA,NA,NA,NA,"C","5/15/2020 15:45","41aae3f2c25b0f3f29f4c1422a17fe71a1cd7593","2020-05-16T20:00:00Z",119,NA,59978,59978,59978,31,6,0,2407,356,2763
"706",20200516,"NH",3464,39212,1401,110,335,NA,109,NA,NA,1254,"B","5/15/2020 09:00","9e367dbae784781a994f8b46d3b098c2b8a59d0c","2020-05-16T20:00:00Z",159,335,44077,42676,42676,33,0,0,64,0,64
"707",20200516,"NJ",145089,330135,NA,3564,NA,1061,NA,846,NA,22939,"A+","5/16/2020 13:00","a1d5ee1890ca01342f04526d2be0d2997e662e3e","2020-05-16T20:00:00Z",10249,NA,475224,475224,475224,34,111,0,11068,1184,12252
"708",20200516,"NM",5662,118796,NA,223,886,NA,NA,NA,NA,1671,"C","5/15/2020 18:01","69a90501b35471efd8ea0f7ca84faec9f744368d","2020-05-16T20:00:00Z",253,886,124458,124458,124458,35,11,0,4698,159,4857
"709",20200516,"NV",6662,67002,NA,423,NA,105,NA,65,NA,272,"B","5/16/2020 12:00","2e41b8fbad82d469691783657fe2180d379fd861","2020-05-16T20:00:00Z",345,NA,73664,73664,73664,32,6,0,1470,48,1518
"710",20200516,"NY",348232,1030485,NA,6220,75163,2077,NA,1674,NA,60796,"A","5/16/2020 00:00","622d82ace7ccf79647d53e9afa44ad8b1dacdcd6","2020-05-16T20:00:00Z",22478,75163,1378717,1378717,1378717,36,174,412,38250,2419,40669
"711",20200516,"OH",27474,219228,NA,866,4870,366,1277,251,NA,NA,"B","5/16/2020 14:00","81ad312198b01fb16e9bb09a267c963753aaea08","2020-05-16T20:00:00Z",1610,4870,246702,246702,246702,39,29,79,0,520,520
"712",20200516,"OK",5237,118162,NA,180,878,73,NA,NA,NA,3945,"A+","5/16/2020 00:00","a0409ac7bf95e7b598968817bc54f0ba791f3ffb","2020-05-16T20:00:00Z",288,878,123399,123399,123399,40,3,15,5056,151,5207
"713",20200516,"OR",3612,88587,NA,153,699,48,NA,16,NA,1406,"A+","5/16/2020 11:00","07e1ba7619fe165bed8fcb7cc1d6d8321759b2c0","2020-05-16T20:00:00Z",137,699,92199,92199,92199,41,0,8,2622,71,2693
"714",20200516,"PA",61611,266225,NA,1873,NA,NA,NA,429,NA,NA,"C","5/16/2020 00:00","161a82440681a4267d2b5f7718eba9aa273f4964","2020-05-16T20:00:00Z",4403,NA,327836,327836,327836,42,61,0,7015,989,8004
"715",20200516,"PR",2589,NA,NA,161,NA,15,NA,5,NA,NA,"B","5/16/2020 04:59","289f74f1265ff0d89efa36ba8091465362fcbc2c","2020-05-16T20:00:00Z",122,NA,2589,2589,2589,72,0,0,0,47,47
"716",20200516,"RI",12434,96046,NA,273,1403,66,NA,44,NA,947,"A+","5/16/2020 12:00","9bd1830c437e39445f146c19ff4f68251e59b16d","2020-05-16T20:00:00Z",489,1403,108480,108480,108480,44,10,31,3287,215,3502
"717",20200516,"SC",8407,101209,NA,NA,1421,NA,NA,NA,NA,5076,"A","5/15/2020 16:00","540817a2c53e356d3d1273c72b424dc322e7782a","2020-05-16T20:00:00Z",380,1421,109616,109616,109616,45,0,0,0,0,0
"718",20200516,"SD",3959,24217,NA,75,304,NA,NA,NA,NA,2673,"B","5/15/2020 18:00","7d72cf26038d1378315afbdd832b7cfaa4195405","2020-05-16T20:00:00Z",44,304,28176,28176,28176,46,0,8,690,72,762
"719",20200516,"TN",17288,302913,NA,NA,1474,NA,NA,NA,NA,9529,"A","5/16/2020 15:00","3bb4e51fd9e51add7b1df0fedeed808214aaa054","2020-05-16T20:00:00Z",295,1474,320201,320201,320201,47,5,20,10127,318,10445
"720",20200516,"TX",46999,591740,NA,1791,NA,NA,NA,NA,NA,26601,"A","5/15/2020 16:15","6f4ebb63eb3a884d913ab43c9e3dbf27c0e2717b","2020-05-16T20:00:00Z",1305,NA,638739,638739,638739,48,33,0,27308,1801,29109
"721",20200516,"UT",7068,159706,NA,168,578,NA,194,NA,84,3896,"B","5/16/2020 10:21","003c19b221e8cc5236316593052854ea4eef53da","2020-05-16T20:00:00Z",78,578,166774,166774,166774,49,1,12,3401,155,3556
"722",20200516,"VA",29683,155885,485,1505,5414,381,NA,189,NA,3909,"A+","5/15/2020 17:00","d4628b48983aa7f5c1dfa0035ef1a00106e8b745","2020-05-16T20:00:00Z",1002,5414,186053,185568,185568,51,25,98,6543,1011,7554
"723",20200516,"VI",69,1194,37,NA,NA,NA,NA,NA,NA,61,"C","5/14/2020 19:04","d23ddae66222ca554045ee488a3f6e2d7476b64d","2020-05-16T20:00:00Z",6,NA,1300,1263,1263,78,0,0,0,0,0
"724",20200516,"VT",940,22197,NA,20,NA,NA,NA,NA,NA,804,"B","5/16/2020 00:00","f8ef9b79dc98f172d11f4de3c58ccae0b7bdbb3f","2020-05-16T20:00:00Z",53,NA,23137,23137,23137,50,0,0,960,8,968
"725",20200516,"WA",18853,273653,NA,331,NA,90,NA,NA,NA,NA,"A","5/16/2020 00:00","e09ae714e2360b044f9879fcef1161d1321112a8","2020-05-16T20:00:00Z",992,NA,292506,292506,292506,53,9,0,2675,112,2787
"726",20200516,"WI",12187,134206,189,546,2018,127,488,NA,NA,6542,"A+","5/16/2020 00:00","1873ab37f186c9e770d12e0a4ab07cdc93b36638","2020-05-16T20:00:00Z",453,2018,146582,146393,146393,55,8,41,5549,502,6051
"727",20200516,"WV",1457,71936,NA,55,NA,13,NA,6,NA,889,"B","5/16/2020 10:00","d48c366beaca7d30fe464aec140165e17efda6be","2020-05-16T20:00:00Z",64,NA,73393,73393,73393,54,2,0,2441,16,2457
"728",20200516,"WY",716,15678,NA,8,69,NA,NA,NA,NA,496,"B","5/15/2020 16:20","b0d6736f6416c448865108906ad90edd34c74f0f","2020-05-16T20:00:00Z",7,69,16394,16394,16394,56,0,1,371,1,372
"729",20200515,"AK",388,32030,NA,8,NA,NA,NA,NA,NA,343,"B","5/14/2020 00:00","f536c18047b4cea1324fe04724f7381ea682bd38","2020-05-15T20:00:00Z",10,NA,32418,32418,32418,2,0,0,655,1,656
"730",20200515,"AL",11216,134847,NA,NA,1377,NA,497,NA,293,NA,"B","5/15/2020 00:00","8d7c548d019dcc5539c1314bb139ca11c4bd793b","2020-05-15T20:00:00Z",476,1377,146063,146063,146063,1,9,27,3830,248,4078
"731",20200515,"AR",4463,77066,NA,65,520,NA,NA,9,101,3390,"A","5/15/2020 16:20","96b617922fe57968d27b560bbe8547065ea597fe","2020-05-15T20:00:00Z",98,520,81529,81529,81529,5,1,11,5484,227,5711
"732",20200515,"AS",0,105,NA,NA,NA,NA,NA,NA,NA,NA,"C","5/10/2020 00:00","1bb445d1910b80b0e68ea5e0253644b5251a37ef","2020-05-15T20:00:00Z",0,NA,105,105,105,60,0,0,0,0,0
"733",20200515,"AZ",13169,128832,NA,808,1629,313,NA,222,NA,3145,"A+","5/15/2020 00:00","40d27b381b995805d0ef63ea39c2d0033d15d168","2020-05-15T20:00:00Z",651,1629,142001,142001,142001,4,27,-7,7168,495,7663
"734",20200515,"CA",74936,1058970,NA,4519,NA,1324,NA,NA,NA,NA,"B","5/14/2020 00:00","dd4a56509207e53adc6f228223657494252d0d39","2020-05-15T20:00:00Z",3108,NA,1133906,1133906,1133906,6,76,0,27483,1772,29255
"735",20200515,"CO",20838,97192,NA,685,3789,NA,NA,NA,NA,3217,"A","5/13/2020 00:00","6cd5b2dd7a32c5d3c0a52851c31eb0f4447152b5","2020-05-15T20:00:00Z",1091,3789,118030,118030,118030,8,29,54,3148,363,3511
"736",20200515,"CT",36085,119823,NA,1033,10946,NA,NA,NA,NA,6264,"B","5/14/2020 20:30","2e25e5303dc2110f3d9f554edef3615bfc65fa56","2020-05-15T20:00:00Z",3285,10946,155908,155908,155908,9,66,0,5725,621,6346
"737",20200515,"DC",6871,27468,NA,393,NA,NA,NA,90,NA,975,"A","5/14/2020 00:00","17190260870f259a18b29c701e5c839610c84c63","2020-05-15T20:00:00Z",368,NA,34339,34339,34339,11,10,0,1205,135,1340
"738",20200515,"DE",7373,30905,NA,269,NA,NA,NA,NA,NA,3210,"B","5/14/2020 18:00","a3cd9f55970e9f1d0ff2a9f378a066004877bc18","2020-05-15T20:00:00Z",271,NA,38278,38278,38278,10,11,0,1271,150,1421
"739",20200515,"FL",43210,565627,1228,472,7993,232,NA,NA,NA,NA,"A+","5/14/2020 12:33","12ded49a944b5cb60be8fd54c4bf211689017228","2020-05-15T20:00:00Z",1991,7993,610065,608837,608837,12,43,0,0,0,0
"740",20200515,"GA",36681,265193,NA,NA,6438,NA,1534,NA,NA,NA,"A+","5/15/2020 13:00","4bbc1a255b9dc9d678a11542dd94cab3e2c0edd3","2020-05-15T20:00:00Z",1557,6438,301874,301874,301874,13,30,93,15170,823,15993
"741",20200515,"GU",154,4361,NA,NA,NA,NA,NA,NA,NA,124,"C","5/15/2020 04:45","c2b73015710cb6db34bb9a9fa6189737868ef8df","2020-05-15T20:00:00Z",5,NA,4515,4515,4515,66,0,0,135,1,136
"742",20200515,"HI",637,38139,NA,NA,81,NA,NA,NA,NA,564,"B","5/14/2020 18:00","f8e2590d4432dcd5368909981404ab9c5e8c9316","2020-05-15T20:00:00Z",17,81,38776,38776,38776,15,0,0,-104,-1,-105
"743",20200515,"IA",14049,79517,NA,387,NA,130,NA,87,NA,6561,"A+","5/14/2020 00:00","568deee21a555e5c243058ca7c99349ecec9de68","2020-05-15T20:00:00Z",336,NA,93566,93566,93566,19,18,0,3898,374,4272
"744",20200515,"ID",2351,32394,NA,NA,212,NA,89,NA,NA,1573,"B","5/14/2020 19:00","76682158af27b10897f2c42cc7ba37217c009805","2020-05-15T20:00:00Z",72,212,34745,34745,34745,16,3,0,964,27,991
"745",20200515,"IL",90369,448233,NA,4367,NA,1129,NA,675,NA,NA,"A","5/15/2020 00:00","beeae9be7c9b11830edb2ac7e350bc68104cfb9e","2020-05-15T20:00:00Z",4058,NA,538602,538602,538602,17,130,0,24133,2432,26565
"746",20200515,"IN",26655,138793,NA,1294,4389,492,990,213,NA,NA,"A+","5/14/2020 23:59","ca875b5ae6440b327c99b92adde8d4b44ff04098","2020-05-15T20:00:00Z",1691,4389,165448,165448,165448,18,45,0,4607,602,5209
"747",20200515,"KS",7886,53706,NA,NA,724,NA,246,NA,112,443,"A","5/15/2020 10:00","9f1b4f268dd09e1df9d728692dcd14f003fe72a0","2020-05-15T20:00:00Z",172,724,61592,61592,61592,20,8,20,3546,418,3964
"748",20200515,"KY",7225,114053,NA,385,1887,220,794,NA,NA,2712,"A+","5/14/2020 17:00","f6a5783ab7b4b4673fc7840a3d8e13c456996bf1","2020-05-15T20:00:00Z",328,1887,121278,121278,121278,21,2,52,3738,145,3883
"749",20200515,"LA",33837,219352,NA,1091,NA,NA,NA,132,NA,22608,"B","5/15/2020 13:00","653ddbe0dc6d7d773f91f0940e5fd83f6f0e0848","2020-05-15T20:00:00Z",2448,NA,253189,253189,253189,22,31,0,5253,348,5601
"750",20200515,"MA",83421,352258,NA,2767,8314,749,NA,NA,NA,NA,"A+","5/14/2020 10:00","81928ad2704f6448278c92c1818face4b76c8e21","2020-05-15T20:00:00Z",5592,8314,435679,435679,435679,25,110,107,10079,1239,11318
"751",20200515,"MD",36986,145840,NA,1496,6679,598,NA,NA,NA,2685,"B","5/15/2020 10:00","5fa18dd0a4c7da329a035f412507636601b65756","2020-05-15T20:00:00Z",1911,6679,182826,182826,182826,24,45,126,3289,1083,4372
"752",20200515,"ME",1603,22092,NA,35,211,16,NA,8,NA,993,"B","5/15/2020 12:00","0a71b98212d1edb4afad76a1aae5b3d3e00340ef","2020-05-15T20:00:00Z",69,211,23695,23695,23695,23,0,4,0,38,38
"753",20200515,"MI",50079,307417,NA,1256,NA,532,NA,440,NA,22686,"A+","5/14/2020 11:00","dd9ffb53da782e1777a84cbbd982c96f4118268e","2020-05-15T20:00:00Z",4825,NA,357496,357496,357496,26,38,0,21116,497,21613
"754",20200515,"MN",14240,120429,NA,498,1985,200,679,NA,NA,8820,"A+","5/14/2020 17:00","d1508d33e157adcf74822567b643aa93636abbac","2020-05-15T20:00:00Z",692,1985,134669,134669,134669,27,29,70,5112,805,5917
"755",20200515,"MO",10456,124002,NA,812,NA,NA,NA,120,NA,NA,"B","5/15/2020 15:00","2b67ad198e9984e2fc656375303b71067dc62d76","2020-05-15T20:00:00Z",576,NA,134458,134458,134458,29,14,0,7209,139,7348
"756",20200515,"MP",19,3306,NA,NA,NA,NA,NA,NA,NA,12,"D","5/15/2020 00:00","79ca91de44d0d00f007685f7d287220129f782ca","2020-05-15T20:00:00Z",2,NA,3325,3325,3325,69,0,0,0,0,0
"757",20200515,"MS",10801,96022,NA,573,1712,172,NA,81,NA,6268,"A","5/14/2020 19:00","d774a232a25ab76a1be9a328d59ac4462a49dddb","2020-05-15T20:00:00Z",493,1712,106823,106823,106823,28,13,45,1179,318,1497
"758",20200515,"MT",466,24952,NA,3,63,NA,NA,NA,NA,431,"B","5/15/2020 00:00","ae1e5f8325427cd9c49130a4ad24cc3cd7345317","2020-05-15T20:00:00Z",16,63,25418,25418,25418,30,0,0,865,4,869
"759",20200515,"NC",17129,214418,NA,492,NA,NA,NA,NA,NA,9115,"A","5/15/2020 11:00","fa4ea6838c5c4342686f68cfc1be06e505f7a6ec","2020-05-15T20:00:00Z",641,NA,231547,231547,231547,37,26,0,11657,622,12279
"760",20200515,"ND",1761,49954,NA,35,130,NA,NA,NA,NA,1071,"C","5/15/2020 13:00","c7e05e3eabb93e0e01c62c40640c3dee07f92094","2020-05-15T20:00:00Z",42,130,51715,51715,51715,38,2,1,1355,114,1469
"761",20200515,"NE",9416,47799,NA,NA,NA,NA,NA,NA,NA,NA,"C","5/14/2020 15:45","685e51f1e2467d7b22ec7a87334726f3c6fa7386","2020-05-15T20:00:00Z",113,NA,57215,57215,57215,31,6,0,3533,341,3874
"762",20200515,"NH",3464,39148,543,115,335,NA,109,NA,NA,1247,"B","5/14/2020 09:00","5593f127756fdfe3e5af9014ef803c2b8fb42555","2020-05-15T20:00:00Z",159,335,43155,42612,42612,33,9,9,3272,165,3437
"763",20200515,"NJ",143905,319067,NA,3823,NA,1127,NA,865,NA,15642,"A+","5/15/2020 13:00","45b3cca36b07757bb1dd2905e39af31f77ee1de4","2020-05-15T20:00:00Z",10138,NA,462972,462972,462972,34,192,0,10075,1201,11276
"764",20200515,"NM",5503,114098,NA,209,886,NA,NA,NA,NA,1576,"C","5/14/2020 17:55","1dfaa4bc502bb6eee842aea578747c3d564e255e","2020-05-15T20:00:00Z",242,886,119601,119601,119601,35,11,0,4451,139,4590
"765",20200515,"NV",6614,65532,NA,425,NA,115,NA,73,NA,272,"B","5/15/2020 12:00","18254a5b6544c9ddd3b8a6ecde34dc765e2d69a7","2020-05-15T20:00:00Z",339,NA,72146,72146,72146,32,8,0,2547,115,2662
"766",20200515,"NY",345813,992235,NA,6394,74751,2156,NA,1774,NA,60302,"A","5/14/2020 00:00","9b7193c6e15e6af3ddd33905595f6175ab1b495d","2020-05-15T20:00:00Z",22304,74751,1338048,1338048,1338048,36,134,318,36529,2762,39291
"767",20200515,"OH",26954,219228,NA,944,4791,370,1277,260,NA,NA,"B","5/15/2020 14:00","25e1d7a8e26a4568d1aac8367392b444ba9e4545","2020-05-15T20:00:00Z",1581,4791,246182,246182,246182,39,47,73,12233,597,12830
"768",20200515,"OK",5086,113106,NA,215,863,98,NA,NA,NA,3801,"A+","5/15/2020 00:00","66bc81ffe572f39fcd6fb4f3d50dd9805967bf0b","2020-05-15T20:00:00Z",285,863,118192,118192,118192,40,1,5,5885,124,6009
"769",20200515,"OR",3541,85965,NA,161,691,46,NA,19,NA,1406,"A+","5/15/2020 11:00","c6f893a086cdb467e07874c280d349b638a672d6","2020-05-15T20:00:00Z",137,691,89506,89506,89506,41,0,6,5394,62,5456
"770",20200515,"PA",60622,259210,NA,1934,NA,NA,NA,431,NA,NA,"C","5/15/2020 00:00","9b3433b7d1e782e12119dec7bfdc8482e852d7d4","2020-05-15T20:00:00Z",4342,NA,319832,319832,319832,42,124,0,7651,986,8637
"771",20200515,"PR",2542,NA,NA,147,NA,18,NA,3,NA,NA,"B","5/15/2020 05:51","bbd4c37cf50b40eb2fdf0dbb70777015dc114828","2020-05-15T20:00:00Z",122,NA,2542,2542,2542,72,5,0,0,115,115
"772",20200515,"RI",12219,92759,NA,272,1372,63,NA,41,NA,919,"A+","5/15/2020 12:00","0a5b2c3086dbcec6bac43dfc246ce34c0cebfb55","2020-05-15T20:00:00Z",479,1372,104978,104978,104978,44,11,21,3174,203,3377
"773",20200515,"SC",8407,101209,NA,NA,1421,NA,NA,NA,NA,5076,"A","5/15/2020 16:00","b84f7972ce5863e94d569b44321ecc9101e56772","2020-05-15T20:00:00Z",380,1421,109616,109616,109616,45,9,83,6863,218,7081
"774",20200515,"SD",3887,23527,NA,80,296,NA,NA,NA,NA,2574,"B","5/14/2020 18:00","ad2bdf1acf6f736f57696ee85c7f1a4eda2211a5","2020-05-15T20:00:00Z",44,296,27414,27414,27414,46,1,6,846,95,941
"775",20200515,"TN",16970,292786,NA,NA,1454,NA,NA,NA,NA,9280,"A","5/15/2020 15:00","a3876666a9061ffbeaacfc721940b547564a50d4","2020-05-15T20:00:00Z",290,1454,309756,309756,309756,47,3,19,7168,271,7439
"776",20200515,"TX",45198,564432,NA,1716,NA,NA,NA,NA,NA,25454,"A","5/15/2020 16:15","7aa2708c1bcec5f1cce69bdb205c78fa42b62a94","2020-05-15T20:00:00Z",1272,NA,609630,609630,609630,48,56,0,20970,1347,22317
"777",20200515,"UT",6913,156305,NA,161,566,NA,190,NA,83,3719,"B","5/15/2020 10:27","007075841b29601971eb9ba33b101093f8caf638","2020-05-15T20:00:00Z",77,566,163218,163218,163218,49,2,8,2935,164,3099
"778",20200515,"VA",28672,149342,458,1511,5316,362,NA,195,NA,3805,"A+","5/14/2020 17:00","d6cb7f78bd8e7c0308cd4b4abfbde55751bf3f5f","2020-05-15T20:00:00Z",977,5316,178472,178014,178014,51,22,105,10325,859,11184
"779",20200515,"VI",69,1194,37,NA,NA,NA,NA,NA,NA,61,"C","5/14/2020 19:04","f1c1940001cd862d3562c906f96a30c2f60eb9b0","2020-05-15T20:00:00Z",6,NA,1300,1263,1263,78,0,0,30,0,30
"780",20200515,"VT",932,21237,NA,17,NA,NA,NA,NA,NA,796,"B","5/15/2020 00:00","9c679a6204ad6ae2659f92dd7c4aba2abd958996","2020-05-15T20:00:00Z",53,NA,22169,22169,22169,50,0,0,740,1,741
"781",20200515,"WA",18741,270978,NA,374,NA,114,NA,NA,NA,NA,"A","5/15/2020 00:00","0e983bb7a13422f904d52cca7055e3afff1f62ec","2020-05-15T20:00:00Z",983,NA,289719,289719,289719,53,8,0,5816,245,6061
"782",20200515,"WI",11685,128657,191,548,1977,113,485,NA,NA,6250,"A+","5/15/2020 00:00","9ac761b834f4b9300e0fce510d0b59d002f7298d","2020-05-15T20:00:00Z",445,1977,140533,140342,140342,55,11,38,6059,410,6469
"783",20200515,"WV",1441,69495,NA,57,NA,15,NA,8,NA,870,"B","5/15/2020 10:00","ca1aa6c47bc1c8255c16522b372c3e9a9fd79ce5","2020-05-15T20:00:00Z",62,NA,70936,70936,70936,54,2,0,2209,14,2223
"784",20200515,"WY",715,15307,NA,8,68,NA,NA,NA,NA,487,"B","5/14/2020 00:00","14ba619ea080945f3c0cc252b493a56d5f908dd0","2020-05-15T20:00:00Z",7,68,16022,16022,16022,56,0,1,578,14,592
"785",20200514,"AK",387,31375,NA,12,NA,NA,NA,NA,NA,339,"B","5/14/2020 00:00","4cd61592289ebde7cc18776a1c562217a6c9459d","2020-05-14T20:00:00Z",10,NA,31762,31762,31762,2,0,0,1109,4,1113
"786",20200514,"AL",10968,131017,NA,NA,1350,NA,489,NA,291,NA,"B","5/14/2020 00:00","0c7e2b77ab27b5d8e3747dd1c934869148ecd012","2020-05-14T20:00:00Z",467,1350,141985,141985,141985,1,18,33,5262,351,5613
"787",20200514,"AR",4236,71582,NA,64,509,NA,NA,13,100,3277,"A","5/14/2020 08:20","d99ce33ac0b3b642f75b868f76180c249f3fb456","2020-05-14T20:00:00Z",97,509,75818,75818,75818,5,2,12,2531,72,2603
"788",20200514,"AS",0,105,NA,NA,NA,NA,NA,NA,NA,NA,"C","5/10/2020 00:00","223918d2f967c849abaac5dbe21c854dd676c9cc","2020-05-14T20:00:00Z",0,NA,105,105,105,60,0,0,0,0,0
"789",20200514,"AZ",12674,121664,NA,781,1636,323,NA,201,NA,3074,"A+","5/14/2020 00:00","91666cd6ed247ef298d02ea73bd66d5bfdf6122a","2020-05-14T20:00:00Z",624,1636,134338,134338,134338,4,30,46,6090,498,6588
"790",20200514,"CA",73164,1031487,NA,4655,NA,1324,NA,NA,NA,NA,"B","5/14/2020 00:00","ab1526dbbdbe36c6e661db2aa371d77dd19df51d","2020-05-14T20:00:00Z",3032,NA,1104651,1104651,1104651,6,98,0,37036,2023,39059
"791",20200514,"CO",20475,94044,NA,685,3735,NA,NA,NA,NA,3217,"A","5/12/2020 00:00","f31c2e774e1d3f9c6f9db9c695dc6d978a37fbcb","2020-05-14T20:00:00Z",1062,3735,114519,114519,114519,8,53,40,2951,318,3269
"792",20200514,"CT",35464,114098,NA,1103,10946,NA,NA,NA,NA,6264,"B","5/13/2020 20:30","4322b1e818e1cfd2f3a77d7bd573699eb23b8e11","2020-05-14T20:00:00Z",3219,10946,149562,149562,149562,9,94,1557,6010,609,6619
"793",20200514,"DC",6736,26263,NA,397,NA,NA,NA,90,NA,966,"A","5/13/2020 00:00","37fed425316ee8a96f4437af258c5bcdb1554905","2020-05-14T20:00:00Z",358,NA,32999,32999,32999,11,8,0,1189,152,1341
"794",20200514,"DE",7223,29634,NA,273,NA,NA,NA,NA,NA,3080,"B","5/13/2020 18:00","425a83893eb5dd7c03dedcc9fb85774c9c671b6c","2020-05-14T20:00:00Z",260,NA,36857,36857,36857,10,13,0,1833,271,2104
"795",20200514,"FL",43210,565627,1228,472,7993,232,NA,NA,NA,NA,"A+","5/14/2020 12:33","08cd50784b8e27d4ca75aeb5fcff7fb05dafb15a","2020-05-14T20:00:00Z",1948,7993,610065,608837,608837,12,50,158,13266,808,14074
"796",20200514,"GA",35858,250023,NA,NA,6345,NA,1513,NA,NA,NA,"A+","5/14/2020 13:30","99bcce9e3a8809756adb209161131d0b1efd2115","2020-05-14T20:00:00Z",1527,6345,285881,285881,285881,13,22,86,11451,526,11977
"797",20200514,"GU",153,4226,NA,NA,NA,NA,NA,NA,NA,124,"C","5/14/2020 05:45","faa0873fd8d09b226cd2c35b49264bbb5071fb98","2020-05-14T20:00:00Z",5,NA,4379,4379,4379,66,0,0,116,1,117
"798",20200514,"HI",638,38243,NA,NA,81,NA,NA,NA,NA,563,"B","5/13/2020 18:00","ead9c2c5ac72338b889240aac5358950e79dbeae","2020-05-14T20:00:00Z",17,81,38881,38881,38881,15,0,0,513,3,516
"799",20200514,"IA",13675,75619,NA,405,NA,134,NA,93,NA,6231,"A+","5/13/2020 00:00","132d33d134340bb424885e8380e609b02dd8752a","2020-05-14T20:00:00Z",318,NA,89294,89294,89294,19,12,0,3189,386,3575
"800",20200514,"ID",2324,31430,NA,NA,212,NA,88,NA,NA,1557,"B","5/13/2020 19:00","51b8808ae7a6e446afd5580dd162e24c302fdfdd","2020-05-14T20:00:00Z",69,212,33754,33754,33754,16,0,-2,595,31,626
"801",20200514,"IL",87937,424100,NA,4473,NA,1132,NA,689,NA,NA,"A","5/14/2020 00:00","a876c20dbff144e5f0e79d1938b9715f87ac6b40","2020-05-14T20:00:00Z",3928,NA,512037,512037,512037,17,136,0,19439,3239,22678
"802",20200514,"IN",26053,134186,NA,1381,4389,488,990,217,NA,NA,"A+","5/13/2020 23:59","6c625a3b8e3a729824c368ea58f1b9b2c39a4ddc","2020-05-14T20:00:00Z",1646,4389,160239,160239,160239,18,27,0,5576,580,6156
"803",20200514,"KS",7468,50160,NA,NA,704,NA,238,NA,108,422,"A","5/13/2020 10:00","9336495b809672bcb93b80eff453b9ffacdf9046","2020-05-14T20:00:00Z",164,704,57628,57628,57628,20,0,0,0,0,0
"804",20200514,"KY",7080,110315,NA,377,1835,215,784,NA,NA,2649,"A+","5/13/2020 17:00","974c86ea643c02fbba54fa1c3d4c9a722df886bf","2020-05-14T20:00:00Z",326,1835,117395,117395,117395,21,5,10,6534,227,6761
"805",20200514,"LA",33489,214099,NA,1193,NA,NA,NA,140,NA,22608,"B","5/14/2020 13:00","d4c7186772b7c37de7ad8a1263e57da38205e75d","2020-05-14T20:00:00Z",2417,NA,247588,247588,247588,22,36,0,8857,827,9684
"806",20200514,"MA",82182,342179,NA,2859,8207,781,NA,NA,NA,NA,"A+","5/13/2020 10:00","dde4f439c0bf5c6d3f4ff4acab6d3ccf8a968afc","2020-05-14T20:00:00Z",5482,8207,424361,424361,424361,25,167,175,12644,1685,14329
"807",20200514,"MD",35903,142551,NA,1538,6553,569,NA,NA,NA,2569,"B","5/14/2020 10:00","97f675be0b98ceca1d58ecc61e3066bc1c2858f3","2020-05-14T20:00:00Z",1866,6553,178454,178454,178454,24,57,149,3789,1091,4880
"808",20200514,"ME",1565,22092,NA,37,207,18,NA,7,NA,958,"B","5/14/2020 12:30","c9e3bd1005fd7a9893bcdd12f8ba68b6f1f71d3c","2020-05-14T20:00:00Z",69,207,23657,23657,23657,23,3,3,0,50,50
"809",20200514,"MI",49582,286301,NA,1330,NA,653,NA,515,NA,22686,"A+","5/14/2020 11:00","728134334478e07a42d3e0e291ec3f7c0293d756","2020-05-14T20:00:00Z",4787,NA,335883,335883,335883,26,73,0,26432,1191,27623
"810",20200514,"MN",13435,115317,NA,498,1915,203,663,NA,NA,8473,"A+","5/13/2020 17:00","ac8a7a1ac321ed491129848882ce0bb688ec72e5","2020-05-14T20:00:00Z",663,1915,128752,128752,128752,27,25,64,6199,518,6717
"811",20200514,"MO",10317,116793,NA,796,NA,NA,NA,115,NA,NA,"B","5/14/2020 15:00","973eabc5c0120a25364c84d49207a1a0e8fed7a8","2020-05-14T20:00:00Z",562,NA,127110,127110,127110,29,20,0,2793,175,2968
"812",20200514,"MP",19,3306,NA,NA,NA,NA,NA,NA,NA,12,"D","5/14/2020 00:00","b08bc9764ef8dee231d256d47380136ed58e572e","2020-05-14T20:00:00Z",2,NA,3325,3325,3325,69,0,0,285,0,285
"813",20200514,"MS",10483,94843,NA,589,1667,131,NA,72,NA,6268,"A","5/13/2020 19:00","113111017b63e87323c208beee6256a988b5efb6","2020-05-14T20:00:00Z",480,1667,105326,105326,105326,28,15,51,4885,393,5278
"814",20200514,"MT",462,24087,NA,3,63,NA,NA,NA,NA,431,"B","5/14/2020 00:00","cd4417db3e0c03025a90d79157fa5ca3dcea6372","2020-05-14T20:00:00Z",16,63,24549,24549,24549,30,0,0,697,0,697
"815",20200514,"NC",16507,202761,NA,507,NA,NA,NA,NA,NA,9115,"A","5/14/2020 11:00","1ec07a85eac921f142afb5c7a7428f2109300cf1","2020-05-14T20:00:00Z",615,NA,219268,219268,219268,37,18,0,8120,691,8811
"816",20200514,"ND",1647,48599,NA,38,129,NA,NA,NA,NA,1007,"C","5/14/2020 13:00","0b141c449c1b04fdfeb11c7fbb05245f0f8387f4","2020-05-14T20:00:00Z",40,129,50246,50246,50246,38,0,2,1301,0,1301
"817",20200514,"NE",9075,44266,NA,NA,NA,NA,NA,NA,NA,NA,"C","5/13/2020 20:00","8e26a97f89cbcf4abc6a04c143417b5fcc9e55a9","2020-05-14T20:00:00Z",107,NA,53341,53341,53341,31,4,0,3233,383,3616
"818",20200514,"NH",3299,35876,735,126,326,NA,97,NA,NA,1236,"B","5/13/2020 09:00","a2354a712234d8d44acbf4b67920df1c8689bc0d","2020-05-14T20:00:00Z",150,326,39910,39175,39175,33,8,7,1899,60,1959
"819",20200514,"NJ",142704,308992,NA,3958,NA,1157,NA,898,NA,15642,"A+","5/14/2020 13:00","3bbe31c305d3d528719662b3798df23dc133f3f2","2020-05-14T20:00:00Z",9946,NA,451696,451696,451696,34,244,0,9102,1144,10246
"820",20200514,"NM",5364,109647,NA,200,886,NA,NA,NA,NA,1515,"C","5/13/2020 20:20","d25b02d05f9c15802c397707d99d1705250d04d9","2020-05-14T20:00:00Z",231,886,115011,115011,115011,35,12,0,4570,152,4722
"821",20200514,"NV",6499,62985,NA,515,NA,126,NA,75,NA,244,"B","5/14/2020 12:00","60c5110fdf243000ca8f3249205b7f3839f45104","2020-05-14T20:00:00Z",331,NA,69484,69484,69484,32,10,0,2707,105,2812
"822",20200514,"NY",343051,955706,NA,6706,74433,2223,NA,1846,NA,59758,"A","5/14/2020 00:00","d1e88d9c65cc15cd5d79fa8b1ff1d1c8579f3c5f","2020-05-14T20:00:00Z",22170,74433,1298757,1298757,1298757,36,157,470,37460,2390,39850
"823",20200514,"OH",26357,206995,NA,953,4718,360,1268,253,NA,NA,"B","5/14/2020 14:00","8cb4d6353252db8a65a52452a1c1610c590c636d","2020-05-14T20:00:00Z",1534,4718,233352,233352,233352,39,51,100,6862,636,7498
"824",20200514,"OK",4962,107221,NA,217,858,102,NA,NA,NA,3660,"A+","5/14/2020 00:00","b6161bd93c9bba3b0484642f6224df4d5c837071","2020-05-14T20:00:00Z",284,858,112183,112183,112183,40,6,10,2946,110,3056
"825",20200514,"OR",3479,80571,NA,163,685,38,NA,17,NA,1406,"A+","5/14/2020 11:00","e93183106b451a5d42982483bab37114bf785371","2020-05-14T20:00:00Z",137,685,84050,84050,84050,41,3,7,0,63,63
"826",20200514,"PA",59636,251559,NA,1983,NA,NA,NA,446,NA,NA,"C","5/14/2020 00:00","2705d062b62ed8fe149e4a5c3fee9b136163108a","2020-05-14T20:00:00Z",4218,NA,311195,311195,311195,42,275,0,7388,938,8326
"827",20200514,"PR",2427,NA,NA,159,NA,18,NA,5,NA,NA,"B","5/14/2020 06:30","b70f52c40e2003b8f2a97501f0dda4227288fede","2020-05-14T20:00:00Z",117,NA,2427,2427,2427,72,2,0,0,98,98
"828",20200514,"RI",12016,89585,NA,271,1351,65,NA,42,NA,903,"A+","5/14/2020 12:00","3817955f87e430acd4f8aeeb10b3542de4d07e0c","2020-05-14T20:00:00Z",468,1351,101601,101601,101601,44,6,23,3498,181,3679
"829",20200514,"SC",8189,94346,NA,NA,1338,NA,NA,NA,NA,4914,"A","5/14/2020 15:34","db68b8034fbc75e17c75c7a79890ecc538b49bc5","2020-05-14T20:00:00Z",371,1338,102535,102535,102535,45,16,0,9133,262,9395
"830",20200514,"SD",3792,22681,NA,85,290,NA,NA,NA,NA,2437,"B","5/13/2020 18:00","2ebb501ba6f33a29893f01274a8ae7a83f02aa52","2020-05-14T20:00:00Z",43,290,26473,26473,26473,46,4,9,569,60,629
"831",20200514,"TN",16699,285618,NA,NA,1435,NA,NA,NA,NA,8881,"A","5/14/2020 15:00","a344fd94720a960c94d1d106287801b03dcfeb48","2020-05-14T20:00:00Z",287,1435,302317,302317,302317,47,14,47,9071,329,9400
"832",20200514,"TX",43851,543462,NA,1648,NA,NA,NA,NA,NA,24487,"A","5/14/2020 16:30","c4e4592c1cede9e560fcec0f1d8633ebee8f8688","2020-05-14T20:00:00Z",1216,NA,587313,587313,587313,48,58,0,29089,1448,30537
"833",20200514,"UT",6749,153370,NA,142,558,NA,187,NA,83,3566,"B","5/14/2020 10:07","1eed6f28aaf2ab2567abde09ec15967882cb73e1","2020-05-14T20:00:00Z",75,558,160119,160119,160119,49,0,5,3204,129,3333
"834",20200514,"VA",27813,139017,496,1533,5211,355,NA,201,NA,3678,"A+","5/13/2020 17:00","d718e85fd7b1a662fb8937f10ee43e938f3a6b7b","2020-05-14T20:00:00Z",955,5211,167326,166830,166830,51,28,131,4371,1067,5438
"835",20200514,"VI",69,1164,45,NA,NA,NA,NA,NA,NA,61,"C","5/13/2020 17:44","eee09f56f69f7871409f2796d76ea56209e3ba46","2020-05-14T20:00:00Z",6,NA,1278,1233,1233,78,0,0,36,0,36
"836",20200514,"VT",931,20497,NA,18,NA,NA,NA,NA,NA,792,"B","5/14/2020 00:00","42bf5652a7b621286923cf3dbcd9f36bbdcab682","2020-05-14T20:00:00Z",53,NA,21428,21428,21428,50,0,0,789,1,790
"837",20200514,"WA",18496,265162,NA,365,NA,111,NA,NA,NA,NA,"A","5/14/2020 00:00","20d1df65785eb0b9a5fb72b8022a5eca200eb70b","2020-05-14T20:00:00Z",975,NA,283658,283658,283658,53,13,0,5345,247,5592
"838",20200514,"WI",11275,122598,169,507,1939,121,478,NA,NA,5994,"A+","5/14/2020 00:00","e1da001e0870bc0c814799abcd939f859c6f3ab0","2020-05-14T20:00:00Z",434,1939,134042,133873,133873,55,13,31,5487,373,5860
"839",20200514,"WV",1427,67286,NA,52,NA,9,NA,5,NA,870,"B","5/14/2020 10:00","fb56528146ff63b89433d64c35bc8b8a230cd901","2020-05-14T20:00:00Z",60,NA,68713,68713,68713,54,2,0,2004,29,2033
"840",20200514,"WY",701,14729,NA,8,67,NA,NA,NA,NA,480,"B","5/14/2020 00:00","2c39ee8aebd346ddf047dcd3185f744bc00855e1","2020-05-14T20:00:00Z",7,67,15430,15430,15430,56,0,0,345,26,371
"841",20200513,"AK",383,30266,NA,12,NA,NA,NA,NA,NA,338,"B","5/13/2020 00:00","f0aa4fdcbcf8798aa196f83b3272544e5c3a941d","2020-05-13T20:00:00Z",10,NA,30649,30649,30649,2,0,0,688,0,688
"842",20200513,"AL",10617,125755,NA,NA,1317,NA,477,NA,284,NA,"B","5/13/2020 00:00","0c929ad796f110118adce3c056060cecf4cde550","2020-05-13T20:00:00Z",449,1317,136372,136372,136372,1,20,30,2847,307,3154
"843",20200513,"AR",4164,69051,NA,59,497,NA,NA,12,99,3220,"A","5/12/2020 18:33","72af1969cef24d39d08a6be137b8ef56f633511c","2020-05-13T20:00:00Z",95,497,73215,73215,73215,5,0,12,2771,0,2771
"844",20200513,"AS",0,105,NA,NA,NA,NA,NA,NA,NA,NA,"C","5/10/2020 00:00","bcf6d9f15e8b1e7a68106b63798a38260000149f","2020-05-13T20:00:00Z",0,NA,105,105,105,60,0,0,0,0,0
"845",20200513,"AZ",12176,115574,NA,755,1590,292,NA,191,NA,2979,"A+","5/13/2020 00:00","b76df3dfb275ebcb96fcfa48e0f5062f241055d6","2020-05-13T20:00:00Z",594,1590,127750,127750,127750,4,32,26,4468,440,4908
"846",20200513,"CA",71141,994451,NA,4545,NA,1314,NA,NA,NA,NA,"B","5/13/2020 00:00","8a5867cd4322367e6ab3f8a0fb2b92285aa60b64","2020-05-13T20:00:00Z",2934,NA,1065592,1065592,1065592,6,87,0,30463,1759,32222
"847",20200513,"CO",20157,91093,NA,688,3695,NA,NA,NA,NA,3171,"A","5/11/2020 00:00","5b76edb8a4e871129833425856f807723383ec35","2020-05-13T20:00:00Z",1009,3695,111250,111250,111250,8,22,32,2315,278,2593
"848",20200513,"CT",34855,108088,NA,1158,9389,NA,NA,NA,NA,5413,"B","5/13/2020 14:00","9f64d067c58a26177100ab576630d39d10b4e1c2","2020-05-13T20:00:00Z",3125,9389,142943,142943,142943,9,84,0,3997,522,4519
"849",20200513,"DC",6584,25074,NA,423,NA,NA,NA,82,NA,934,"A","5/12/2020 00:00","60a5a8205ad106c17df8430de9ec79ec988d13bc","2020-05-13T20:00:00Z",350,NA,31658,31658,31658,11,14,0,509,99,608
"850",20200513,"DE",6952,27801,NA,282,NA,NA,NA,NA,NA,2942,"B","5/12/2020 18:00","89c3aa7e781ac9d58f5f1bae6a307c1afc5097aa","2020-05-13T20:00:00Z",247,NA,34753,34753,34753,10,10,0,1251,211,1462
"851",20200513,"FL",42402,552361,1191,NA,7835,NA,NA,NA,NA,NA,"A+","5/13/2020 09:43","7766681d762a4c3ecce27b7599fcdb5298c6c7c3","2020-05-13T20:00:00Z",1898,7835,595954,594763,594763,12,49,181,14680,479,15159
"852",20200513,"GA",35332,238572,NA,NA,6259,NA,1494,NA,NA,NA,"A+","5/13/2020 13:25","426dc2758151720472ddd5b9db4bd03d4e94f0b0","2020-05-13T20:00:00Z",1505,6259,273904,273904,273904,13,44,129,11028,697,11725
"853",20200513,"GU",152,4110,NA,NA,NA,NA,NA,NA,NA,124,"C","5/13/2020 07:55","4a7dfbff7cef9bb628d4da02e7880c1ec1ed8d30","2020-05-13T20:00:00Z",5,NA,4262,4262,4262,66,0,0,171,0,171
"854",20200513,"HI",635,37730,NA,NA,81,NA,NA,NA,NA,563,"B","5/12/2020 18:00","26416e0e81e32454f332ba7a2462f08be63995b3","2020-05-13T20:00:00Z",17,81,38365,38365,38365,15,0,0,425,1,426
"855",20200513,"IA",13289,72430,NA,388,NA,133,NA,101,NA,5954,"A+","5/12/2020 00:00","7078aec8259446a6b063280cf2da9b2ed255b4ce","2020-05-13T20:00:00Z",306,NA,85719,85719,85719,19,17,0,4054,377,4431
"856",20200513,"ID",2293,30835,NA,NA,214,NA,88,NA,NA,1536,"B","5/12/2020 19:00","3bf18933be28c366ecce611428a9a73197f586cb","2020-05-13T20:00:00Z",69,214,33128,33128,33128,16,-1,4,390,33,423
"857",20200513,"IL",84698,404661,NA,4563,NA,1208,NA,714,NA,NA,"A","5/13/2020 00:00","850a3d380e16b1a41147bdf42cad86804414204a","2020-05-13T20:00:00Z",3792,NA,489359,489359,489359,17,191,0,15991,1677,17668
"858",20200513,"IN",25473,128610,NA,1336,4389,481,990,217,NA,NA,"A+","5/12/2020 23:59","571f1446b987b3bcd5bb0e77dfa164f4f65b7c47","2020-05-13T20:00:00Z",1619,4389,154083,154083,154083,18,41,0,3227,346,3573
"859",20200513,"KS",7468,50160,NA,NA,704,NA,238,NA,108,422,"A","5/13/2020 10:00","60f9cb70675f6aa8680647af9392458ed8400983","2020-05-13T20:00:00Z",164,704,57628,57628,57628,20,6,44,3167,352,3519
"860",20200513,"KY",6853,103781,NA,379,1825,215,783,NA,NA,2546,"A+","5/12/2020 17:00","e62d39fb90ce7f21c28c982cb8b93123839ad7b3","2020-05-13T20:00:00Z",321,1825,110634,110634,110634,21,10,58,6434,176,6610
"861",20200513,"LA",32662,205242,NA,1194,NA,NA,NA,147,NA,22608,"B","5/13/2020 13:00","0f10a4ca63459290d22c161e545e63eaca3a62d4","2020-05-13T20:00:00Z",2381,NA,237904,237904,237904,22,34,0,9280,612,9892
"862",20200513,"MA",80497,329535,NA,3101,8032,794,NA,NA,NA,NA,"A+","5/13/2020 10:00","0361f85391c9351ec6cd8a1a6679b819bba00927","2020-05-13T20:00:00Z",5315,8032,410032,410032,410032,25,174,190,7371,1165,8536
"863",20200513,"MD",34812,138762,NA,1550,6404,572,NA,NA,NA,2456,"B","5/13/2020 10:00","f00ddc4a5f4d2a08acc4a8373fd3e1dfbcfa5d49","2020-05-13T20:00:00Z",1809,6404,173574,173574,173574,24,53,117,3320,751,4071
"864",20200513,"ME",1515,22092,NA,41,204,20,NA,7,NA,943,"B","5/13/2020 12:30","20cebe6a0dde50f21335799472837100f364019c","2020-05-13T20:00:00Z",66,204,23607,23607,23607,23,1,2,0,38,38
"865",20200513,"MI",48391,259869,NA,1384,NA,693,NA,525,NA,22686,"A+","5/13/2020 11:00","8c362386bb61b44481f31cefb3e2fb6a6607884a","2020-05-13T20:00:00Z",4714,NA,308260,308260,308260,26,40,0,0,370,370
"866",20200513,"MN",12917,109118,NA,494,1851,199,647,NA,NA,8149,"A+","5/12/2020 17:00","cb2b7b13c5966374bc33f734f8cf46a79339ad71","2020-05-13T20:00:00Z",638,1851,122035,122035,122035,27,24,52,778,423,1201
"867",20200513,"MO",10142,114000,NA,771,NA,NA,NA,129,NA,NA,"B","5/13/2020 15:00","2a5d4cdbefd6105fb82708c9457a7883d72e52d6","2020-05-13T20:00:00Z",542,NA,124142,124142,124142,29,18,0,2710,136,2846
"868",20200513,"MP",19,3021,NA,NA,NA,NA,NA,NA,NA,12,"D","5/13/2020 00:00","928c81f38edb611befb506b92974b588a3693a02","2020-05-13T20:00:00Z",2,NA,3040,3040,3040,69,0,0,167,0,167
"869",20200513,"MS",10090,89958,NA,604,1616,150,NA,79,NA,6268,"A","5/12/2020 19:00","5694ba1eb7d050ab826606ab2f4fcaeb33d28ca1","2020-05-13T20:00:00Z",465,1616,100048,100048,100048,28,8,34,2174,182,2356
"870",20200513,"MT",462,23390,NA,3,63,NA,NA,NA,NA,430,"B","5/13/2020 00:00","361e8774d1eb2ee74016227b7b2c8e1aa970c248","2020-05-13T20:00:00Z",16,63,23852,23852,23852,30,0,0,816,1,817
"871",20200513,"NC",15816,194641,NA,521,NA,NA,NA,NA,NA,9115,"A","5/13/2020 10:40","f2c7adc6470979e3d0020cdec2a2c65ad8ae8958","2020-05-13T20:00:00Z",597,NA,210457,210457,210457,37,20,0,7743,470,8213
"872",20200513,"ND",1647,47298,NA,37,127,NA,NA,NA,NA,969,"C","5/13/2020 13:00","318a9e66fa74eb4f693061ca3eee2b00fa2f8025","2020-05-13T20:00:00Z",40,127,48945,48945,48945,38,2,5,1037,76,1113
"873",20200513,"NE",8692,41033,NA,192,NA,81,NA,56,NA,NA,"B","5/12/2020 20:00","03d5496c5e3e98969ecdb244cab1cd95b25900c0","2020-05-13T20:00:00Z",103,NA,49725,49725,49725,31,3,0,1662,120,1782
"874",20200513,"NH",3239,33977,51,121,319,NA,97,NA,NA,1234,"B","5/12/2020 09:00","bd2864c1732c7c51efa2c636d5a748767e45ba3b","2020-05-13T20:00:00Z",142,319,37267,37216,37216,33,9,1,1576,79,1655
"875",20200513,"NJ",141560,299890,NA,4226,NA,1226,NA,928,NA,15642,"A+","5/13/2020 13:00","f080f7b1131f2cd1e51e3984e7275eafd2fbf137","2020-05-13T20:00:00Z",9702,NA,441450,441450,441450,34,194,0,7573,817,8390
"876",20200513,"NM",5212,105077,NA,199,886,NA,NA,NA,NA,1434,"C","5/12/2020 18:05","cc555962aec1775c9b2aa39e2ea20c8d360ca464","2020-05-13T20:00:00Z",219,886,110289,110289,110289,35,11,0,3425,143,3568
"877",20200513,"NV",6394,60278,NA,522,NA,121,NA,64,NA,198,"B","5/13/2020 12:30","f46eef093bc1eeb5fb3866f8105008601d5bb001","2020-05-13T20:00:00Z",321,NA,66672,66672,66672,32,9,0,2514,83,2597
"878",20200513,"NY",340661,918246,NA,6946,73963,2308,NA,1908,NA,59193,"A","5/13/2020 00:00","1d5851bab770a5879020e77f52e0b97326cdb80b","2020-05-13T20:00:00Z",22013,73963,1258907,1258907,1258907,36,168,820,31618,2176,33794
"879",20200513,"OH",25721,200133,NA,924,4618,353,1248,244,NA,NA,"B","5/13/2020 14:00","1321d9f890ba99e305ca496b34de3698619412e9","2020-05-13T20:00:00Z",1483,4618,225854,225854,225854,39,47,79,7652,471,8123
"880",20200513,"OK",4852,104275,NA,218,848,93,NA,NA,NA,3559,"A+","5/13/2020 00:00","b3ffbb4664ecaafea7c4d541c9a67a2de68fb08b","2020-05-13T20:00:00Z",278,848,109127,109127,109127,40,0,20,12896,120,13016
"881",20200513,"OR",3416,80571,NA,162,678,38,NA,17,NA,1406,"A+","5/13/2020 11:00","438a05f6bb0140dd606b5e9ee9a7700f234b29c4","2020-05-13T20:00:00Z",134,678,83987,83987,83987,41,4,5,6251,130,6381
"882",20200513,"PA",58698,244171,NA,2012,NA,NA,NA,473,NA,NA,"C","5/13/2020 00:00","43c50f8a017e6821f22efc238e2b98387fe5b6e7","2020-05-13T20:00:00Z",3943,NA,302869,302869,302869,42,137,0,6182,707,6889
"883",20200513,"PR",2329,NA,NA,NA,NA,10,NA,6,NA,NA,"C","5/12/2020 06:30","57a9745f2eb1affe18e0f04f5260d6b9dbaa5fbc","2020-05-13T20:00:00Z",115,NA,2329,2329,2329,72,1,0,0,30,30
"884",20200513,"RI",11835,86087,NA,269,1328,68,NA,48,NA,886,"A+","5/13/2020 12:00","93ba1f99e544c799306fd6357827f5258cd40afd","2020-05-13T20:00:00Z",462,1328,97922,97922,97922,44,18,21,2462,221,2683
"885",20200513,"SC",7927,85213,NA,NA,1338,NA,NA,NA,NA,6817,"A","5/12/2020 16:14","70f6e29cf342781052323ec4f1b865022490ea78","2020-05-13T20:00:00Z",355,1338,93140,93140,93140,45,0,0,0,0,0
"886",20200513,"SD",3732,22112,NA,79,281,NA,NA,NA,NA,2367,"B","5/13/2020 11:30","2aaa32c067f9470c0024e7f98385d39217d55398","2020-05-13T20:00:00Z",39,281,25844,25844,25844,46,0,10,578,69,647
"887",20200513,"TN",16370,276547,NA,NA,1388,NA,NA,NA,NA,8624,"A","5/13/2020 15:00","ebaedd06baf811ad7f323b6813a59ea7d61735bb","2020-05-13T20:00:00Z",273,1388,292917,292917,292917,47,8,25,8834,259,9093
"888",20200513,"TX",42403,514373,NA,1676,NA,NA,NA,NA,NA,23519,"A","5/13/2020 16:20","8acbaee9922c98c560d0c617b6a3d776886fa771","2020-05-13T20:00:00Z",1158,NA,556776,556776,556776,48,25,0,17249,1355,18604
"889",20200513,"UT",6620,150166,NA,158,553,NA,182,NA,81,3406,"B","5/13/2020 15:00","c96cabfeb092c582c0c85316242bda57bff1b78b","2020-05-13T20:00:00Z",75,553,156786,156786,156786,49,2,18,3113,188,3301
"890",20200513,"VA",26746,134646,485,1526,5080,374,NA,202,NA,3554,"A+","5/12/2020 17:00","563149eb30c1da27c4136ef18ff4863d26a8d4a2","2020-05-13T20:00:00Z",927,5080,161877,161392,161392,51,36,151,5117,946,6063
"891",20200513,"VI",69,1128,62,NA,NA,NA,NA,NA,NA,61,"C","5/12/2020 18:22","71b6080224de80acc7690e1b487e0ae3b5df3fd8","2020-05-13T20:00:00Z",6,NA,1259,1197,1197,78,0,0,13,0,13
"892",20200513,"VT",930,19708,NA,17,NA,NA,NA,NA,NA,789,"B","5/13/2020 00:00","c0a564d1e2f42e64651f1559f4b5a09a26f612b8","2020-05-13T20:00:00Z",53,NA,20638,20638,20638,50,0,0,601,1,602
"893",20200513,"WA",18249,259817,NA,384,NA,114,NA,NA,NA,NA,"A","5/13/2020 00:00","4e69ffe690400c61bebcd4a405acd182ae47bed1","2020-05-13T20:00:00Z",962,NA,278066,278066,278066,53,17,0,5999,280,6279
"894",20200513,"WI",10902,117111,194,527,1908,110,469,NA,NA,5673,"A+","5/13/2020 00:00","de4d8a420d2a38d3221e26646d14ac0b3b301ba5","2020-05-13T20:00:00Z",421,1908,128207,128013,128013,55,3,31,4363,291,4654
"895",20200513,"WV",1398,65282,NA,58,NA,11,NA,6,NA,813,"B","5/13/2020 10:00","cdbda082a3958ef1d0728802889e7e30636f86cb","2020-05-13T20:00:00Z",58,NA,66680,66680,66680,54,1,0,1584,27,1611
"896",20200513,"WY",675,14384,NA,10,67,NA,NA,NA,NA,477,"B","5/12/2020 15:50","fc0baf8b80b394019ff6c64f6f3b59f9c5daf0b0","2020-05-13T20:00:00Z",7,67,15059,15059,15059,56,0,0,0,0,0
"897",20200512,"AK",383,29578,NA,10,NA,NA,NA,NA,NA,334,"B","5/12/2020 00:00","ad64932142ec53f8eee1158369c6db3eb643ceed","2020-05-12T20:00:00Z",10,NA,29961,29961,29961,2,0,0,1279,2,1281
"898",20200512,"AL",10310,122908,NA,NA,1287,NA,468,NA,280,NA,"B","5/12/2020 00:00","dc0d90e43e92b36fb107e2ec174f64c4e91412e9","2020-05-12T20:00:00Z",429,1287,133218,133218,133218,1,28,31,3473,301,3774
"899",20200512,"AR",4164,66280,NA,59,485,NA,NA,12,98,3220,"A","5/11/2020 18:55","c6b2b29faaf304a3e36270f55c766b0fc9773bc2","2020-05-12T20:00:00Z",95,485,70444,70444,70444,5,1,5,1284,130,1414
"900",20200512,"AS",0,105,NA,NA,NA,NA,NA,NA,NA,NA,"C","5/10/2020 00:00","92e4d4fafe1a2e9955e7a0bac38789993d7da480","2020-05-12T20:00:00Z",0,NA,105,105,105,60,0,0,0,0,0
"901",20200512,"AZ",11736,111106,NA,765,1564,318,NA,204,NA,2909,"A+","5/12/2020 00:00","e1f3e3aa6e1b798039369c830077e7267e4a6cde","2020-05-12T20:00:00Z",562,1564,122842,122842,122842,4,20,27,6022,356,6378
"902",20200512,"CA",69382,963988,NA,4544,NA,1349,NA,NA,NA,NA,"B","5/12/2020 00:00","1c3c812803c41f5b0c75e07b15a8a4428e7d662f","2020-05-12T20:00:00Z",2847,NA,1033370,1033370,1033370,6,77,0,40030,1443,41473
"903",20200512,"CO",19879,88778,NA,738,3663,NA,NA,NA,NA,3114,"A","5/10/2020 00:00","141998ef5f6d8315b29a660425fd4378eef65180","2020-05-12T20:00:00Z",987,3663,108657,108657,108657,8,6,-26,-113,-20,-133
"904",20200512,"CT",34333,104091,NA,1189,9389,NA,NA,NA,NA,5413,"B","5/12/2020 14:00","94125cc6367af615dfdf3201a4acadd5160e7787","2020-05-12T20:00:00Z",3041,9389,138424,138424,138424,9,33,0,5348,568,5916
"905",20200512,"DC",6485,24565,NA,416,NA,NA,NA,82,NA,886,"A","5/11/2020 00:00","9437f63c6fb36500cb3681a8b3667804ea58935d","2020-05-12T20:00:00Z",336,NA,31050,31050,31050,11,8,0,693,96,789
"906",20200512,"DE",6741,26550,NA,276,NA,NA,NA,NA,NA,2802,"B","5/11/2020 18:00","aae09df87e288b5d98307ab1d05ee660312b75ef","2020-05-12T20:00:00Z",237,NA,33291,33291,33291,10,12,0,1187,176,1363
"907",20200512,"FL",41923,537681,1064,NA,7654,NA,NA,NA,NA,NA,"A+","5/12/2020 09:28","c095dad326b6e29d6cdc568a6f8b53a910be8121","2020-05-12T20:00:00Z",1849,7654,580668,579604,579604,12,44,196,17606,941,18547
"908",20200512,"GA",34635,227544,NA,NA,6130,NA,1443,NA,NA,NA,"A+","5/11/2020 13:00","b0656969e39a973d0cb2d4fdbf46bac5ffc9f638","2020-05-12T20:00:00Z",1461,6130,262179,262179,262179,13,20,115,10183,708,10891
"909",20200512,"GU",152,3939,NA,NA,NA,NA,NA,NA,NA,124,"C","5/11/2020 18:00","b07de06424b91c7563ec1fd794d01ec27c2988d9","2020-05-12T20:00:00Z",5,NA,4091,4091,4091,66,0,0,101,1,102
"910",20200512,"HI",634,37305,NA,NA,81,NA,NA,NA,NA,561,"B","5/11/2020 18:00","4c15f93f1f310f449317b691c7504e27d4b0a992","2020-05-12T20:00:00Z",17,81,37939,37939,37939,15,0,0,254,2,256
"911",20200512,"IA",12912,68376,NA,385,NA,143,NA,101,NA,5618,"A+","5/12/2020 00:00","851003bc001f9d3c6070b7a0744f75232b70cfef","2020-05-12T20:00:00Z",289,NA,81288,81288,81288,19,18,0,2957,539,3496
"912",20200512,"ID",2260,30445,NA,NA,210,NA,87,NA,NA,1508,"B","5/11/2020 19:00","cdfbbe6e13eb9a49d4af2261bc1c8e26d78e13a9","2020-05-12T20:00:00Z",70,210,32705,32705,32705,16,3,3,533,30,563
"913",20200512,"IL",83021,388670,NA,4626,NA,1215,NA,730,NA,NA,"A","5/12/2020 00:00","7eeee0fea9bfea9b5d442150defcb14e725265a0","2020-05-12T20:00:00Z",3601,NA,471691,471691,471691,17,142,0,25252,4014,29266
"914",20200512,"IN",25127,125383,NA,1283,4389,472,NA,212,NA,NA,"A+","5/11/2020 23:59","ec63c274fb44ab277a9da75afd8d13931ce0bd12","2020-05-12T20:00:00Z",1578,4389,150510,150510,150510,18,38,0,3322,500,3822
"915",20200512,"KS",7116,46993,NA,NA,660,NA,233,NA,101,376,"A","5/11/2020 10:00","e4e4b08f70f7483e20e2d1ab1e8a88a904c403de","2020-05-12T20:00:00Z",158,660,54109,54109,54109,20,0,0,0,0,0
"916",20200512,"KY",6677,97347,NA,383,1767,220,768,NA,NA,2335,"A+","5/11/2020 17:00","49f080fd95b649d6f35a2acacf5d6189f063f556","2020-05-12T20:00:00Z",311,1767,104024,104024,104024,21,7,10,16864,237,17101
"917",20200512,"LA",32050,195962,NA,1320,NA,NA,NA,146,NA,22608,"B","5/12/2020 13:00","725798364fbd1d9d469c7f8d7a9f48c9d6dc5826","2020-05-12T20:00:00Z",2347,NA,228012,228012,228012,22,39,0,6947,235,7182
"918",20200512,"MA",79332,322164,NA,3127,7842,818,NA,NA,NA,NA,"A+","5/12/2020 10:00","c0ec660677afe7ab283ad8476d692eac9ab0c5c5","2020-05-12T20:00:00Z",5141,7842,401496,401496,401496,25,33,110,5898,870,6768
"919",20200512,"MD",34061,135442,NA,1563,6287,590,NA,NA,NA,2394,"B","5/12/2020 10:00","2142d1295ff6b5b79e60702668d777393cb8035b","2020-05-12T20:00:00Z",1756,6287,169503,169503,169503,24,73,104,4035,688,4723
"920",20200512,"ME",1477,22092,NA,34,202,17,NA,8,NA,913,"B","5/12/2020 12:30","8d555f344de837c9297183826a631604f9095d84","2020-05-12T20:00:00Z",65,202,23569,23569,23569,23,0,2,0,15,15
"921",20200512,"MI",48021,259869,NA,1384,NA,693,NA,525,NA,22686,"A+","5/12/2020 11:00","f89a13701a2f7ee5383d462bde185e0e48ce1c94","2020-05-12T20:00:00Z",4674,NA,307890,307890,307890,26,90,0,8473,469,8942
"922",20200512,"MN",12494,108340,NA,496,1799,199,625,NA,NA,7609,"A","5/11/2020 17:00","94e73ef963e7f3b480431b17800b26277fe73864","2020-05-12T20:00:00Z",614,1799,120834,120834,120834,27,23,83,4358,695,5053
"923",20200512,"MO",10006,111290,NA,787,NA,NA,NA,140,NA,NA,"B","5/12/2020 15:00","a0b380a66f7e018682c96854e0dc4ebd6529dba4","2020-05-12T20:00:00Z",524,NA,121296,121296,121296,29,36,0,5588,88,5676
"924",20200512,"MP",19,2854,NA,NA,NA,NA,NA,NA,NA,12,"D","5/12/2020 00:00","de6e7a04c4dcd1ab903b996dfb4990a2a9981bba","2020-05-12T20:00:00Z",2,NA,2873,2873,2873,69,0,0,178,0,178
"925",20200512,"MS",9908,87784,NA,604,1582,146,NA,75,NA,6268,"A","5/11/2020 19:00","c2ad322a2ca23780c0423744f1c8d342b86e2cde","2020-05-12T20:00:00Z",457,1582,97692,97692,97692,28,22,36,1573,234,1807
"926",20200512,"MT",461,22574,NA,4,63,NA,NA,NA,NA,425,"B","5/12/2020 00:00","2b3dc441154f5955223ec8be3d6b25315ae87038","2020-05-12T20:00:00Z",16,63,23035,23035,23035,30,0,1,461,2,463
"927",20200512,"NC",15346,186898,NA,475,NA,NA,NA,NA,NA,9115,"A","5/12/2020 11:00","99811235d4384d8dc44fb9b020be9a445fca0410","2020-05-12T20:00:00Z",577,NA,202244,202244,202244,37,27,0,6078,301,6379
"928",20200512,"ND",1571,46261,NA,38,122,NA,NA,NA,NA,877,"C","5/12/2020 12:10","6439186903c6409dca9c56820e62dc85e6ab838e","2020-05-12T20:00:00Z",38,122,47832,47832,47832,38,2,7,765,53,818
"929",20200512,"NE",8572,39371,NA,192,NA,81,NA,56,NA,NA,"B","5/11/2020 20:05","82de0819c060549c93f72549b792b5de897151e2","2020-05-12T20:00:00Z",100,NA,47943,47943,47943,31,2,0,1447,257,1704
"930",20200512,"NH",3160,32401,54,117,318,NA,97,NA,NA,1231,"B","5/11/2020 09:00","4ea2337b6353839aa3392a0949b5de5037f18200","2020-05-12T20:00:00Z",133,318,35615,35561,35561,33,0,0,678,0,678
"931",20200512,"NJ",140743,292317,NA,4328,NA,1306,NA,982,NA,15642,"A+","5/12/2020 13:00","a551c9bb3078185c8537e653e9855a75e1844e2f","2020-05-12T20:00:00Z",9508,NA,433060,433060,433060,34,198,0,6329,798,7127
"932",20200512,"NM",5069,101652,NA,207,886,NA,NA,NA,NA,1300,"C","5/11/2020 22:33","6d7039f5d1bc3661cde6775cc8c8f54088ec2a2b","2020-05-12T20:00:00Z",208,886,106721,106721,106721,35,8,97,4017,206,4223
"933",20200512,"NV",6311,57764,NA,522,NA,121,NA,64,NA,185,"C","5/12/2020 12:30","a1ac2e2156586d3396c44f016461670c4d570e8e","2020-05-12T20:00:00Z",312,NA,64075,64075,64075,32,6,0,3832,159,3991
"934",20200512,"NY",338485,886628,NA,7063,73143,2375,NA,1964,NA,58679,"A","5/12/2020 00:00","557195b2b5a5899f0b86cf3d014ed6a5b11dd26a","2020-05-12T20:00:00Z",21845,73143,1225113,1225113,1225113,36,205,0,19032,1430,20462
"935",20200512,"OH",25250,192481,NA,1032,4539,401,1232,270,NA,NA,"B","5/12/2020 14:00","de8d2b78e3adb0f6a856466164f7abbfe651e297","2020-05-12T20:00:00Z",1436,4539,217731,217731,217731,39,79,126,6728,473,7201
"936",20200512,"OK",4732,91379,NA,190,828,83,NA,NA,NA,3423,"A+","5/12/2020 00:00","ab5d94f248233e426e55e603e11be5d53cb0fc1d","2020-05-12T20:00:00Z",278,828,96111,96111,96111,40,4,0,0,119,119
"937",20200512,"OR",3286,74320,NA,165,673,39,NA,25,NA,1125,"A+","5/12/2020 11:52","2d615f054ea8e40981ad1c1119401e4cfae83193","2020-05-12T20:00:00Z",130,673,77606,77606,77606,41,0,0,0,0,0
"938",20200512,"PA",57991,237989,NA,2187,NA,NA,NA,497,NA,NA,"C","5/12/2020 12:00","fa3ba6d4689c14fb4158f6072afa997b7d6078e3","2020-05-12T20:00:00Z",3806,NA,295980,295980,295980,42,75,0,6285,837,7122
"939",20200512,"PR",2299,NA,NA,NA,NA,NA,NA,NA,NA,NA,"C","5/12/2020 06:30","dd849b252fa9866c8bba2f82baae46c6f552e95d","2020-05-12T20:00:00Z",114,NA,2299,2299,2299,72,1,0,0,43,43
"940",20200512,"RI",11614,83625,NA,277,1307,72,NA,53,NA,863,"A+","5/12/2020 12:00","0b3efb331e4b384182d3a043259392a9b43e03e5","2020-05-12T20:00:00Z",444,1307,95239,95239,95239,44,14,27,1743,164,1907
"941",20200512,"SC",7927,85213,NA,NA,1338,NA,NA,NA,NA,6817,"A","5/12/2020 16:14","d9ad2effd29087d5acdaddd770ddf5116ff02f21","2020-05-12T20:00:00Z",355,1338,93140,93140,93140,45,24,86,8409,274,8683
"942",20200512,"SD",3663,21534,NA,74,271,NA,NA,NA,NA,2309,"B","5/12/2020 11:30","398b44ebe956f8b3706040627f7a9fbc550424f1","2020-05-12T20:00:00Z",39,271,25197,25197,25197,46,5,8,570,49,619
"943",20200512,"TN",16111,267713,NA,NA,1363,NA,NA,NA,NA,8336,"A","5/12/2020 16:00","b54071de6f6bdd53a83161c3100769996827243e","2020-05-12T20:00:00Z",265,1363,283824,283824,283824,47,14,19,9980,567,10547
"944",20200512,"TX",41048,497124,NA,1725,NA,NA,NA,NA,NA,22674,"A","5/11/2020 16:25","11b70727dc1782af8dae590db1e184305ba794d7","2020-05-12T20:00:00Z",1133,NA,538172,538172,538172,48,33,0,11296,1179,12475
"945",20200512,"UT",6432,147053,NA,166,535,NA,178,NA,80,3267,"B","5/12/2020 15:00","529a080f15d8f439a8f5d45ba54214b08fd1cdbc","2020-05-12T20:00:00Z",73,535,153485,153485,153485,49,5,18,2830,70,2900
"946",20200512,"VA",25800,129529,447,1529,4929,364,NA,201,NA,3400,"A+","5/12/2020 09:00","45d4f6b36abd4c2c07613461218de47ff5c0c389","2020-05-12T20:00:00Z",891,4929,155776,155329,155329,51,41,152,3982,730,4712
"947",20200512,"VI",69,1115,58,NA,NA,NA,NA,NA,NA,61,"C","5/12/2020 14:19","866582e0254dc6dd9d7793bd722ba6661a15affc","2020-05-12T20:00:00Z",6,NA,1242,1184,1184,78,1,0,5,0,5
"948",20200512,"VT",929,19107,NA,18,NA,NA,NA,NA,NA,787,"B","5/12/2020 00:00","ec47f00ffa089616bae20aa70b90268d1ed8cc0b","2020-05-12T20:00:00Z",53,NA,20036,20036,20036,50,0,0,310,2,312
"949",20200512,"WA",17969,253818,NA,321,NA,94,NA,NA,NA,NA,"A","5/12/2020 00:00","fa0129bf086192ec1fa0707a4e662567d93bb8f3","2020-05-12T20:00:00Z",945,NA,271787,271787,271787,53,14,0,5869,241,6110
"950",20200512,"WI",10611,112748,180,520,1877,116,464,NA,NA,5371,"A+","5/12/2020 12:23","0f63f7dde4112e772bcdfc22930c6a3f586ed906","2020-05-12T20:00:00Z",418,1877,123539,123359,123359,55,9,31,4715,193,4908
"951",20200512,"WV",1371,63698,NA,50,NA,9,NA,5,NA,803,"C","5/12/2020 10:00","f37078141cf9d5c1e30b4386d7cb47825c2621bd","2020-05-12T20:00:00Z",57,NA,65069,65069,65069,54,3,0,1595,5,1600
"952",20200512,"WY",675,14384,NA,10,67,NA,NA,NA,NA,477,"B","5/12/2020 15:50","edb8d27bf5882660de5e5b0543f7624c2b51f9d2","2020-05-12T20:00:00Z",7,67,15059,15059,15059,56,0,1,2981,13,2994
"953",20200511,"AK",381,28299,NA,7,NA,NA,NA,NA,NA,328,"C","5/11/2020 00:00","a7223546ea51f5c1f4befbca92cbba972c4254a3","2020-05-11T20:00:00Z",10,NA,28680,28680,28680,2,0,0,1314,2,1316
"954",20200511,"AL",10009,119435,NA,NA,1256,NA,463,NA,276,NA,"B","5/11/2020 00:00","7a458a485ba87dec00819901d27fc50e4fbfdb01","2020-05-11T20:00:00Z",401,1256,129444,129444,129444,1,8,16,1791,232,2023
"955",20200511,"AR",4034,64996,NA,61,480,NA,NA,11,98,3149,"A","5/10/2020 19:05","dbe584b0f033faf71ab1255e32755841c0161597","2020-05-11T20:00:00Z",94,480,69030,69030,69030,5,6,9,3215,287,3502
"956",20200511,"AS",0,105,NA,NA,NA,NA,NA,NA,NA,NA,"D","5/10/2020 00:00","9b5ed3d398c7403c615f2cb9e18aff10510c6d39","2020-05-11T20:00:00Z",0,NA,105,105,105,60,0,0,22,0,22
"957",20200511,"AZ",11380,105084,NA,717,1537,297,NA,201,NA,2852,"A+","5/11/2020 00:00","afa17a1ea8cc6e6a5c171643105c247148ac1517","2020-05-11T20:00:00Z",542,1537,116464,116464,116464,4,6,9,5826,261,6087
"958",20200511,"CA",67939,923958,NA,4549,NA,1329,NA,NA,NA,NA,"B","5/11/2020 00:00","53613cacac307d4a734c079025735a0eec798c35","2020-05-11T20:00:00Z",2770,NA,991897,991897,991897,6,25,0,34974,1259,36233
"959",20200511,"CO",19899,88891,NA,573,3689,NA,NA,NA,NA,3076,"B","5/9/2020 00:00","d264f761689eb0a1f19c6dd11a87d98c9aa6ea95","2020-05-11T20:00:00Z",981,3689,108790,108790,108790,8,14,66,4517,196,4713
"960",20200511,"CT",33765,98743,NA,1212,9389,NA,NA,NA,NA,5413,"B","5/11/2020 14:00","725f98630b953261d0e361ea3ce240eb58dd87a5","2020-05-11T20:00:00Z",3008,9389,132508,132508,132508,9,41,0,2105,211,2316
"961",20200511,"DC",6389,23872,NA,416,NA,NA,NA,82,NA,881,"A","5/10/2020 00:00","96823a86d077b838aa718a491d8ad8e667579778","2020-05-11T20:00:00Z",328,NA,30261,30261,30261,11,5,0,574,117,691
"962",20200511,"DE",6565,25363,NA,275,NA,NA,NA,NA,NA,2619,"B","5/10/2020 18:00","b495a3c92d603717fcb0e0353a8b46934f687d7a","2020-05-11T20:00:00Z",225,NA,31928,31928,31928,10,1,0,771,118,889
"963",20200511,"FL",40982,520075,1080,NA,7458,NA,NA,NA,NA,NA,"B","5/11/2020 09:31","41a0c5448dd172e1de13ee660933da7aca6920e0","2020-05-11T20:00:00Z",1805,7458,562137,561057,561057,12,14,54,21723,386,22109
"964",20200511,"GA",33927,217361,NA,NA,6015,NA,1414,NA,NA,NA,"A","5/11/2020 13:00","36622751034808e79ec4a2f2a0e717a7238d62c4","2020-05-11T20:00:00Z",1441,6015,251288,251288,251288,13,36,18,7255,486,7741
"965",20200511,"GU",151,3838,NA,NA,NA,NA,NA,NA,NA,124,"C","5/11/2020 06:45","344915c252ec72e2897d08cedf0096c076238394","2020-05-11T20:00:00Z",5,NA,3989,3989,3989,66,0,0,195,0,195
"966",20200511,"HI",632,37051,NA,NA,81,NA,NA,NA,NA,561,"B","5/10/2020 18:00","c1a3fdf904f506a49beb3904919cfb214d1056b1","2020-05-11T20:00:00Z",17,81,37683,37683,37683,15,0,0,412,1,413
"967",20200511,"IA",12373,65419,NA,394,NA,152,NA,107,NA,5249,"A+","5/11/2020 00:00","6dc1fea55734472dff46f44afd605f1af78a08de","2020-05-11T20:00:00Z",271,NA,77792,77792,77792,19,6,0,3204,414,3618
"968",20200511,"ID",2230,29912,NA,NA,207,NA,87,NA,NA,1473,"B","5/9/2020 19:00","320a48fe6833d123bb557c59e853aa6f0948fc96","2020-05-11T20:00:00Z",67,207,32142,32142,32142,16,0,0,0,0,0
"969",20200511,"IL",79007,363418,NA,4319,NA,1248,NA,730,NA,NA,"A","5/11/2020 00:00","f44cdbee224288e9756f9c879b4330cf1a40125a","2020-05-11T20:00:00Z",3459,NA,442425,442425,442425,17,53,0,11175,1266,12441
"970",20200511,"IN",24627,122061,NA,1346,4389,452,990,213,NA,NA,"A+","5/10/2020 23:59","a57c95bf26ced24d8dba4841fca0b3ed92f8ddfd","2020-05-11T20:00:00Z",1540,4389,146688,146688,146688,18,32,0,6158,501,6659
"971",20200511,"KS",7116,46993,NA,NA,660,NA,233,NA,101,376,"A","5/11/2020 10:00","37cb8fd29d5e89ecc06556f7e2c38e2870d68a69","2020-05-11T20:00:00Z",158,660,54109,54109,54109,20,1,3,1436,168,1604
"972",20200511,"KY",6440,80483,NA,394,1757,226,758,NA,NA,2308,"A","5/9/2020 17:00","65bd44bbae0cf8f21518a61a2cf25ccc1bd682fc","2020-05-11T20:00:00Z",304,1757,86923,86923,86923,21,0,0,0,0,0
"973",20200511,"LA",31815,189015,NA,1310,NA,NA,NA,157,NA,22608,"B","5/11/2020 13:00","882c80ef83db3a2040f72edd1c0b65c14bcf63be","2020-05-11T20:00:00Z",2308,NA,220830,220830,220830,22,22,0,4743,215,4958
"974",20200511,"MA",78462,316266,NA,3102,7732,813,NA,NA,NA,NA,"A","5/11/2020 10:00","6e951327a5d89abb820241523b201fdd432bb5e9","2020-05-11T20:00:00Z",5108,7732,394728,394728,394728,25,129,115,5670,669,6339
"975",20200511,"MD",33373,131407,NA,1544,6183,585,NA,NA,NA,2298,"A","5/11/2020 10:00","8eb40ee065afac534d20547f61f42f71c62ff92e","2020-05-11T20:00:00Z",1683,6183,164780,164780,164780,24,39,228,4063,786,4849
"976",20200511,"ME",1462,22092,NA,37,200,17,NA,9,NA,872,"B","5/11/2020 12:00","c25684830089eb770ad7aedc26e6565286ebfbab","2020-05-11T20:00:00Z",65,200,23554,23554,23554,23,1,1,0,26,26
"977",20200511,"MI",47552,251396,NA,1424,NA,685,NA,557,NA,22686,"A+","5/11/2020 11:00","a5d0f888a8b221813babc8a27f5015b598c9a9c2","2020-05-11T20:00:00Z",4584,NA,298948,298948,298948,26,33,0,12856,414,13270
"978",20200511,"MN",11799,103982,NA,452,1716,194,600,NA,NA,6945,"A","5/10/2020 17:00","ecafaae09dc0d562862664aff3f747447fd8284b","2020-05-11T20:00:00Z",591,1716,115781,115781,115781,27,13,59,4165,528,4693
"979",20200511,"MO",9918,105702,NA,824,NA,NA,NA,137,NA,NA,"B","5/11/2020 15:00","0a40716dc1fc6b5028e3a0b211783ea46f043cd9","2020-05-11T20:00:00Z",488,NA,115620,115620,115620,29,6,0,0,74,74
"980",20200511,"MP",19,2676,NA,NA,NA,NA,NA,NA,NA,12,"D","5/11/2020 00:00","5083b9724765025f257e7b96c00732bf25063219","2020-05-11T20:00:00Z",2,NA,2695,2695,2695,69,0,0,355,3,358
"981",20200511,"MS",9674,86211,NA,507,1546,132,NA,68,NA,6268,"A","5/10/2020 19:00","7b98e0ac888e25cb18aced67458df0e038dbf2cb","2020-05-11T20:00:00Z",435,1546,95885,95885,95885,28,5,15,14110,173,14283
"982",20200511,"MT",459,22113,NA,4,62,NA,NA,NA,NA,423,"C","5/10/2020 00:00","8bbba487e4da82581b0cf57a838d1c0a9b85971f","2020-05-11T20:00:00Z",16,62,22572,22572,22572,30,0,0,867,1,868
"983",20200511,"NC",15045,180820,NA,464,NA,NA,NA,NA,NA,9115,"B","5/11/2020 14:00","df1be569ae745bfd298a930e35362f09b2dad0c9","2020-05-11T20:00:00Z",550,NA,195865,195865,195865,37,3,0,3449,281,3730
"984",20200511,"ND",1518,45496,NA,34,115,NA,NA,NA,NA,846,"C","5/11/2020 12:10","0d5f52057ed67028f24db06f823d35bd8a25a4fa","2020-05-11T20:00:00Z",36,115,47014,47014,47014,38,1,5,2118,27,2145
"985",20200511,"NE",8315,37924,NA,NA,NA,NA,NA,NA,NA,NA,"D","5/10/2020 19:45","e58065fd1954d908292eee28a9f7fa0147c1658f","2020-05-11T20:00:00Z",98,NA,46239,46239,46239,31,2,0,589,81,670
"986",20200511,"NH",3160,31723,261,113,318,NA,97,NA,NA,1229,"B","5/10/2020 09:00","1e4d21c6c7cb4723f7c568bff5bb5287f0176a6c","2020-05-11T20:00:00Z",133,318,35144,34883,34883,33,2,5,1281,149,1430
"987",20200511,"NJ",139945,285988,NA,4195,NA,1255,NA,970,NA,15642,"A+","5/11/2020 13:00","94fa78b2e3195af312b3de2382d6da9df5a34c2d","2020-05-11T20:00:00Z",9310,NA,425933,425933,425933,34,55,0,112073,1413,113486
"988",20200511,"NM",4863,97635,NA,194,789,NA,NA,NA,NA,1285,"C","5/10/2020 17:50","431ea4a184bf3daa6990f2048eadb3bbffd4e3a3","2020-05-11T20:00:00Z",200,789,102498,102498,102498,35,9,0,5360,85,5445
"989",20200511,"NV",6152,53932,NA,482,NA,117,NA,60,NA,183,"C","5/11/2020 13:30","835d3bc0c7cb54e6e40f6e63266d5675959a69a6","2020-05-11T20:00:00Z",306,NA,60084,60084,60084,32,0,0,1221,54,1275
"990",20200511,"NY",337055,867596,NA,7226,73143,2450,NA,2020,NA,58363,"A","5/10/2020 00:00","c605cd69fc6d8af2586f5f00c31106bff9a1edd9","2020-05-11T20:00:00Z",21640,73143,1204651,1204651,1204651,36,162,428,19993,1660,21653
"991",20200511,"OH",24777,185753,NA,1011,4413,391,1217,256,NA,NA,"B","5/11/2020 14:00","cdf49b3d1bbbb6ee921c935e2760c07c4064d760","2020-05-11T20:00:00Z",1357,4413,210530,210530,210530,39,16,62,4972,696,5668
"992",20200511,"OK",4613,91379,NA,177,828,93,NA,NA,NA,3241,"A+","5/11/2020 00:00","04935b380656454e2afe3546d5ca7532a81d5efa","2020-05-11T20:00:00Z",274,828,95992,95992,95992,40,2,2,0,24,24
"993",20200511,"OR",3286,74320,NA,164,673,40,NA,23,NA,1125,"A+","5/11/2020 11:00","04658e44200d2f00f1f31ece71de204266d1e870","2020-05-11T20:00:00Z",130,673,77606,77606,77606,41,3,3,2041,58,2099
"994",20200511,"PA",57154,231704,NA,2176,NA,NA,NA,497,NA,NA,"C","5/11/2020 00:00","76cf6b30b46ddf22c8cd3d091eea7ae6fde2279b","2020-05-11T20:00:00Z",3731,NA,288858,288858,288858,42,24,0,3932,543,4475
"995",20200511,"PR",2256,NA,NA,NA,NA,NA,NA,NA,NA,NA,"D","5/11/2020 05:57","c241a9b6b383c2725aa95666ccfb34e74c9bf690","2020-05-11T20:00:00Z",113,NA,2256,2256,2256,72,2,0,0,58,58
"996",20200511,"RI",11450,81882,NA,276,1280,73,NA,52,NA,841,"A+","5/11/2020 12:00","5d97783cd28918685ef4cd8e2b2a4452ced74fc9","2020-05-11T20:00:00Z",430,1280,93332,93332,93332,44,8,29,1943,176,2119
"997",20200511,"SC",7653,76804,NA,NA,1252,NA,NA,NA,NA,4120,"B","5/10/2020 16:30","5f9e0d3a2ec058ef8d95dd9bf20de96334069a78","2020-05-11T20:00:00Z",331,1252,84457,84457,84457,45,0,0,0,0,0
"998",20200511,"SD",3614,20964,NA,78,263,NA,NA,NA,NA,2187,"C","5/10/2020 18:00","ad203958ee06caa056610e78ffd6ed44dbf5bdea","2020-05-11T20:00:00Z",34,263,24578,24578,24578,46,0,2,587,97,684
"999",20200511,"TN",15544,257733,NA,NA,1344,NA,NA,NA,NA,8038,"B","5/11/2020 15:00","c4c07a966a9529ae7ebf4274e5f2f04c52e4cfd7","2020-05-11T20:00:00Z",251,1344,273277,273277,273277,47,8,19,10849,559,11408
"1000",20200511,"TX",39869,485828,NA,1525,NA,NA,NA,NA,NA,21713,"B","5/10/2020 16:35","14400b4f7e9ed0cdc8479e35757aa0364baa0578","2020-05-11T20:00:00Z",1100,NA,525697,525697,525697,48,12,0,22921,1000,23921
"1001",20200511,"UT",6362,144223,NA,160,517,NA,169,NA,76,3181,"B","5/11/2020 15:00","fd0ee60a58a8dba6346a766037e5c849819ee5c8","2020-05-11T20:00:00Z",68,517,150585,150585,150585,49,1,5,3964,111,4075
"1002",20200511,"VA",25070,125547,432,1504,4777,362,NA,194,NA,3273,"A+","5/10/2020 17:00","8959bbe05f63848e746dc5bf369ff728539bb0e5","2020-05-11T20:00:00Z",850,4777,151049,150617,150617,51,11,21,6573,989,7562
"1003",20200511,"VI",69,1110,36,NA,NA,NA,NA,NA,NA,60,"C","5/11/2020 09:30","bdb309ceed93be561945a50c86d6472695a67e4b","2020-05-11T20:00:00Z",5,NA,1215,1179,1179,78,1,0,8,0,8
"1004",20200511,"VT",927,18797,NA,14,NA,NA,NA,NA,NA,785,"B","5/11/2020 00:00","19465764838118a2a9fe6fe904a1f043e936fbff","2020-05-11T20:00:00Z",53,NA,19724,19724,19724,50,0,0,630,1,631
"1005",20200511,"WA",17728,247949,NA,350,NA,110,NA,NA,NA,NA,"B","5/11/2020 00:00","0e25fb92adce6b32967ed02c92e22fc012d6878a","2020-05-11T20:00:00Z",931,NA,265677,265677,265677,53,10,0,5610,283,5893
"1006",20200511,"WI",10418,108033,180,520,1846,116,460,NA,NA,5176,"A+","5/11/2020 00:00","633ecbf7b293489344a345f2d9e75dd82a7ed049","2020-05-11T20:00:00Z",409,1846,118631,118451,118451,55,9,26,2870,199,3069
"1007",20200511,"WV",1366,62103,NA,49,NA,10,NA,6,NA,775,"C","5/11/2020 10:00","bed0929e916b8748d922f830ff1fb1496a4d66d3","2020-05-11T20:00:00Z",54,NA,63469,63469,63469,54,0,0,819,6,825
"1008",20200511,"WY",662,11403,NA,12,66,NA,NA,NA,NA,443,"C","5/10/2020 17:38","c83025544ba417d05dd8af280986c4f1014532fd","2020-05-11T20:00:00Z",7,66,12065,12065,12065,56,0,1,0,1,1
"1009",20200510,"AK",379,26985,NA,8,NA,NA,NA,NA,NA,324,"C","5/10/2020 14:00","c326467537b8aa4035125d086454fe043009b85a","2020-05-10T20:00:00Z",10,NA,27364,27364,27364,2,0,0,914,1,915
"1010",20200510,"AL",9777,117644,NA,NA,1240,NA,460,NA,274,NA,"B","5/10/2020 00:00","b784245157e15325dbb3d93142f0dd3e69664809","2020-05-10T20:00:00Z",393,1240,127421,127421,127421,1,5,12,1717,210,1927
"1011",20200510,"AR",3747,61781,NA,64,471,NA,NA,14,96,2968,"B","5/10/2020 10:15","38a9c539abfb2c4f9d79d7cf330d67eada846df5","2020-05-10T20:00:00Z",88,471,65528,65528,65528,5,0,0,0,0,0
"1012",20200510,"AS",0,83,NA,NA,NA,NA,NA,NA,NA,NA,"D","5/3/2020 00:00","d66ec1502bd760d9b7e029ada9baca3d2c30db82","2020-05-10T20:00:00Z",0,NA,83,83,83,60,0,0,0,0,0
"1013",20200510,"AZ",11119,99258,NA,713,1528,300,NA,195,NA,2775,"A+","5/10/2020 00:00","287b2d1ba3cf9773d4cee612cbc898f28a3468cc","2020-05-10T20:00:00Z",536,1528,110377,110377,110377,4,4,14,4408,159,4567
"1014",20200510,"CA",66680,888984,NA,4555,NA,1328,NA,NA,NA,NA,"B","5/10/2020 00:00","b618e4b193ed0312e703672e19ebad8c2eb045b9","2020-05-10T20:00:00Z",2745,NA,955664,955664,955664,6,67,0,40975,2119,43094
"1015",20200510,"CO",19703,84374,NA,790,3623,NA,NA,NA,NA,3023,"B","5/8/2020 00:00","b6464cb169146815265eb578981aabe8c68ff128","2020-05-10T20:00:00Z",967,3623,104077,104077,104077,8,7,23,6429,876,7305
"1016",20200510,"CT",33554,96638,NA,1242,9389,NA,NA,NA,NA,5413,"B","5/10/2020 14:00","a4c7c8644339c7b4965da9d6c0785d7457fe871b","2020-05-10T20:00:00Z",2967,9389,130192,130192,130192,9,35,0,6053,570,6623
"1017",20200510,"DC",6272,23298,NA,447,NA,130,NA,91,NA,880,"A+","5/9/2020 00:00","9ab94b199d79e73252cf8b30ca7cb25d6d2074ee","2020-05-10T20:00:00Z",323,NA,29570,29570,29570,11,12,0,1217,170,1387
"1018",20200510,"DE",6447,24592,NA,285,NA,NA,NA,NA,NA,2537,"B","5/10/2020 12:03","4a92e6d0367c63db9ab97284439e2a5026f20810","2020-05-10T20:00:00Z",224,NA,31039,31039,31039,10,3,0,1573,170,1743
"1019",20200510,"FL",40596,498352,1265,NA,7404,NA,NA,NA,NA,NA,"B","5/10/2020 11:52","5fd55763ed688491e61a8ff37692f6c31604dde6","2020-05-10T20:00:00Z",1791,7404,540213,538948,538948,12,6,79,10622,595,11217
"1020",20200510,"GA",33441,210106,NA,NA,5997,NA,1412,NA,NA,NA,"A","5/10/2020 15:25","86f151b7601a5de5d6bd7691bf065a15a90b1286","2020-05-10T20:00:00Z",1405,5997,243547,243547,243547,13,5,10,7314,909,8223
"1021",20200510,"GU",151,3643,NA,NA,NA,NA,NA,NA,NA,124,"C","5/9/2020 03:50","757ed03d2cb576479b027e5acb6a0cb8fe526263","2020-05-10T20:00:00Z",5,NA,3794,3794,3794,66,0,0,0,0,0
"1022",20200510,"HI",631,36639,NA,NA,81,NA,NA,NA,NA,551,"B","5/9/2020 18:00","072e29ed5e44933022ac843a0e38baa07b4b6c7a","2020-05-10T20:00:00Z",17,81,37270,37270,37270,15,0,0,1006,2,1008
"1023",20200510,"IA",11959,62215,NA,413,NA,157,NA,105,NA,5154,"A+","5/10/2020 00:00","924bfb5cb0d7fcd1dae4deea5efeddce43984d4c","2020-05-10T20:00:00Z",265,NA,74174,74174,74174,19,13,0,2410,288,2698
"1024",20200510,"ID",2230,29912,NA,NA,207,NA,87,NA,NA,1473,"B","5/9/2020 19:00","db58dfc95e993ed07a381d837e9ea4db4f3374a7","2020-05-10T20:00:00Z",67,207,32142,32142,32142,16,0,1,311,25,336
"1025",20200510,"IL",77741,352243,NA,4293,NA,1232,NA,709,NA,NA,"A","5/10/2020 00:00","4ad02b7be8aa92e1bb30db588bbfa73e13e1109e","2020-05-10T20:00:00Z",3406,NA,429984,429984,429984,17,57,0,11997,1656,13653
"1026",20200510,"IN",24126,115903,NA,1328,4389,462,990,205,NA,NA,"A+","5/9/2020 23:59","61f42e3076ad88cad0e3b26405c5f0d608837b14","2020-05-10T20:00:00Z",1508,4389,140029,140029,140029,18,18,0,3949,394,4343
"1027",20200510,"KS",6948,45557,NA,NA,657,NA,231,NA,101,371,"A","5/10/2020 10:00","ba178b544ad80845a654827695bf3827b00dcebe","2020-05-10T20:00:00Z",157,657,52505,52505,52505,20,0,22,2375,197,2572
"1028",20200510,"KY",6440,80483,NA,394,1757,226,758,NA,NA,2308,"A","5/9/2020 17:00","f83a17b5bd4ea2dc5974c49812e17a75bb6559be","2020-05-10T20:00:00Z",304,1757,86923,86923,86923,21,6,61,324,152,476
"1029",20200510,"LA",31600,184272,NA,1324,NA,NA,NA,161,NA,20316,"B","5/10/2020 13:00","a7949c9c91fd8ecf8e3c4d85cc8308867da5c044","2020-05-10T20:00:00Z",2286,NA,215872,215872,215872,22,19,0,3532,183,3715
"1030",20200510,"MA",77793,310596,NA,3128,7617,810,NA,NA,NA,NA,"A","5/10/2020 10:00","9576e492f559b32690054f3fa3411e2be1cca071","2020-05-10T20:00:00Z",4979,7617,388389,388389,388389,25,139,66,10802,1050,11852
"1031",20200510,"MD",32587,127344,NA,1640,5955,611,NA,NA,NA,2293,"A","5/10/2020 10:00","4ded8c406238fe33eea4eb7bc0cd41e5ae52cea6","2020-05-10T20:00:00Z",1644,5955,159931,159931,159931,24,30,23,2850,1053,3903
"1032",20200510,"ME",1436,22092,NA,36,199,17,NA,10,NA,861,"B","5/10/2020 11:30","8461ff8b72c814e211682b26c9e699e173e3ca65","2020-05-10T20:00:00Z",64,199,23528,23528,23528,23,0,1,0,28,28
"1033",20200510,"MI",47138,238540,NA,1437,NA,674,NA,536,NA,22686,"A+","5/10/2020 11:00","71718f2c1a21e702418aca594f0d9f731b4d6626","2020-05-10T20:00:00Z",4551,NA,285678,285678,285678,26,25,0,11810,382,12192
"1034",20200510,"MN",11271,99817,NA,434,1657,199,581,NA,NA,6304,"A","5/9/2020 17:00","70cfe68a1823a8bff7ff71f1f3126bffd00a226f","2020-05-10T20:00:00Z",578,1657,111088,111088,111088,27,20,45,4344,481,4825
"1035",20200510,"MO",9844,105702,NA,824,NA,NA,NA,137,NA,NA,"B","5/10/2020 15:00","4d092ef5d6d737c9e01a97f8ca03f88f8e1b773c","2020-05-10T20:00:00Z",482,NA,115546,115546,115546,29,10,0,6470,178,6648
"1036",20200510,"MP",16,2321,NA,NA,NA,NA,NA,NA,NA,12,"D","5/9/2020 00:00","4e2f076c96c9aa0af76db8d66919c94b87714bce","2020-05-10T20:00:00Z",2,NA,2337,2337,2337,69,0,0,0,0,0
"1037",20200510,"MS",9501,72101,NA,645,1531,141,NA,78,NA,4421,"A","5/9/2020 19:00","ca5e3d96f8f1031bf700e1bd9f00e60ea02bb544","2020-05-10T20:00:00Z",430,1531,81602,81602,81602,28,9,19,0,123,123
"1038",20200510,"MT",458,21246,NA,4,62,NA,NA,NA,NA,422,"C","5/9/2020 00:00","9382d786231437ead678156c85e50de4579d627b","2020-05-10T20:00:00Z",16,62,21704,21704,21704,30,0,0,375,0,375
"1039",20200510,"NC",14764,177371,NA,442,NA,NA,NA,NA,NA,NA,"B","5/10/2020 11:00","237b748945e3f2d99668906b48183b665328d5ff","2020-05-10T20:00:00Z",547,NA,192135,192135,192135,37,3,0,5369,404,5773
"1040",20200510,"ND",1491,43378,NA,29,110,NA,NA,NA,NA,792,"C","5/10/2020 12:10","28e21e109ad3b087f521e481bb62497823ce324d","2020-05-10T20:00:00Z",35,110,44869,44869,44869,38,0,0,909,27,936
"1041",20200510,"NE",8234,37335,NA,NA,NA,NA,NA,NA,NA,NA,"D","5/9/2020 19:45","5879712120a4aa09dd5b869db7972f4819c0e903","2020-05-10T20:00:00Z",96,NA,45569,45569,45569,31,4,0,2190,403,2593
"1042",20200510,"NH",3011,30442,512,107,313,NA,97,NA,NA,1228,"B","5/9/2020 09:00","56fc03e3d6f03856478b30432c283600dd86ef42","2020-05-10T20:00:00Z",131,313,33965,33453,33453,33,10,4,1091,64,1155
"1043",20200510,"NJ",138532,173915,591,4308,NA,1338,NA,994,NA,15642,"A+","5/10/2020 13:00","2d4fa753c18d1324c8040c9faab55ee1d031a979","2020-05-10T20:00:00Z",9255,NA,313038,312447,312447,34,139,0,5794,1447,7241
"1044",20200510,"NM",4778,92275,NA,198,789,NA,NA,NA,NA,1268,"C","5/9/2020 16:00","d6fcc501da594c6545a5f1b6d0f190e25277e46c","2020-05-10T20:00:00Z",191,789,97053,97053,97053,35,10,0,3686,105,3791
"1045",20200510,"NV",6098,52711,NA,444,NA,116,NA,65,NA,182,"C","5/10/2020 12:30","283add2eae1ec5c03a43329f2900d0e7edb8d4f7","2020-05-10T20:00:00Z",306,NA,58809,58809,58809,32,5,0,2628,70,2698
"1046",20200510,"NY",335395,847603,NA,7262,72715,2488,NA,2073,NA,58006,"A","5/10/2020 00:00","7456280faad8dfbb520eaf338c44a80263063dcd","2020-05-10T20:00:00Z",21478,72715,1182998,1182998,1182998,36,207,460,26957,2273,29230
"1047",20200510,"OH",24081,180781,NA,962,4351,381,1205,254,NA,NA,"B","5/10/2020 14:00","53626757c056b8c0a737516abee4fd9c33ce3d32","2020-05-10T20:00:00Z",1341,4351,204862,204862,204862,39,10,51,7808,384,8192
"1048",20200510,"OK",4589,91379,NA,177,826,93,NA,NA,NA,3204,"A+","5/10/2020 00:00","44d6bc9800e190bd47648507e02461200a188e60","2020-05-10T20:00:00Z",272,826,95968,95968,95968,40,2,4,0,99,99
"1049",20200510,"OR",3228,72279,NA,164,670,45,NA,22,NA,1125,"A+","5/10/2020 11:00","26f6a9643e0572d8af19774478830f279bdcaa44","2020-05-10T20:00:00Z",127,670,75507,75507,75507,41,0,8,819,68,887
"1050",20200510,"PA",56611,227772,NA,2230,NA,NA,NA,501,NA,NA,"C","5/10/2020 00:00","3da8706011af30cabe61231cac1023af05c187a5","2020-05-10T20:00:00Z",3707,NA,284383,284383,284383,42,19,0,5981,1295,7276
"1051",20200510,"PR",2198,NA,NA,NA,NA,NA,NA,NA,NA,NA,"D","5/10/2020 05:51","d2d87be134563714f69cf1017860a295ce53e98d","2020-05-10T20:00:00Z",111,NA,2198,2198,2198,72,3,0,0,25,25
"1052",20200510,"RI",11274,79939,NA,283,1251,70,NA,52,NA,809,"A+","5/10/2020 12:00","7a6c8a40426db438e86b3a6399dfee8addbf6c3a","2020-05-10T20:00:00Z",422,1251,91213,91213,91213,44,4,33,3113,285,3398
"1053",20200510,"SC",7653,76804,NA,NA,1252,NA,NA,NA,NA,4120,"B","5/10/2020 16:30","5efcda5d5a6a295360901ab712a6805e5899de78","2020-05-10T20:00:00Z",331,1252,84457,84457,84457,45,1,0,3372,122,3494
"1054",20200510,"SD",3517,20377,NA,77,261,NA,NA,NA,NA,2147,"C","5/9/2020 18:00","c4ff3ff4de4c2d2139e2a175fadb5397ce5c381b","2020-05-10T20:00:00Z",34,261,23894,23894,23894,46,0,8,818,124,942
"1055",20200510,"TN",14985,246884,NA,NA,1325,NA,NA,NA,NA,7528,"B","5/10/2020 00:00","dd509ef43a7c74f44ff5fccec68d55f63b83b373","2020-05-10T20:00:00Z",243,1325,261869,261869,261869,47,1,6,8904,217,9121
"1056",20200510,"TX",38869,462907,NA,1626,NA,NA,NA,NA,NA,21022,"B","5/10/2020 16:35","60657a7921f91150194620b537c6c67f05172295","2020-05-10T20:00:00Z",1088,NA,501776,501776,501776,48,39,0,11473,1009,12482
"1057",20200510,"UT",6251,140259,NA,144,512,NA,168,NA,76,3033,"B","5/10/2020 10:31","95436551c2b902b219be9d3207ee419385b7bac2","2020-05-10T20:00:00Z",67,512,146510,146510,146510,49,1,14,3068,148,3216
"1058",20200510,"VA",24081,118974,506,1555,4756,351,NA,187,NA,3201,"A+","5/9/2020 17:00","0bd6d170c496208151324155be57b6cbe4f43870","2020-05-10T20:00:00Z",839,4756,143561,143055,143055,51,12,39,5021,885,5906
"1059",20200510,"VI",69,1102,39,NA,NA,NA,NA,NA,NA,59,"C","5/9/2020 19:06","ee099923bf00dc5235a450b2ba8d2ea3e5864949","2020-05-10T20:00:00Z",4,NA,1210,1171,1171,78,0,0,78,1,79
"1060",20200510,"VT",926,18167,NA,21,NA,NA,NA,NA,NA,777,"B","5/10/2020 00:00","4e0674164b4edb99097ae94ea820fcc1dbcf400a","2020-05-10T20:00:00Z",53,NA,19093,19093,19093,50,0,0,477,0,477
"1061",20200510,"WA",17445,242339,NA,335,NA,101,NA,NA,NA,NA,"B","5/10/2020 00:00","5fd0dc7c8ed51193d01de6d0eb6c0d78e72eb6e3","2020-05-10T20:00:00Z",921,NA,259784,259784,259784,53,16,0,1225,51,1276
"1062",20200510,"WI",10219,105163,182,514,1820,113,456,NA,NA,5014,"A+","5/10/2020 00:00","4a844e20f456da87827d9c03465f522d77c48ca1","2020-05-10T20:00:00Z",400,1820,115564,115382,115382,55,2,14,3228,280,3508
"1063",20200510,"WV",1360,61284,NA,49,NA,10,NA,6,NA,775,"C","5/10/2020 10:00","3c1d39dabb627af244c343c9c787dde00286d7e2","2020-05-10T20:00:00Z",54,NA,62644,62644,62644,54,1,0,1622,25,1647
"1064",20200510,"WY",661,11403,NA,12,65,NA,NA,NA,NA,443,"C","5/10/2020 16:00","d6d9ace070069ce541b1dcdbcef3313083a54cfd","2020-05-10T20:00:00Z",7,65,12064,12064,12064,56,0,1,0,17,17
"1065",20200509,"AK",378,26071,NA,8,NA,NA,NA,NA,NA,318,"C","5/9/2020 00:00","81730ed56f3a546adb227bf046219933797f9cbb","2020-05-09T20:00:00Z",10,NA,26449,26449,26449,2,0,0,975,1,976
"1066",20200509,"AL",9567,115927,NA,NA,1228,NA,459,NA,272,NA,"B","5/9/2020 00:00","7c1a5067467c6ce495a787917ddccae550e81335","2020-05-09T20:00:00Z",388,1228,125494,125494,125494,1,13,21,5034,346,5380
"1067",20200509,"AR",3747,61781,NA,64,471,NA,NA,14,96,2968,"B","5/9/2020 10:15","64db20aa3b59b76ce6735254a2bb4e60fe5ecede","2020-05-09T20:00:00Z",88,471,65528,65528,65528,5,0,5,1481,53,1534
"1068",20200509,"AS",0,83,NA,NA,NA,NA,NA,NA,NA,NA,"D","5/3/2020 00:00","b6693293693460b7260be24906ab0d08dd930dfc","2020-05-09T20:00:00Z",0,NA,83,83,83,60,0,0,0,0,0
"1069",20200509,"AZ",10960,94850,NA,739,1514,296,NA,186,NA,2684,"A+","5/9/2020 00:00","0c51b40014e66205aabbe047828c065095d91e60","2020-05-09T20:00:00Z",532,1514,105810,105810,105810,4,15,32,4251,434,4685
"1070",20200509,"CA",64561,848009,NA,4538,NA,1349,NA,NA,NA,NA,"B","5/9/2020 14:00","47564b4be2325468b20b81c3212689a291e88901","2020-05-09T20:00:00Z",2678,NA,912570,912570,912570,6,93,0,35249,2049,37298
"1071",20200509,"CO",18827,77945,NA,790,3600,NA,NA,NA,NA,2974,"B","5/7/2020 00:00","d2f613acd2237a7c8cacaa9956f4b78a04521607","2020-05-09T20:00:00Z",960,3600,96772,96772,96772,8,-1,43,2210,26,2236
"1072",20200509,"CT",32984,90585,NA,1301,9389,NA,NA,NA,NA,5413,"B","5/9/2020 14:00","01199bbcde2fe21240fdfa5e5b06eec4fc2bf14f","2020-05-09T20:00:00Z",2932,9389,123569,123569,123569,9,58,0,2455,573,3028
"1073",20200509,"DC",6102,22081,NA,447,NA,130,NA,91,NA,879,"A+","5/8/2020 00:00","fecd17d92c59c096e523aeea3a74b9985c7047e3","2020-05-09T20:00:00Z",311,NA,28183,28183,28183,11,7,0,865,203,1068
"1074",20200509,"DE",6277,23019,NA,288,NA,NA,NA,NA,NA,2450,"B","5/8/2020 18:00","f67f2ebe03cc2106cd34e5453ec631c29ee3b6c9","2020-05-09T20:00:00Z",221,NA,29296,29296,29296,10,8,0,866,166,1032
"1075",20200509,"FL",40001,487730,1452,NA,7325,NA,NA,NA,NA,NA,"B","5/9/2020 10:39","ef9da64b5362fec901ba880a258aec4b898108c2","2020-05-09T20:00:00Z",1785,7325,529183,527731,527731,12,47,168,13588,802,14390
"1076",20200509,"GA",32532,202792,NA,NA,5987,NA,1409,NA,NA,NA,"A","5/9/2020 15:25","204dadb2e92812c6e2aace60e479344fbc1556cd","2020-05-09T20:00:00Z",1400,5987,235324,235324,235324,13,23,52,7331,426,7757
"1077",20200509,"GU",151,3643,NA,NA,NA,NA,NA,NA,NA,124,"C","5/9/2020 00:00","a0787c893f96bca36cbc46881ad4849e8ccb4049","2020-05-09T20:00:00Z",5,NA,3794,3794,3794,66,0,0,17,0,17
"1078",20200509,"HI",629,35633,NA,NA,81,NA,NA,NA,NA,566,"C","5/8/2020 00:00","0ea646ce253eb164e57bf38ba662e6cdbb4056ea","2020-05-09T20:00:00Z",17,81,36262,36262,36262,15,0,7,-356,0,-356
"1079",20200509,"IA",11671,59805,NA,402,NA,161,NA,106,NA,5011,"A+","5/8/2020 00:00","625c8062844ccd2edf3357e1cefe04e0b53caf99","2020-05-09T20:00:00Z",252,NA,71476,71476,71476,19,9,0,1001,214,1215
"1080",20200509,"ID",2205,29601,NA,NA,206,NA,86,NA,NA,1442,"B","5/8/2020 19:00","d6939e30457235c428c0003fe3211364639e9007","2020-05-09T20:00:00Z",67,206,31806,31806,31806,16,0,0,509,27,536
"1081",20200509,"IL",76085,340246,NA,4739,NA,1215,NA,739,NA,NA,"A","5/9/2020 00:00","07903096ff837ca8e1b850ca57263f091836fab3","2020-05-09T20:00:00Z",3349,NA,416331,416331,416331,17,108,0,14292,2325,16617
"1082",20200509,"IN",23732,111954,NA,1361,4389,458,990,213,NA,NA,"A+","5/8/2020 23:59","9ecb3e3d8b25dcc8428abaf3b34416ded6a7cc1f","2020-05-09T20:00:00Z",1490,4389,135686,135686,135686,18,43,0,4972,586,5558
"1083",20200509,"KS",6751,43182,NA,NA,635,NA,229,NA,100,350,"A","5/9/2020 10:00","15691c476af3b027542f0107c43630ec4bb97749","2020-05-09T20:00:00Z",157,635,49933,49933,49933,20,5,27,1975,250,2225
"1084",20200509,"KY",6288,80159,NA,369,1696,210,723,NA,NA,2266,"A","5/8/2020 17:00","0910882e8d226007c371901b42299d6684d61741","2020-05-09T20:00:00Z",298,1696,86447,86447,86447,21,4,12,4887,159,5046
"1085",20200509,"LA",31417,180740,NA,1333,NA,NA,NA,165,NA,20316,"B","5/9/2020 13:00","1de5ed273e90a6e5fdbbb696fcb928a2ab4606b3","2020-05-09T20:00:00Z",2267,NA,212157,212157,212157,22,40,0,9179,562,9741
"1086",20200509,"MA",76743,299794,NA,3229,7551,814,NA,NA,NA,NA,"A","5/9/2020 12:00","a15a99f24710a2be0d1eeaaf078b522c1294f8bf","2020-05-09T20:00:00Z",4840,7551,376537,376537,376537,25,138,117,9104,1410,10514
"1087",20200509,"MD",31534,124494,NA,1665,5932,575,NA,NA,NA,2159,"A","5/9/2020 10:00","561560d62bd8198925150769ddce3ce15f238a6c","2020-05-09T20:00:00Z",1614,5932,156028,156028,156028,24,54,121,2792,1049,3841
"1088",20200509,"ME",1408,22092,NA,43,198,22,NA,10,NA,857,"B","5/9/2020 12:00","83cc15a0c0ad23dbf8634ca0c93a986d99a22d93","2020-05-09T20:00:00Z",64,198,23500,23500,23500,23,1,4,0,34,34
"1089",20200509,"MI",46756,226730,NA,1531,NA,683,NA,539,NA,22686,"A+","5/9/2020 11:00","2983b0ff047740cd05d6590a66d492e30a5873b7","2020-05-09T20:00:00Z",4526,NA,273486,273486,273486,26,133,0,12803,430,13233
"1090",20200509,"MN",10790,95473,NA,476,1612,180,556,NA,NA,5764,"A","5/8/2020 17:00","baea496224e24c911262aa754d4cbf231a04eb10","2020-05-09T20:00:00Z",558,1612,106263,106263,106263,27,24,63,4291,702,4993
"1091",20200509,"MO",9666,99232,NA,855,NA,NA,NA,144,NA,NA,"B","5/9/2020 15:00","c9372e6290aa65a2399a140ab0012a42780210b6","2020-05-09T20:00:00Z",472,NA,108898,108898,108898,29,23,0,0,177,177
"1092",20200509,"MP",16,2321,NA,NA,NA,NA,NA,NA,NA,12,"D","5/9/2020 00:00","25968ca5353100812e3d2bd7af971757c31661bb","2020-05-09T20:00:00Z",2,NA,2337,2337,2337,69,0,0,0,1,1
"1093",20200509,"MS",9378,72101,NA,607,1512,133,NA,76,NA,4421,"A","5/8/2020 19:00","e0169a98c606eae96e19a7fc08e46e53e93979f9","2020-05-09T20:00:00Z",421,1512,81479,81479,81479,28,12,34,0,288,288
"1094",20200509,"MT",458,20871,NA,4,62,NA,NA,NA,NA,422,"C","5/9/2020 00:00","ac92d036b372c0d34819356dcf2a6610651bb95a","2020-05-09T20:00:00Z",16,62,21329,21329,21329,30,0,0,384,0,384
"1095",20200509,"NC",14360,172002,NA,513,NA,NA,NA,NA,NA,NA,"B","5/9/2020 10:45","dddfb01ff698f851a6f67e7ac06637a366484c2f","2020-05-09T20:00:00Z",544,NA,186362,186362,186362,37,17,0,7257,492,7749
"1096",20200509,"ND",1464,42469,NA,34,110,NA,NA,NA,NA,762,"C","5/9/2020 13:00","6de891a9f16398f6255ae3c05cb8ae53df709a0b","2020-05-09T20:00:00Z",35,110,43933,43933,43933,38,2,6,1393,39,1432
"1097",20200509,"NE",7831,35145,NA,NA,NA,NA,NA,NA,NA,NA,"D","5/8/2020 18:45","07a1d730030d712883b30e99ed55a06c6d91ce47","2020-05-09T20:00:00Z",92,NA,42976,42976,42976,31,2,0,1923,641,2564
"1098",20200509,"NH",2947,29351,304,112,309,NA,97,NA,NA,1210,"B","5/8/2020 09:00","44f3944af5938a1be615529d518dd51aa9c995eb","2020-05-09T20:00:00Z",121,309,32602,32298,32298,33,7,1,1522,104,1626
"1099",20200509,"NJ",137085,168121,557,4628,NA,1416,NA,1054,NA,15642,"A+","5/9/2020 13:00","ca160df21f97ad632bd433115355785cca9cf372","2020-05-09T20:00:00Z",9116,NA,305763,305206,305206,34,164,0,4816,1631,6447
"1100",20200509,"NM",4673,88589,NA,201,789,NA,NA,NA,NA,1189,"C","5/8/2020 06:05","ece8c1d80b607c2d7767da45b5fb04037e4beace","2020-05-09T20:00:00Z",181,789,93262,93262,93262,35,9,29,4050,180,4230
"1101",20200509,"NV",6028,50083,NA,NA,NA,NA,NA,NA,NA,205,"D","5/9/2020 12:00","faaceef0577a059ce191b287172431d11dcea067","2020-05-09T20:00:00Z",301,NA,56111,56111,56111,32,8,0,2623,144,2767
"1102",20200509,"NY",333122,820646,NA,7776,72255,2664,NA,2203,NA,57180,"B","5/9/2020 00:00","052e6f0369c8bf1cdcb0e87919a4c28dd1bcbc19","2020-05-09T20:00:00Z",21271,72255,1153768,1153768,1153768,36,226,576,29510,2715,32225
"1103",20200509,"OH",23697,172973,NA,929,4300,368,1200,222,NA,NA,"B","5/9/2020 14:00","d45e2038c5005e0a1c85edbd3ae52e34cd77e808","2020-05-09T20:00:00Z",1331,4300,196670,196670,196670,39,25,82,11673,681,12354
"1104",20200509,"OK",4490,91379,NA,177,822,93,NA,NA,NA,3154,"A+","5/9/2020 00:00","72f433d39ab5748a4be4e7031f6dc27886f8bddf","2020-05-09T20:00:00Z",270,822,95869,95869,95869,40,4,17,5946,66,6012
"1105",20200509,"OR",3160,71460,NA,139,662,34,NA,19,NA,1125,"A+","5/9/2020 11:00","0862e8c7f1b97b9126f6cff69e7b4d8806ecc27d","2020-05-09T20:00:00Z",127,662,74620,74620,74620,41,3,3,1835,92,1927
"1106",20200509,"PA",55316,221791,NA,2285,NA,NA,NA,502,NA,NA,"C","5/9/2020 00:00","5f8ccdfa24c0fec523066148e8777ce265a818e0","2020-05-09T20:00:00Z",3688,NA,277107,277107,277107,42,72,0,5470,1078,6548
"1107",20200509,"PR",2173,NA,NA,161,NA,NA,NA,7,NA,NA,"C","5/9/2020 05:51","8c628cfba2bc5516700770e7a54cd31a6b905edc","2020-05-09T20:00:00Z",108,NA,2173,2173,2173,72,1,0,0,17,17
"1108",20200509,"RI",10989,76826,NA,292,1218,77,NA,56,NA,772,"A+","5/9/2020 12:00","3e24dfd5465d624d4dd95ef8ee68dcfc32db0d62","2020-05-09T20:00:00Z",418,1218,87815,87815,87815,44,19,31,2339,210,2549
"1109",20200509,"SC",7531,73432,NA,NA,1252,NA,NA,NA,NA,4120,"B","5/8/2020 16:30","4c1038923332fd0d07cdff110cb98fadc437f92e","2020-05-09T20:00:00Z",330,1252,80963,80963,80963,45,14,100,7132,389,7521
"1110",20200509,"SD",3393,19559,NA,79,253,NA,NA,NA,NA,2125,"C","5/8/2020 18:00","871e9b0c0a9ffa1699633bb87575756e29d751c3","2020-05-09T20:00:00Z",34,253,22952,22952,22952,46,3,6,1410,249,1659
"1111",20200509,"TN",14768,237980,NA,NA,1319,NA,NA,NA,NA,7369,"B","5/9/2020 00:00","02c32bc4a0a92449b19802a67089073494fa5ba3","2020-05-09T20:00:00Z",242,1319,252748,252748,252748,47,1,20,8843,327,9170
"1112",20200509,"TX",37860,451434,NA,1735,NA,NA,NA,NA,NA,20141,"B","5/9/2020 13:15","deeecea989a19b1e2c2f50a4fa57cec56a0ec1c2","2020-05-09T20:00:00Z",1049,NA,489294,489294,489294,48,45,0,10925,1251,12176
"1113",20200509,"UT",6103,137191,NA,172,498,NA,166,NA,75,2901,"B","5/9/2020 10:32","3c83518dba343f7639c59cd83af6d40488fbd5df","2020-05-09T20:00:00Z",66,498,143294,143294,143294,49,5,10,4422,184,4606
"1114",20200509,"VA",23196,113953,501,1593,4717,367,NA,198,NA,3124,"A+","5/8/2020 17:00","47072fc63ce2e0f9691de637b93f63fc84351e81","2020-05-09T20:00:00Z",827,4717,137650,137149,137149,51,15,95,6350,854,7204
"1115",20200509,"VI",68,1024,36,NA,NA,NA,NA,NA,NA,57,"C","5/7/2020 23:58","1030504cc80d670690cf8cb1479cf04330077f32","2020-05-09T20:00:00Z",4,NA,1128,1092,1092,78,0,0,0,0,0
"1116",20200509,"VT",926,17690,NA,21,NA,NA,NA,NA,NA,744,"B","5/9/2020 00:00","0af3c5b90857b3b38094b40d5b46cc5770e792f9","2020-05-09T20:00:00Z",53,NA,18616,18616,18616,50,0,0,468,8,476
"1117",20200509,"WA",17394,241114,NA,393,NA,128,NA,NA,NA,NA,"B","5/9/2020 00:00","63eab5af90f2b748927a8925b0537eac9818add7","2020-05-09T20:00:00Z",905,NA,258508,258508,258508,53,14,0,2136,121,2257
"1118",20200509,"WI",9939,101935,204,543,1806,110,452,NA,NA,4875,"A+","5/9/2020 00:00","4b4a259c3a82a196abfc535e790f27ddd657a413","2020-05-09T20:00:00Z",398,1806,112078,111874,111874,55,14,39,4670,349,5019
"1119",20200509,"WV",1335,59662,NA,53,NA,13,NA,7,NA,761,"C","5/9/2020 10:00","09642d84ae790c3f44a5895ee86022ec59029396","2020-05-09T20:00:00Z",53,NA,60997,60997,60997,54,2,0,1536,25,1561
"1120",20200509,"WY",644,11403,NA,12,64,NA,NA,NA,NA,438,"C","5/8/2020 13:58","32b9361f6678988d53fede85b97149c6bb7b42b6","2020-05-09T20:00:00Z",7,64,12047,12047,12047,56,0,4,0,9,9
"1121",20200508,"AK",377,25096,NA,16,NA,NA,NA,NA,NA,305,"C","5/8/2020 00:00","81130d86c029e28f831d55def58fcadc319009c7","2020-05-08T20:00:00Z",10,NA,25473,25473,25473,2,0,0,1129,3,1132
"1122",20200508,"AL",9221,110893,NA,NA,1207,NA,454,NA,266,NA,"B","5/8/2020 00:00","7aa497df30566f92a1e2edef1fc0ea0aa8bb2120","2020-05-08T20:00:00Z",375,1207,120114,120114,120114,1,26,29,4618,323,4941
"1123",20200508,"AR",3694,60300,NA,70,466,NA,NA,14,93,2159,"B","5/8/2020 08:15","a4ca6c4d1efac4b48f7e80e29bbc2be13f132133","2020-05-08T20:00:00Z",88,466,63994,63994,63994,5,1,4,3916,83,3999
"1124",20200508,"AS",0,83,NA,NA,NA,NA,NA,NA,NA,NA,"F","5/3/2020 00:00","aee242eef36c48dcf1bf337be214b3af34e8e755","2020-05-08T20:00:00Z",0,NA,83,83,83,60,0,0,0,0,0
"1125",20200508,"AZ",10526,90599,NA,730,1482,295,NA,197,NA,1747,"A+","5/8/2020 00:00","dd11a957bd4e0ac80faff29dc87e8cd6c07f254c","2020-05-08T20:00:00Z",517,1482,101125,101125,101125,4,67,33,4110,581,4691
"1126",20200508,"CA",62512,812760,NA,4514,NA,1342,NA,NA,NA,NA,"B","5/8/2020 14:00","d5ef05ed6769ba774cc29375bd1e4f0a66958120","2020-05-08T20:00:00Z",2585,NA,875272,875272,875272,6,81,0,30500,1898,32398
"1127",20200508,"CO",18801,75735,NA,821,3557,NA,NA,NA,NA,2869,"B","5/6/2020 00:00","d1531108149f241ae16a6ba1e928e6e29559c1fc","2020-05-08T20:00:00Z",961,3557,94536,94536,94536,8,40,571,2218,971,3189
"1128",20200508,"CT",32411,88130,NA,1327,9389,NA,NA,NA,NA,5413,"B","5/7/2020 20:30","f9d580ec47d3a4fe510f0433aba0d74adc57f755","2020-05-08T20:00:00Z",2874,9389,120541,120541,120541,9,77,0,3740,627,4367
"1129",20200508,"DC",5899,21216,NA,447,NA,130,NA,91,NA,825,"A+","5/7/2020 00:00","4059ea82f25e636e5e3f0e85f8a14089e334a132","2020-05-08T20:00:00Z",304,NA,27115,27115,27115,11,19,0,1014,245,1259
"1130",20200508,"DE",6111,22153,NA,289,NA,NA,NA,NA,NA,2288,"B","5/7/2020 18:00","05cce2b1146ef2508cd656e268c772e0c5f61627","2020-05-08T20:00:00Z",213,NA,28264,28264,28264,10,11,0,766,172,938
"1131",20200508,"FL",39199,474142,1433,NA,7157,NA,NA,NA,NA,NA,"C","5/8/2020 10:10","d523f47e828d33beb300781280737503c7ddcbb1","2020-05-08T20:00:00Z",1738,7157,514774,513341,513341,12,71,167,20020,371,20391
"1132",20200508,"GA",32106,195461,NA,NA,5935,NA,1399,NA,NA,NA,"A","5/8/2020 15:25","aa82111d80af104260d0401d74f9dce4247df15c","2020-05-08T20:00:00Z",1377,5935,227567,227567,227567,13,41,100,9597,667,10264
"1133",20200508,"GU",151,3626,NA,NA,NA,NA,NA,NA,NA,122,"D","5/8/2020 00:00","df2d72dc3b5ac3b441a640b4fe7575480bb5fa3f","2020-05-08T20:00:00Z",5,NA,3777,3777,3777,66,0,0,62,0,62
"1134",20200508,"HI",629,35989,NA,NA,74,NA,NA,NA,NA,565,"B","5/7/2020 00:00","07921d5536643c5746fa1468db358d4777572b79","2020-05-08T20:00:00Z",17,74,36618,36618,36618,15,0,0,1074,3,1077
"1135",20200508,"IA",11457,58804,NA,407,NA,164,NA,109,NA,4685,"A+","5/7/2020 00:00","2fe477a9e76f3a02dcd47b53b6d5f94d62c92c9a","2020-05-08T20:00:00Z",243,NA,70261,70261,70261,19,12,0,3436,398,3834
"1136",20200508,"ID",2178,29092,NA,NA,206,NA,86,NA,NA,1420,"B","5/7/2020 19:00","15167812dd966c2f2fb491c9211e5ababa67ed04","2020-05-08T20:00:00Z",67,206,31270,31270,31270,16,1,1,360,20,380
"1137",20200508,"IL",73760,325954,NA,4750,NA,1222,NA,727,NA,NA,"A","5/8/2020 00:00","78645d0b39c50f0808f893027de4117e81e09766","2020-05-08T20:00:00Z",3241,NA,399714,399714,399714,17,130,0,17784,2887,20671
"1138",20200508,"IN",23146,106982,NA,1379,4389,481,990,219,NA,NA,"A+","5/7/2020 23:59","480f314902b86ee3045123da9a2ff0e9dc6e796a","2020-05-08T20:00:00Z",1447,4389,130128,130128,130128,18,33,4389,4703,643,5346
"1139",20200508,"KS",6501,41207,NA,NA,608,NA,223,NA,99,332,"A","5/8/2020 10:00","7a6b3519fad992c15b77ac91c033c0752ca923f6","2020-05-08T20:00:00Z",152,608,47708,47708,47708,20,5,21,2529,357,2886
"1140",20200508,"KY",6129,75272,NA,356,1684,199,714,NA,NA,2177,"A","5/7/2020 17:00","ffe9736e32f92a5c53a18f0b0d6c1b5abb0778eb","2020-05-08T20:00:00Z",294,1684,81401,81401,81401,21,11,68,2600,195,2795
"1141",20200508,"LA",30855,171561,NA,1359,NA,NA,NA,185,NA,20316,"B","5/8/2020 13:00","798d2fa2bbbc9f6a6faa4f36f30a21ad47e7481a","2020-05-08T20:00:00Z",2227,NA,202416,202416,202416,22,19,0,1446,203,1649
"1142",20200508,"MA",75333,290690,NA,3349,7434,826,NA,NA,NA,NA,"A","5/8/2020 10:00","29288f59af3b7848a4383bf253e8f5f8c76e24c7","2020-05-08T20:00:00Z",4702,7434,366023,366023,366023,25,150,197,12779,1612,14391
"1143",20200508,"MD",30485,121702,NA,1674,5811,571,NA,NA,NA,2041,"A","5/8/2020 10:00","a40950a18445cbc462e6d21b498783fa36ae1bbd","2020-05-08T20:00:00Z",1560,5811,152187,152187,152187,24,57,148,2476,1111,3587
"1144",20200508,"ME",1374,22092,NA,44,194,23,NA,10,NA,836,"B","5/8/2020 12:00","d701dbb55751d5f7ab76b969a0937a06dfffa41e","2020-05-08T20:00:00Z",63,194,23466,23466,23466,23,1,2,0,44,44
"1145",20200508,"MI",46326,213927,NA,1637,NA,725,NA,570,NA,15659,"A+","5/8/2020 11:00","5656716f32beca12ba86a75347a1dfa804135f2b","2020-05-08T20:00:00Z",4393,NA,260253,260253,260253,26,50,0,12511,680,13191
"1146",20200508,"MN",10088,91182,NA,473,1549,198,540,NA,NA,5163,"A","5/7/2020 17:00","84d5bc4313c3341bed05796c58f0f5c8118999b4","2020-05-08T20:00:00Z",534,1549,101270,101270,101270,27,26,90,3126,723,3849
"1147",20200508,"MO",9489,99232,NA,832,NA,NA,NA,143,NA,NA,"B","5/8/2020 15:00","cb8a506b2bf8d309aea553ac9a5d36b2bbf75c37","2020-05-08T20:00:00Z",449,NA,108721,108721,108721,29,31,0,4951,148,5099
"1148",20200508,"MP",15,2321,NA,NA,NA,NA,NA,NA,NA,12,"D","5/8/2020 00:00","9b862d1a90dcf2b8daf2821e698b2f42772cf4aa","2020-05-08T20:00:00Z",2,NA,2336,2336,2336,69,0,0,538,0,538
"1149",20200508,"MS",9090,72101,NA,632,1478,123,NA,58,NA,4421,"A","5/7/2020 19:00","2a05739132b693efbe465d1f48b8f6948a37a25e","2020-05-08T20:00:00Z",409,1478,81191,81191,81191,28,13,36,0,404,404
"1150",20200508,"MT",458,20487,NA,6,62,NA,NA,NA,NA,420,"C","5/8/2020 00:00","f9b1fb8909ff1e1e651d265138da62419eab8ba0","2020-05-08T20:00:00Z",16,62,20945,20945,20945,30,0,0,696,2,698
"1151",20200508,"NC",13868,164745,NA,515,NA,NA,NA,NA,NA,NA,"B","5/8/2020 11:00","2c94b28d0a88a51d057b9357ce342276e9a20f08","2020-05-08T20:00:00Z",527,NA,178613,178613,178613,37,20,0,6814,471,7285
"1152",20200508,"ND",1425,41076,NA,33,104,NA,NA,NA,NA,714,"C","5/8/2020 13:00","c2f0bdf76280ec4d5932cf4ceb476c215b3c6be2","2020-05-08T20:00:00Z",33,104,42501,42501,42501,38,2,2,1580,54,1634
"1153",20200508,"NE",7190,33222,NA,NA,NA,NA,NA,NA,NA,NA,"D","5/7/2020 17:45","48a33e436baca69ed6b034feec23e236d8251ba1","2020-05-08T20:00:00Z",90,NA,40412,40412,40412,31,4,0,2235,419,2654
"1154",20200508,"NH",2843,27829,532,113,308,NA,97,NA,NA,1165,"B","5/7/2020 09:00","50ddf2398c6a93ee074dabace2cda40f6c82f5fa","2020-05-08T20:00:00Z",114,308,31204,30672,30672,33,3,1,1763,103,1866
"1155",20200508,"NJ",135454,163305,553,4605,NA,1439,NA,1089,NA,15642,"A+","5/8/2020 13:00","c674982e32236def6d6881374f8fd46abda975f5","2020-05-08T20:00:00Z",8952,NA,299312,298759,298759,34,151,0,4282,1819,6101
"1156",20200508,"NM",4493,84539,NA,197,760,NA,NA,NA,NA,1125,"C","5/7/2020 06:09","36e32e27cf2044cca8f5e61e6ee44eede81f7fbe","2020-05-08T20:00:00Z",172,760,89032,89032,89032,35,3,73,3146,202,3348
"1157",20200508,"NV",5884,47460,NA,NA,NA,NA,NA,NA,NA,205,"D","5/8/2020 12:50","fddebc83d3f09145e6d2b0fd2738051b005e0d89","2020-05-08T20:00:00Z",293,NA,53344,53344,53344,32,7,0,1869,118,1987
"1158",20200508,"NY",330407,791136,NA,8196,71679,2811,NA,2295,NA,56378,"B","5/8/2020 00:00","cce93730cb4bfe975fc7b77442c3b664e71c74ee","2020-05-08T20:00:00Z",21045,71679,1121543,1121543,1121543,36,217,527,28869,2758,31627
"1159",20200508,"OH",23016,161300,NA,1060,4218,393,1188,274,NA,NA,"B","5/8/2020 14:00","c91975a5e248e1698b76b269fe427ab2548e9183","2020-05-08T20:00:00Z",1306,4218,184316,184316,184316,39,35,78,7372,885,8257
"1160",20200508,"OK",4424,85433,NA,228,805,96,NA,NA,NA,3064,"A+","5/8/2020 00:00","dc4244c9c33a01e9877f2d6b8f68a63a15715ca8","2020-05-08T20:00:00Z",266,805,89857,89857,89857,40,6,0,2876,94,2970
"1161",20200508,"OR",3068,69625,NA,159,659,42,NA,18,NA,1125,"A+","5/8/2020 11:00","0550e88698767291e1f876d477ab0e641e981c56","2020-05-08T20:00:00Z",124,659,72693,72693,72693,41,3,14,2156,79,2235
"1162",20200508,"PA",54238,216321,NA,2342,NA,NA,NA,517,NA,NA,"C","5/8/2020 00:00","4eec00d4452c1371765038df18cbd7b5cca69ba9","2020-05-08T20:00:00Z",3616,NA,270559,270559,270559,42,200,0,6448,1323,7771
"1163",20200508,"PR",2156,NA,NA,161,NA,NA,NA,10,NA,NA,"C","5/8/2020 06:00","cc40033a03f02f0b1744d51206e3318f51aefca2","2020-05-08T20:00:00Z",107,NA,2156,2156,2156,72,5,0,0,125,125
"1164",20200508,"RI",10779,74487,NA,312,1187,71,NA,52,NA,730,"A+","5/8/2020 12:00","3065c7d768798e66b0a05bb90f027c7f9e4cdc30","2020-05-08T20:00:00Z",399,1187,85266,85266,85266,44,11,34,2699,249,2948
"1165",20200508,"SC",7142,66300,NA,NA,1152,NA,NA,NA,NA,3816,"B","5/7/2020 16:13","7c15b816d23596c0823ceb01d4f650cc109f26b4","2020-05-08T20:00:00Z",316,1152,73442,73442,73442,45,11,0,-4246,206,-4040
"1166",20200508,"SD",3144,18149,NA,76,247,NA,NA,NA,NA,2069,"C","5/7/2020 18:00","6c5861ab763af95806d0b7bdc812ac1e9900c0d7","2020-05-08T20:00:00Z",31,247,21293,21293,21293,46,0,11,940,239,1179
"1167",20200508,"TN",14441,229137,NA,NA,1299,NA,NA,NA,NA,7011,"B","5/8/2020 00:00","2f7623d291130bf9523e8d7a15c854494e9002b2","2020-05-08T20:00:00Z",241,1299,243578,243578,243578,47,4,33,6905,345,7250
"1168",20200508,"TX",36609,440509,NA,1734,NA,NA,NA,NA,NA,19197,"B","5/8/2020 13:00","b7f8c531addc2df51f14fa89b29a6821d47aad45","2020-05-08T20:00:00Z",1004,NA,477118,477118,477118,48,31,0,20737,1219,21956
"1169",20200508,"UT",5919,132769,NA,216,488,NA,162,NA,73,2769,"B","5/8/2020 15:00","c4ea753cfa02e60f4960bb3f95b6219c42ce5fd2","2020-05-08T20:00:00Z",61,488,138688,138688,138688,49,0,12,3950,195,4145
"1170",20200508,"VA",22342,107603,549,1625,4622,378,NA,199,NA,2997,"A+","5/7/2020 17:00","d30c5922d79f512c500b8be346be1360f542a828","2020-05-08T20:00:00Z",812,4622,130494,129945,129945,51,43,184,6021,772,6793
"1171",20200508,"VI",68,1024,36,NA,NA,NA,NA,NA,NA,57,"C","5/7/2020 11:58","0e0865c8970acfe68154aa50628308f47c963a11","2020-05-08T20:00:00Z",4,NA,1128,1092,1092,78,0,0,34,2,36
"1172",20200508,"VT",918,17222,NA,15,NA,NA,NA,NA,NA,737,"B","5/8/2020 00:00","656b036bfa042976a213e20de52742fbccf09111","2020-05-08T20:00:00Z",53,NA,18140,18140,18140,50,0,0,532,2,534
"1173",20200508,"WA",17273,238978,NA,393,NA,122,NA,NA,NA,NA,"B","5/8/2020 00:00","508af61d8383fc88a3b5d52a5a7bec67b9ce4d97","2020-05-08T20:00:00Z",891,NA,256251,256251,256251,53,21,0,5769,245,6014
"1174",20200508,"WI",9590,97265,204,552,1767,110,441,NA,NA,4694,"A+","5/8/2020 00:00","cc597cd49b76d128f0ba5f3310d152ae7d1e0950","2020-05-08T20:00:00Z",384,1767,107059,106855,106855,55,10,35,4230,375,4605
"1175",20200508,"WV",1310,58126,NA,65,NA,19,NA,11,NA,761,"C","5/8/2020 10:00","673f9fc45a5a9baea96ab99b912d2b36ae5506db","2020-05-08T20:00:00Z",51,NA,59436,59436,59436,54,0,0,1892,23,1915
"1176",20200508,"WY",635,11403,NA,9,60,NA,NA,NA,NA,428,"C","5/7/2020 04:28","cf995ba192011d35d06b60e3ac7d111228c27b82","2020-05-08T20:00:00Z",7,60,12038,12038,12038,56,0,1,0,4,4
"1177",20200507,"AK",374,23967,NA,12,NA,NA,NA,NA,NA,291,"C","5/7/2020 00:00","449ecb13656500db3e19fb31dc5d0da6349b15f8","2020-05-07T20:00:00Z",10,NA,24341,24341,24341,2,0,0,684,2,686
"1178",20200507,"AL",8898,106275,NA,NA,1178,NA,448,NA,266,NA,"B","5/7/2020 00:00","16d0fc1c8d0756fc29a6ae42c8c46a5c457b6c35","2020-05-07T20:00:00Z",349,1178,115173,115173,115173,1,9,20,5340,317,5657
"1179",20200507,"AR",3611,56384,NA,69,462,NA,NA,14,93,2123,"B","5/7/2020 09:43","b3e21ebbb872bb53477dc05f144a563b65c54954","2020-05-07T20:00:00Z",87,462,59995,59995,59995,5,2,9,949,43,992
"1180",20200507,"AS",0,83,NA,NA,NA,NA,NA,NA,NA,NA,"F","5/3/2020 00:00","83b5c4028fb671362a616856cb1be2ce7436e639","2020-05-07T20:00:00Z",0,NA,83,83,83,60,0,0,0,0,0
"1181",20200507,"AZ",9945,86489,NA,766,1449,288,NA,196,NA,1722,"A+","5/7/2020 00:00","a6e10332a1d2f226a90bffe22d6997ece386f650","2020-05-07T20:00:00Z",450,1449,96434,96434,96434,4,24,19,4459,238,4697
"1182",20200507,"CA",60614,782260,NA,4560,NA,1374,NA,NA,NA,NA,"B","5/7/2020 14:00","b0530540a08b211f4f0c5342ff4c7562ff42c505","2020-05-07T20:00:00Z",2504,NA,842874,842874,842874,6,92,0,32039,1799,33838
"1183",20200507,"CO",17830,73517,NA,798,2986,NA,NA,NA,NA,2869,"B","5/5/2020 00:00","3e03c77d64cca86cc6bb96e5c0a21500ddb373cc","2020-05-07T20:00:00Z",921,2986,91347,91347,91347,8,18,67,4905,466,5371
"1184",20200507,"CT",31784,84390,NA,1385,9389,NA,NA,NA,NA,5413,"B","5/6/2020 20:30","ee451791fbc93bb64c87c4490666a15fb30d6f59","2020-05-07T20:00:00Z",2797,9389,116174,116174,116174,9,79,1631,3938,789,4727
"1185",20200507,"DC",5654,20202,NA,447,NA,130,NA,91,NA,825,"A+","5/6/2020 00:00","fc68efa48d5d84087e4928a346e54a3fe21092b9","2020-05-07T20:00:00Z",285,NA,25856,25856,25856,11,8,0,679,193,872
"1186",20200507,"DE",5939,21387,NA,285,NA,NA,NA,NA,NA,2110,"B","5/6/2020 18:00","a01cc85116382c71edfc34e0e627577cafb6243e","2020-05-07T20:00:00Z",202,NA,27326,27326,27326,10,9,0,697,161,858
"1187",20200507,"FL",38828,454122,1499,NA,6990,NA,NA,NA,NA,NA,"C","5/7/2020 14:40","82a555f5e7054b394251d1718a523e26517abba0","2020-05-07T20:00:00Z",1667,6990,494449,492950,492950,12,62,214,12073,826,12899
"1188",20200507,"GA",31439,185864,NA,NA,5835,NA,1374,NA,NA,NA,"A","5/7/2020 14:29","8b72275059d53f301e1eb6d6c03d263918eda04b","2020-05-07T20:00:00Z",1336,5835,217303,217303,217303,13,25,70,12423,743,13166
"1189",20200507,"GU",151,3564,NA,NA,NA,NA,NA,NA,NA,123,"F","5/7/2020 00:00","75ce2bd275cecde57c810125b5302bc204f594ed","2020-05-07T20:00:00Z",5,NA,3715,3715,3715,66,0,0,88,0,88
"1190",20200507,"HI",626,34915,NA,NA,74,NA,NA,NA,NA,558,"B","5/6/2020 18:00","335a5091ee1ed24720cfaebe4d43aa61c1cfd334","2020-05-07T20:00:00Z",17,74,35541,35541,35541,15,0,1,341,1,342
"1191",20200507,"IA",11059,55368,NA,417,NA,151,NA,107,NA,4266,"A+","5/6/2020 12:00","de46350e2dbfe249d2ceb6d29bbd543061a5edbb","2020-05-07T20:00:00Z",231,NA,66427,66427,66427,19,12,0,2601,655,3256
"1192",20200507,"ID",2158,28732,NA,NA,205,NA,86,NA,NA,1399,"B","5/6/2020 19:00","a0694da8c4d6988ee7dcb1ee51bb2ba32aafb115","2020-05-07T20:00:00Z",66,205,30890,30890,30890,16,1,2,314,31,345
"1193",20200507,"IL",70873,308170,NA,4862,NA,1253,NA,766,NA,NA,"A","5/7/2020 00:00","82ce7cd91fbf0e15d62a7314630c13ab479438b5","2020-05-07T20:00:00Z",3111,NA,379043,379043,379043,17,137,0,15142,2641,17783
"1194",20200507,"IN",22503,102279,NA,1457,NA,487,NA,228,NA,NA,"A+","5/6/2020 23:59","1fe31f4de1b9953584f2953cc3e389c7ea30357f","2020-05-07T20:00:00Z",1414,NA,124782,124782,124782,18,37,0,3653,633,4286
"1195",20200507,"KS",6144,38678,NA,NA,587,NA,218,NA,97,323,"A","5/7/2020 10:00","5a13df282cb178c70abf3907da4371681e953305","2020-05-07T20:00:00Z",147,587,44822,44822,44822,20,3,16,2298,410,2708
"1196",20200507,"KY",5934,72672,NA,351,1616,190,693,NA,NA,2125,"A","5/6/2020 17:00","c1007b50ec510ff1927027e94df83bfb58b439e7","2020-05-07T20:00:00Z",283,1616,78606,78606,78606,21,8,13,17480,112,17592
"1197",20200507,"LA",30652,170115,NA,1432,NA,NA,NA,189,NA,20316,"B","5/7/2020 13:00","4e34eecd9233497ec6fa6a74780769e3b6fb89d0","2020-05-07T20:00:00Z",2208,NA,200767,200767,200767,22,93,0,5842,253,6095
"1198",20200507,"MA",73721,277911,NA,3436,7237,852,NA,NA,NA,NA,"A","5/7/2020 12:00","4a4162d0489acdb1a31af6ff3affba97e0177f77","2020-05-07T20:00:00Z",4552,7237,351632,351632,351632,25,132,157,10297,1696,11993
"1199",20200507,"MD",29374,119226,NA,1683,5663,584,NA,NA,NA,2029,"A","5/7/2020 10:00","de1008533f73b0a33b71be20ad889273392a7734","2020-05-07T20:00:00Z",1503,5663,148600,148600,148600,24,66,166,3377,1211,4588
"1200",20200507,"ME",1330,22092,NA,39,192,16,NA,11,NA,787,"B","5/7/2020 11:45","819d62c177516d7fe51974426a6fd6efce816172","2020-05-07T20:00:00Z",62,192,23422,23422,23422,23,0,1,0,76,76
"1201",20200507,"MI",45646,201416,NA,1697,NA,753,NA,612,NA,15659,"A+","5/7/2020 11:00","aa0d78a7edb6a243a5ae934d898e4283692bb73c","2020-05-07T20:00:00Z",4343,NA,247062,247062,247062,26,93,0,13239,592,13831
"1202",20200507,"MN",9365,88056,NA,435,1459,182,512,NA,NA,4800,"A","5/6/2020 17:00","1af49c226145e62235319ec849c0957642ea4588","2020-05-07T20:00:00Z",508,1459,97421,97421,97421,27,23,54,3403,786,4189
"1203",20200507,"MO",9341,94281,NA,917,NA,NA,NA,141,NA,NA,"B","5/7/2020 15:00","003c3cd7ee7fee4e0d716617af71259804d51b74","2020-05-07T20:00:00Z",418,NA,103622,103622,103622,29,22,0,2636,239,2875
"1204",20200507,"MP",15,1783,NA,NA,NA,NA,NA,NA,NA,12,"D","5/6/2020 00:00","1c0a293a28ccb3c8bc4b1aa682d2da319e5c9216","2020-05-07T20:00:00Z",2,NA,1798,1798,1798,69,0,0,0,0,0
"1205",20200507,"MS",8686,72101,NA,650,1442,139,NA,71,NA,4421,"A","5/6/2020 19:00","6c68bff7548724b2a7e075c6737181f3e013970a","2020-05-07T20:00:00Z",396,1442,80787,80787,80787,28,22,50,0,262,262
"1206",20200507,"MT",456,19791,NA,6,62,NA,NA,NA,NA,417,"C","5/7/2020 00:00","54d050cadd9864444637a853f909837d2c4fe04c","2020-05-07T20:00:00Z",16,62,20247,20247,20247,30,0,0,543,0,543
"1207",20200507,"NC",13397,157931,NA,525,NA,NA,NA,NA,NA,NA,"B","5/7/2020 11:00","acd644e9ced8bc6b35ad5790e35258d0170296b4","2020-05-07T20:00:00Z",507,NA,171328,171328,171328,37,30,0,6207,639,6846
"1208",20200507,"ND",1371,39496,NA,35,102,NA,NA,NA,NA,601,"C","5/7/2020 13:00","9da56a0ac56b6cadf8701583326864f913bd9dc9","2020-05-07T20:00:00Z",31,102,40867,40867,40867,38,0,5,2187,48,2235
"1209",20200507,"NE",6771,30987,NA,NA,NA,NA,NA,NA,NA,NA,"D","5/6/2020 17:45","6ffe9539528470c9307a11c2010883d59b68285b","2020-05-07T20:00:00Z",86,NA,37758,37758,37758,31,4,0,1297,333,1630
"1210",20200507,"NH",2740,26066,345,113,307,NA,82,NA,NA,1110,"B","5/6/2020 09:00","0e030c5590ddc8f83cdc37a0e2e0bc1089aa00c3","2020-05-07T20:00:00Z",111,307,29151,28806,28806,33,19,12,969,104,1073
"1211",20200507,"NJ",133635,159023,552,4996,NA,1470,NA,1107,NA,15642,"A+","5/7/2020 13:00","04f0e88155e2fe93102e54ac53b91efca0056bee","2020-05-07T20:00:00Z",8801,NA,293210,292658,292658,34,252,0,1993,1745,3738
"1212",20200507,"NM",4291,81393,NA,193,687,NA,NA,NA,NA,1073,"C","5/6/2020 06:01","29326b71397717de1c54efc0cc5b3fc955a16670","2020-05-07T20:00:00Z",169,687,85684,85684,85684,35,7,0,2280,153,2433
"1213",20200507,"NV",5766,45591,NA,NA,NA,NA,NA,NA,NA,205,"D","5/7/2020 12:40","45a26ef346c9e06e6f0d3470b15341fef5f5df6b","2020-05-07T20:00:00Z",286,NA,51357,51357,51357,32,10,0,1979,103,2082
"1214",20200507,"NY",327649,762267,NA,8665,71152,2976,NA,2425,NA,55547,"B","5/7/2020 00:00","aa09a1b85d3fc400541054cb2c3d6b8448d876c7","2020-05-07T20:00:00Z",20828,71152,1089916,1089916,1089916,36,951,613,30324,3671,33995
"1215",20200507,"OH",22131,153928,NA,1057,4140,418,1167,279,NA,NA,"B","5/7/2020 14:00","ed2899c3bd0a252435cd91dfc1063d748fbddd02","2020-05-07T20:00:00Z",1271,4140,176059,176059,176059,39,46,88,6575,555,7130
"1216",20200507,"OK",4330,82557,NA,223,805,97,NA,NA,NA,2985,"A+","5/7/2020 00:00","bcff317d24f0fc4cd6980da55e2599126cb50da9","2020-05-07T20:00:00Z",260,805,86887,86887,86887,40,7,32,3868,129,3997
"1217",20200507,"OR",2989,67469,NA,171,645,48,NA,23,NA,1125,"A+","5/7/2020 11:00","e2da35f6b07bd37c500fc664735737f50e3c99e5","2020-05-07T20:00:00Z",121,645,70458,70458,70458,41,6,4,2409,73,2482
"1218",20200507,"PA",52915,209873,NA,2420,NA,NA,NA,539,NA,NA,"C","5/7/2020 00:00","f339fc9b90b8fc5e7e00bbb2a923916ff6a49890","2020-05-07T20:00:00Z",3416,NA,262788,262788,262788,42,310,0,5378,1070,6448
"1219",20200507,"PR",2031,NA,NA,NA,NA,NA,NA,NA,NA,NA,"D","5/7/2020 06:00","4527cb6b92e4ae973ae4cb053449076a5ecb3abf","2020-05-07T20:00:00Z",102,NA,2031,2031,2031,72,3,0,0,63,63
"1220",20200507,"RI",10530,71788,NA,318,1153,82,NA,56,NA,696,"A+","5/6/2020 12:00","129dc7d079af33f0aafad27af5b88a6577cf9f87","2020-05-07T20:00:00Z",388,1153,82318,82318,82318,44,18,30,2620,325,2945
"1221",20200507,"SC",6936,70546,NA,NA,1152,NA,NA,NA,NA,3816,"B","5/6/2020 16:20","ec394c556c4abcc745b3f9b63ee25296da636d2c","2020-05-07T20:00:00Z",305,1152,77482,77482,77482,45,0,0,0,0,0
"1222",20200507,"SD",2905,17209,NA,70,236,NA,NA,NA,NA,2028,"C","5/6/2020 18:00","67ae5d871efe950aafaf1eda84696df99dba7200","2020-05-07T20:00:00Z",31,236,20114,20114,20114,46,2,6,572,126,698
"1223",20200507,"TN",14096,222232,NA,NA,1266,NA,NA,NA,NA,6783,"B","5/7/2020 15:00","6cabf2a54fdece34081beb81fa812444413e5add","2020-05-07T20:00:00Z",237,1266,236328,236328,236328,47,-2,45,9069,158,9227
"1224",20200507,"TX",35390,419772,NA,1750,NA,NA,NA,NA,NA,18440,"B","5/7/2020 13:00","d45b2d01a3363e6d595183fd93f6d7dfbcbde02f","2020-05-07T20:00:00Z",973,NA,455162,455162,455162,48,25,0,15256,968,16224
"1225",20200507,"UT",5724,128819,NA,194,476,NA,159,NA,73,2640,"B","5/7/2020 15:00","102a3a6a5debf91ec371c69370f032467b88438e","2020-05-07T20:00:00Z",61,476,134543,134543,134543,49,3,12,3412,129,3541
"1226",20200507,"VA",21570,101582,519,1613,4438,371,NA,203,NA,2825,"A+","5/6/2020 17:00","1594731882d14613e8e3d538f334c85f85f56ff8","2020-05-07T20:00:00Z",769,4438,123671,123152,123152,51,56,325,8130,1314,9444
"1227",20200507,"VI",66,990,37,NA,NA,NA,NA,NA,NA,54,"C","5/6/2020 09:46","27a92f146d58dcd58c01571ddc2d001efcd1006c","2020-05-07T20:00:00Z",4,NA,1093,1056,1056,78,0,0,0,0,0
"1228",20200507,"VT",916,16690,NA,14,NA,2,NA,0,NA,718,"B","5/7/2020 00:00","8b07ca2ac6c85eb873f57fc55e064b879125ed26","2020-05-07T20:00:00Z",53,NA,17606,17606,17606,50,1,0,409,2,411
"1229",20200507,"WA",17028,233209,NA,358,NA,144,NA,NA,NA,NA,"B","5/7/2020 00:00","a365835faf428f4f18ef63c41f2b732ed6a2841d","2020-05-07T20:00:00Z",870,NA,250237,250237,250237,53,8,0,5518,243,5761
"1230",20200507,"WI",9215,93035,219,624,1732,108,435,NA,NA,4520,"A+","5/7/2020 00:00","f7c14ee00a0cfc743e2a892f423525be89fed895","2020-05-07T20:00:00Z",374,1732,102469,102250,102250,55,12,38,5209,314,5523
"1231",20200507,"WV",1287,56234,NA,76,NA,22,NA,12,NA,716,"C","5/7/2020 10:00","d5683cefcda0418c9b16fae15e2de62f4567ebd7","2020-05-07T20:00:00Z",51,NA,57521,57521,57521,54,1,0,1698,39,1737
"1232",20200507,"WY",631,11403,NA,11,59,NA,NA,NA,NA,416,"C","5/6/2020 15:27","c13fee2e524bddf39f97125e6c47667d529b7cdc","2020-05-07T20:00:00Z",7,59,12034,12034,12034,56,0,-1,0,27,27
"1233",20200506,"AK",372,23283,NA,8,NA,NA,NA,NA,NA,284,"C","5/6/2020 00:00","fc9f98fdf2f0db7f59fd92efea605ccca134259e","2020-05-06T20:00:00Z",10,NA,23655,23655,23655,2,1,0,962,1,963
"1234",20200506,"AL",8581,100935,NA,NA,1158,NA,442,NA,264,NA,"B","5/6/2020 00:00","cda808b17675c452da77c0e6b5aaf56a5f434a0e","2020-05-06T20:00:00Z",340,1158,109516,109516,109516,1,27,51,2454,296,2750
"1235",20200506,"AR",3568,55435,NA,69,453,NA,NA,14,89,2109,"B","5/6/2020 14:42","cb92db297b9f3a9418a5a0bf6439bf95106cc319","2020-05-06T20:00:00Z",85,453,59003,59003,59003,5,2,0,4296,72,4368
"1236",20200506,"AS",0,83,NA,NA,NA,NA,NA,NA,NA,NA,"F","5/3/2020 00:00","ba86f4ccd459fbd32fadda9d5a86774440b0d3ee","2020-05-06T20:00:00Z",0,NA,83,83,83,60,0,0,0,0,0
"1237",20200506,"AZ",9707,82030,NA,754,1430,286,NA,193,NA,1693,"A+","5/6/2020 00:00","3c805a6c16888efca84885003f9697d2f9b99141","2020-05-06T20:00:00Z",426,1430,91737,91737,91737,4,31,33,3075,402,3477
"1238",20200506,"CA",58815,750221,NA,4681,NA,1415,NA,NA,NA,NA,"B","5/5/2020 14:00","414d88b0f66a2eacb032953c8c9c95da419f193d","2020-05-06T20:00:00Z",2412,NA,809036,809036,809036,6,95,0,26531,2603,29134
"1239",20200506,"CO",17364,68612,NA,792,2919,NA,NA,NA,NA,2801,"B","5/4/2020 00:00","3a2140e7af83e8e04554d6d8d4e1e37ad425181e","2020-05-06T20:00:00Z",903,2919,85976,85976,85976,8,52,81,515,457,972
"1240",20200506,"CT",30995,80452,NA,1445,7758,NA,NA,NA,NA,4346,"B","5/5/2020 20:30","bedfec74704364ff5825e6e69d64f2bd411fe1ba","2020-05-06T20:00:00Z",2718,7758,111447,111447,111447,9,85,0,2430,374,2804
"1241",20200506,"DC",5461,19523,NA,447,NA,130,NA,91,NA,808,"A+","5/5/2020 00:00","9ecfd2c253242034e3f5affc7997fdccfdeb1152","2020-05-06T20:00:00Z",277,NA,24984,24984,24984,11,13,0,516,139,655
"1242",20200506,"DE",5778,20690,NA,299,NA,NA,NA,NA,NA,2008,"B","5/5/2020 18:00","fbd26ed38a8eb0fec102963a87c6f277870816b3","2020-05-06T20:00:00Z",193,NA,26468,26468,26468,10,6,0,1381,407,1788
"1243",20200506,"FL",38002,442049,1351,NA,6776,NA,NA,NA,NA,NA,"C","5/6/2020 09:45","ef53ede20479581dcab76508f0c672a9542fe387","2020-05-06T20:00:00Z",1605,6776,481402,480051,480051,12,69,230,13797,563,14360
"1244",20200506,"GA",30696,173441,NA,NA,5765,NA,1343,NA,NA,NA,"A","5/6/2020 15:25","62bd7f63ff8ecf3e3f51526374d9392edfc16db8","2020-05-06T20:00:00Z",1311,5765,204137,204137,204137,13,23,131,2269,985,3254
"1245",20200506,"GU",151,3476,NA,NA,NA,NA,NA,NA,NA,123,"F","5/6/2020 00:00","659f9f46906c350d458a3175b9e99ae502ece53b","2020-05-06T20:00:00Z",5,NA,3627,3627,3627,66,0,0,135,2,137
"1246",20200506,"HI",625,34574,NA,NA,73,NA,NA,NA,NA,551,"B","5/5/2020 18:00","a687f61edc39121bd5ad1256fe5686043392420e","2020-05-06T20:00:00Z",17,73,35199,35199,35199,15,0,0,1196,4,1200
"1247",20200506,"IA",10404,52767,NA,414,NA,151,NA,103,NA,3803,"B","5/5/2020 12:00","34e43a32bf14038f1f1e71a8c2c57d561751b90b","2020-05-06T20:00:00Z",219,NA,63171,63171,63171,19,12,0,2309,293,2602
"1248",20200506,"ID",2127,28418,NA,NA,203,NA,84,NA,NA,1379,"C","5/4/2020 19:00","5e06fa4cb38d9a1896745a278cf1fbeffc5879f1","2020-05-06T20:00:00Z",65,203,30545,30545,30545,16,1,2,216,21,237
"1249",20200506,"IL",68232,293028,NA,4832,NA,1231,NA,780,NA,NA,"A","5/6/2020 00:00","eda1ae6d1d4b368cd632daf32b8a7bff6e7ccc00","2020-05-06T20:00:00Z",2974,NA,361260,361260,361260,17,136,0,12704,2270,14974
"1250",20200506,"IN",21870,98626,NA,1558,NA,526,NA,281,NA,NA,"A+","5/5/2020 23:59","450d1525e1996806cca1824d571c37abf2f676be","2020-05-06T20:00:00Z",1377,NA,120496,120496,120496,18,51,0,3825,837,4662
"1251",20200506,"KS",5734,36380,NA,NA,571,NA,213,NA,96,318,"A","5/6/2020 10:00","6d60bb442e79635e20e0e024954da98722778a14","2020-05-06T20:00:00Z",144,571,42114,42114,42114,20,7,5,1746,276,2022
"1252",20200506,"KY",5822,55192,NA,347,1603,189,685,NA,NA,2058,"A","5/5/2020 17:00","96e56ce4aa0fe3ba8da39c2c26eff12d135d2a5f","2020-05-06T20:00:00Z",275,1603,61014,61014,61014,21,14,74,390,577,967
"1253",20200506,"LA",30399,164273,NA,1465,NA,NA,NA,187,NA,20316,"B","5/6/2020 16:30","62716c5f09422fc6f556ef9767252c7200ab5314","2020-05-06T20:00:00Z",2115,NA,194672,194672,194672,22,0,0,6038,403,6441
"1254",20200506,"MA",72025,267614,NA,3564,7080,922,NA,NA,NA,NA,"A","5/6/2020 12:00","eaf763bb35728c31df949ba03dbcb5f36e8445f7","2020-05-06T20:00:00Z",4420,7080,339639,339639,339639,25,208,249,4536,1754,6290
"1255",20200506,"MD",28163,115849,NA,1707,5497,584,NA,NA,NA,1903,"A","5/6/2020 10:00","59b43e670179ff1df5dced4ce775c1929464ecbb","2020-05-06T20:00:00Z",1437,5497,144012,144012,144012,24,47,160,2863,1046,3909
"1256",20200506,"ME",1254,22092,NA,37,191,18,NA,12,NA,766,"B","5/6/2020 12:30","5585f4006defe24fc5152cf16d4a80e29d11e948","2020-05-06T20:00:00Z",62,191,23346,23346,23346,23,1,4,2546,28,2574
"1257",20200506,"MI",45054,188177,NA,1818,NA,794,NA,617,NA,15659,"A+","5/6/2020 11:00","9e38e78bba7be5cf34eb0df657b37e1f0a0dedcb","2020-05-06T20:00:00Z",4250,NA,233231,233231,233231,26,71,0,9738,657,10395
"1258",20200506,"MN",8579,84653,NA,443,1405,180,488,NA,NA,4520,"A","5/5/2020 17:00","b63c0c178d7c3f4365a7242db0f24cd49b238661","2020-05-06T20:00:00Z",485,1405,93232,93232,93232,27,30,55,4495,728,5223
"1259",20200506,"MO",9102,91645,NA,953,NA,NA,NA,134,NA,NA,"B","5/6/2020 15:00","83cade9d495af2d80dd15645fddc3fa36bbd41a7","2020-05-06T20:00:00Z",396,NA,100747,100747,100747,29,19,0,5495,186,5681
"1260",20200506,"MP",15,1783,NA,NA,NA,NA,NA,NA,NA,12,"D","5/6/2020 00:00","f6a6a075e4e2c599a9d8e3a158338b373b9481e1","2020-05-06T20:00:00Z",2,NA,1798,1798,1798,69,0,0,0,1,1
"1261",20200506,"MS",8424,72101,NA,618,1392,144,NA,79,NA,4421,"B","5/5/2020 19:00","eb78fb694b490eddb3fbe9246f9f01e290ca18c6","2020-05-06T20:00:00Z",374,1392,80525,80525,80525,28,32,40,0,217,217
"1262",20200506,"MT",456,19248,NA,6,62,NA,NA,NA,NA,417,"C","5/6/2020 00:00","40d67b45ae316f1e7a5aeaa3195f66937aace9ad","2020-05-06T20:00:00Z",16,62,19704,19704,19704,30,0,0,4432,0,4432
"1263",20200506,"NC",12758,151724,NA,516,NA,NA,NA,NA,NA,NA,"B","5/6/2020 10:45","fd59df96bae6345ac96a11d053d90a94aaac3c29","2020-05-06T20:00:00Z",477,NA,164482,164482,164482,37,25,0,12180,502,12682
"1264",20200506,"ND",1323,37309,NA,32,97,NA,NA,NA,NA,582,"C","5/6/2020 13:00","1ca558b4a74d6468948080fde98352bb743c0c1d","2020-05-06T20:00:00Z",31,97,38632,38632,38632,38,6,2,2154,57,2211
"1265",20200506,"NE",6438,29690,NA,NA,NA,NA,NA,NA,NA,NA,"D","5/5/2020 17:45","5c976a58216c68bfb17c950e17a8a96022f3ed54","2020-05-06T20:00:00Z",82,NA,36128,36128,36128,31,4,0,1164,355,1519
"1266",20200506,"NH",2636,25097,79,115,295,NA,82,NA,NA,1105,"B","5/5/2020 09:00","dee3ef9c0aa8331262a24fb54f5e0e74038c2712","2020-05-06T20:00:00Z",92,295,27812,27733,27733,33,6,9,815,48,863
"1267",20200506,"NJ",131890,157030,594,5221,NA,1549,NA,1146,NA,15642,"A+","5/6/2020 13:00","297c2a475992a14152995c68c5f0c14382383e75","2020-05-06T20:00:00Z",8549,NA,289514,288920,288920,34,305,0,0,1297,1297
"1268",20200506,"NM",4138,79113,NA,178,687,NA,NA,NA,NA,964,"C","5/5/2020 17:30","fe1c29e64bdb8167d6d666a89273efaf189f66bb","2020-05-06T20:00:00Z",162,687,83251,83251,83251,35,6,20,1424,107,1531
"1269",20200506,"NV",5663,43612,NA,NA,NA,NA,NA,NA,NA,203,"D","5/6/2020 12:40","1ddcb2d39896880e12590fa07036020923051ff2","2020-05-06T20:00:00Z",276,NA,49275,49275,49275,32,8,0,1322,69,1391
"1270",20200506,"NY",323978,731943,NA,9179,70539,NA,NA,NA,NA,54597,"B","5/6/2020 00:00","e8a0855be45dbf442e72628a2fce22a1d0e9575d","2020-05-06T20:00:00Z",19877,70539,1055921,1055921,1055921,36,232,672,24236,2786,27022
"1271",20200506,"OH",21576,147353,NA,1045,4052,407,1151,275,NA,NA,"B","5/6/2020 14:00","adcf63127af23200aef19a1f1fd29738430deb7a","2020-05-06T20:00:00Z",1225,4052,168929,168929,168929,39,90,96,7587,607,8194
"1272",20200506,"OK",4201,78689,NA,230,773,102,NA,NA,NA,2909,"A","5/6/2020 00:00","7f28d7e4efe8483188c959d4037b4551b9082b93","2020-05-06T20:00:00Z",253,773,82890,82890,82890,40,6,0,3399,74,3473
"1273",20200506,"OR",2916,65060,NA,191,641,47,NA,20,NA,1125,"A+","5/6/2020 11:00","63841c2c96030464940dc4b754af6d391c2108b0","2020-05-06T20:00:00Z",115,641,67976,67976,67976,41,2,19,2475,77,2552
"1274",20200506,"PA",51845,204495,NA,2545,NA,NA,NA,560,NA,NA,"C","5/6/2020 00:00","542dcf3cc53de6381f5246d69aebb2b4f5f72622","2020-05-06T20:00:00Z",3106,NA,256340,256340,256340,42,94,0,4570,888,5458
"1275",20200506,"PR",1968,NA,NA,NA,NA,NA,NA,NA,NA,NA,"D","5/6/2020 06:00","cc901c42cb14ae77da2dd9315c3623dc138c5872","2020-05-06T20:00:00Z",99,NA,1968,1968,1968,72,0,0,0,44,-9269
"1276",20200506,"RI",10205,69168,NA,324,1123,86,NA,60,NA,665,"A+","5/6/2020 12:00","70dce254282fd61abf949bebc99c782a10c5edfc","2020-05-06T20:00:00Z",370,1123,79373,79373,79373,44,15,31,2666,272,2938
"1277",20200506,"SC",6936,70546,NA,NA,1152,NA,NA,NA,NA,3816,"B","5/6/2020 16:20","302fca1f21ea263ba99279a1b4bdaa849cf22076","2020-05-06T20:00:00Z",305,1152,77482,77482,77482,45,22,42,9532,179,9711
"1278",20200506,"SD",2779,16637,NA,72,230,NA,NA,NA,NA,1977,"C","5/5/2020 18:00","a7e9189f4158b01eea258d33e25d971e2c7acf77","2020-05-06T20:00:00Z",29,230,19416,19416,19416,46,5,10,336,58,394
"1279",20200506,"TN",13938,213163,NA,NA,1221,NA,NA,NA,NA,6564,"B","5/6/2020 15:00","04a8d430a8070c0df8b25f6b0c2314819dbafd82","2020-05-06T20:00:00Z",239,1221,227101,227101,227101,47,13,65,7991,248,8239
"1280",20200506,"TX",34422,404516,NA,1812,NA,NA,NA,NA,NA,17622,"B","5/6/2020 13:20","e3e1055c642b3e0d3990aa76bce02f31643fe0d1","2020-05-06T20:00:00Z",948,NA,438938,438938,438938,48,42,0,10675,1053,11728
"1281",20200506,"UT",5595,125407,NA,NA,464,NA,NA,NA,NA,2509,"C","5/6/2020 15:00","a04e797d75550a86cb6f234015667a5db215989d","2020-05-06T20:00:00Z",58,464,131002,131002,131002,49,2,8,4141,146,4287
"1282",20200506,"VA",20256,93452,469,1496,4113,361,NA,189,NA,2617,"A+","5/4/2020 17:00","94b8e4a87a30500ae2a55dc7069ea75bb96521b3","2020-05-06T20:00:00Z",713,4113,114177,113708,113708,51,0,0,0,0,0
"1283",20200506,"VI",66,990,37,NA,NA,NA,NA,NA,NA,54,"C","5/5/2020 20:30","1e6efbdf87c8ccce2a5de295607eae6834bde658","2020-05-06T20:00:00Z",4,NA,1093,1056,1056,78,0,0,17,0,17
"1284",20200506,"VT",914,16281,NA,26,NA,2,NA,0,NA,706,"B","5/6/2020 00:00","c865640fa504d3211b74f8c8fee7136aa960f19a","2020-05-06T20:00:00Z",52,NA,17195,17195,17195,50,0,0,216,5,221
"1285",20200506,"WA",16785,227691,NA,390,NA,127,NA,NA,NA,NA,"B","5/6/2020 00:00","c1c68d18031a2e2205b6d7416d95e29377f9db3a","2020-05-06T20:00:00Z",862,NA,244476,244476,244476,53,21,0,6662,275,6937
"1286",20200506,"WI",8901,87826,212,511,1694,107,423,NA,NA,4348,"A+","5/6/2020 00:00","262075549424f2d5301755f881e0bf3990d4ed46","2020-05-06T20:00:00Z",362,1694,96939,96727,96727,55,9,31,3859,335,4194
"1287",20200506,"WV",1248,54536,NA,76,NA,22,NA,12,NA,716,"C","5/6/2020 10:00","d6a7a1e6777a83cd867984183135256763655ed6","2020-05-06T20:00:00Z",50,NA,55784,55784,55784,54,0,0,951,10,961
"1288",20200506,"WY",604,11403,NA,11,60,NA,NA,NA,NA,409,"C","5/5/2020 15:30","cd4c7a9bd14f1bf5169459a27da1667df82af918","2020-05-06T20:00:00Z",7,60,12007,12007,12007,56,0,0,1084,8,1092
"1289",20200505,"AK",371,22321,NA,13,NA,NA,NA,NA,NA,277,"C","5/5/2020 00:00","00204bcdd1828164f28ff336af010befc611be6f","2020-05-05T20:00:00Z",9,NA,22692,22692,22692,2,0,0,968,1,969
"1290",20200505,"AL",8285,98481,NA,NA,1107,NA,428,NA,255,NA,"B","5/5/2020 00:00","cdeeecd2210217b93fc3b08765445de51e2cebcc","2020-05-05T20:00:00Z",313,1107,106766,106766,106766,1,17,43,3389,260,3649
"1291",20200505,"AR",3496,51139,NA,89,453,NA,NA,16,89,2041,"B","5/5/2020 16:10","843ec804bd4dfd6e377571e1e26decc15ef217ff","2020-05-05T20:00:00Z",83,453,54635,54635,54635,5,2,15,155,38,193
"1292",20200505,"AS",0,83,NA,NA,NA,NA,NA,NA,NA,NA,"F","5/3/2020 00:00","f94c558e51e8e65ec0f3cabbacdfc175c6c485e1","2020-05-05T20:00:00Z",0,NA,83,83,83,60,0,0,0,0,0
"1293",20200505,"AZ",9305,78955,NA,728,1397,303,NA,185,NA,1671,"A+","5/5/2020 00:00","735adac292a2c990854cd5e5b718e42fe1aa4c45","2020-05-05T20:00:00Z",395,1397,88260,88260,88260,4,33,40,2621,386,3007
"1294",20200505,"CA",56212,723690,NA,4622,NA,1388,NA,NA,NA,NA,"B","5/5/2020 14:00","d1e1fbebac80a5b1d13fc2900c50bff6c705d793","2020-05-05T20:00:00Z",2317,NA,779902,779902,779902,6,63,0,30753,1275,32028
"1295",20200505,"CO",16907,68097,NA,834,2838,NA,NA,NA,NA,2743,"B","5/3/2020 00:00","45f92d821fee555fde1bf6c68d3273b70ef8cd97","2020-05-05T20:00:00Z",851,2838,85004,85004,85004,8,9,39,1642,272,1914
"1296",20200505,"CT",30621,78022,NA,1500,7758,NA,NA,NA,NA,4346,"B","5/4/2020 16:00","3488aabd351aea8585068a7fc27d49d9563f83c8","2020-05-05T20:00:00Z",2633,7758,108643,108643,108643,9,138,0,4816,1334,6150
"1297",20200505,"DC",5322,19007,NA,447,NA,130,NA,91,NA,667,"A+","5/4/2020 00:00","a0b3d68c2585ef94d3ddd3c69e2a6042672a2488","2020-05-05T20:00:00Z",264,NA,24329,24329,24329,11,6,0,382,152,534
"1298",20200505,"DE",5371,19309,NA,284,NA,NA,NA,NA,NA,1847,"B","5/4/2020 18:00","c0c1630758c4164710e71aa3cdb8f4eb34b22f8e","2020-05-05T20:00:00Z",187,NA,24680,24680,24680,10,5,0,487,83,570
"1299",20200505,"FL",37439,428252,1265,NA,6546,NA,NA,NA,NA,NA,"C","5/5/2020 10:31","cc9858355edd3f9217a9161416e34034e40cfd24","2020-05-05T20:00:00Z",1536,6546,466956,465691,465691,12,113,217,20879,542,21421
"1300",20200505,"GA",29711,171172,NA,NA,5634,NA,1318,NA,NA,NA,"A","5/5/2020 16:25","5ae5e90907f6431ec82926953cadb35734aae2b1","2020-05-05T20:00:00Z",1288,5634,200883,200883,200883,13,66,108,17215,343,17558
"1301",20200505,"GU",149,3341,NA,NA,NA,NA,NA,NA,NA,124,"F","5/5/2020 09:00","da2be305fcb62d71c916f9a592b8d5c52932737e","2020-05-05T20:00:00Z",5,NA,3490,3490,3490,66,0,0,99,0,99
"1302",20200505,"HI",621,33378,NA,NA,73,NA,NA,NA,NA,548,"B","5/4/2020 18:00","8776cad44a432b84f7a3c2b78a5f960983b55ef1","2020-05-05T20:00:00Z",17,73,33999,33999,33999,15,0,0,132,1,133
"1303",20200505,"IA",10111,50458,NA,407,NA,152,NA,94,NA,3572,"B","5/4/2020 12:00","6d9839305f5fb6657d48b48c6a6c63e446cba279","2020-05-05T20:00:00Z",207,NA,60569,60569,60569,19,19,0,3000,408,3408
"1304",20200505,"ID",2106,28202,NA,NA,201,NA,83,NA,NA,1358,"C","5/3/2020 19:00","448b45a6b4659f99f4359f0d2b376f0329445496","2020-05-05T20:00:00Z",64,201,30308,30308,30308,16,0,1,456,45,501
"1305",20200505,"IL",65962,280324,NA,4780,NA,1266,NA,780,NA,NA,"A","5/5/2020 00:00","e21339964b8c7a6a92673f5c4e442e0c7cac79d8","2020-05-05T20:00:00Z",2838,NA,346286,346286,346286,17,176,0,11017,2122,13139
"1306",20200505,"IN",21033,94801,NA,1537,NA,480,NA,272,NA,NA,"A+","5/4/2020 23:59","24f7f8571c40557ecd256e61727a7a074590bd94","2020-05-05T20:00:00Z",1326,NA,115834,115834,115834,18,62,0,2011,526,2537
"1307",20200505,"KS",5458,34634,NA,NA,566,NA,212,NA,95,296,"A","5/5/2020 10:00","8ff92e3fe8a630f59bb17426fbbf5e798a9c8376","2020-05-05T20:00:00Z",137,566,40092,40092,40092,20,1,13,1276,213,1489
"1308",20200505,"KY",5245,54802,NA,333,1529,174,659,NA,NA,1892,"A","5/4/2020 17:00","5bc7150780989d3c773ad0a7b6087632a7c24912","2020-05-05T20:00:00Z",261,1529,60047,60047,60047,21,8,10,1523,115,1638
"1309",20200505,"LA",29996,158235,NA,1512,NA,NA,NA,194,NA,20316,"B","5/5/2020 13:00","59a66c5d31e3245daa4f058dcbc9f04d64545ffa","2020-05-05T20:00:00Z",2115,NA,188231,188231,188231,22,51,0,6977,323,7300
"1310",20200505,"MA",70271,263078,NA,3542,6831,914,NA,NA,NA,NA,"A","5/5/2020 12:00","3593a34b4fe8246a23128a3ebc6649733d8dea6f","2020-05-05T20:00:00Z",4212,6831,333349,333349,333349,25,122,209,7897,1184,9081
"1311",20200505,"MD",27117,112986,NA,1693,5337,573,NA,NA,NA,1810,"A","5/5/2020 10:00","d3cefd3286163525658d9cb622d3576b72f71b31","2020-05-05T20:00:00Z",1390,5337,140103,140103,140103,24,73,138,2399,709,3108
"1312",20200505,"ME",1226,19546,NA,36,187,18,NA,12,NA,741,"B","5/4/2020 11:59","e8f401f6d9b9ad47aa3c5ab29b4770a2a59e0c65","2020-05-05T20:00:00Z",61,187,20772,20772,20772,23,4,1,0,21,21
"1313",20200505,"MI",44397,178439,NA,1948,NA,839,NA,670,NA,15659,"A+","5/5/2020 11:00","f59ef5db99fd14e9a762c8a5febf4c372ce0dbac","2020-05-05T20:00:00Z",4179,NA,222836,222836,222836,26,130,0,0,447,447
"1314",20200505,"MN",7851,80158,NA,434,1350,182,475,NA,NA,4159,"A","5/4/2020 17:00","38f73da04e6a3332c1fe0fcb31278dfe24c2c236","2020-05-05T20:00:00Z",455,1350,88009,88009,88009,27,27,79,1451,617,2068
"1315",20200505,"MO",8916,86150,NA,893,NA,NA,NA,139,NA,NA,"A","5/5/2020 15:00","82fb3c9723b2a8a539659d6d8ee54258f76b9f05","2020-05-05T20:00:00Z",377,NA,95066,95066,95066,29,19,0,3453,162,3615
"1316",20200505,"MP",14,1783,NA,NA,NA,NA,NA,NA,NA,12,"D","5/5/2020 00:00","f974f99e211b2591c47910c40c7ff8077c6bdd43","2020-05-05T20:00:00Z",2,NA,1797,1797,1797,69,0,0,462,0,462
"1317",20200505,"MS",8207,72101,NA,645,1352,162,NA,77,NA,4421,"B","5/4/2020 19:00","35c010c9b6fcdcabd627b0bcf993a21631e152f7","2020-05-05T20:00:00Z",342,1352,80308,80308,80308,28,32,36,301,330,631
"1318",20200505,"MT",456,14816,NA,6,62,NA,NA,NA,NA,410,"C","5/5/2020 00:00","f6410c7bdf2b59d94fe6cc88584d1b65a1a9b226","2020-05-05T20:00:00Z",16,62,15272,15272,15272,30,0,0,185,-1,184
"1319",20200505,"NC",12256,139544,NA,534,NA,NA,NA,NA,NA,NA,"B","5/5/2020 11:00","71eed4dbf332c52c2b433209f5a051c552b9df27","2020-05-05T20:00:00Z",452,NA,151800,151800,151800,37,22,0,4953,408,5361
"1320",20200505,"ND",1266,35155,NA,31,95,NA,NA,NA,NA,559,"C","5/5/2020 13:00","99506c09c06027bed7c1ec571a7e7bb4e07b4608","2020-05-05T20:00:00Z",25,95,36421,36421,36421,38,0,1,1626,41,1667
"1321",20200505,"NE",6083,28526,NA,NA,NA,NA,NA,NA,NA,NA,"D","5/3/2020 20:45","f05a556fe3dc264585731aa10567937679347eaf","2020-05-05T20:00:00Z",78,NA,34609,34609,34609,31,0,0,682,173,855
"1322",20200505,"NH",2588,24282,79,111,286,NA,82,NA,NA,1019,"C","5/4/2020 09:00","d439d727676ac494e305c57b835834454be533c1","2020-05-05T20:00:00Z",86,286,26949,26870,26870,33,0,0,0,0,0
"1323",20200505,"NJ",130593,157030,550,5328,NA,1534,NA,1169,NA,15642,"A+","5/5/2020 13:00","0f17a7613eb59c4f6f7ab558a6dab1852c01412f","2020-05-05T20:00:00Z",8244,NA,288173,287623,287623,34,334,0,8079,2324,10403
"1324",20200505,"NM",4031,77689,NA,181,667,NA,NA,NA,NA,842,"C","5/4/2020 17:53","2c66e6cd3bb6109cb641d763ca3267091982b0ab","2020-05-05T20:00:00Z",156,667,81720,81720,81720,35,5,80,3562,181,3743
"1325",20200505,"NV",5594,42290,NA,NA,NA,NA,NA,NA,NA,200,"D","5/5/2020 10:00","07a812b256249da19674d50471105d9a2f785bed","2020-05-05T20:00:00Z",268,NA,47884,47884,47884,32,6,0,1615,103,1718
"1326",20200505,"NY",321192,707707,NA,9603,69867,NA,NA,NA,NA,58950,"B","5/5/2020 00:00","29c3e10715681c8e3221108398fa8f4bb8572a6a","2020-05-05T20:00:00Z",19645,69867,1028899,1028899,1028899,36,230,536,19350,2239,21589
"1327",20200505,"OH",20969,139766,NA,1069,3956,402,1123,281,NA,NA,"B","5/5/2020 14:00","3acdd8b604c289b8b53b3d65695a9378a96f3dc2","2020-05-05T20:00:00Z",1135,3956,160735,160735,160735,39,79,147,5085,495,5580
"1328",20200505,"OK",4127,75290,NA,236,773,113,NA,NA,NA,2830,"A","5/5/2020 00:00","3c6db41578e8e82105376eab0af843c6c1258f6a","2020-05-05T20:00:00Z",247,773,79417,79417,79417,40,9,20,15486,83,15569
"1329",20200505,"OR",2839,62585,NA,219,622,49,NA,25,NA,860,"A+","5/5/2020 11:00","15f61d1e5752dc22b67d98736af8338d666b9085","2020-05-05T20:00:00Z",113,622,65424,65424,65424,41,4,14,1887,80,1967
"1330",20200505,"PA",50957,199925,NA,2580,NA,NA,NA,550,NA,NA,"B","5/5/2020 00:00","1b812795c7e10a4eb1108793f5e2ae0f1227d51f","2020-05-05T20:00:00Z",3012,NA,250882,250882,250882,42,554,0,4427,865,5292
"1331",20200505,"PR",1924,9313,NA,NA,NA,NA,NA,NA,NA,NA,"D","5/5/2020 06:00","1661fe4eded7da03ba9a6d93c741ad360c4bd5a6","2020-05-05T20:00:00Z",99,NA,11237,11237,11237,72,2,0,0,81,81
"1332",20200505,"RI",9933,66502,NA,327,1092,89,NA,62,NA,639,"A+","5/5/2020 00:00","fae8f59d023bf2ca7ca77646cd1282163ee85a25","2020-05-05T20:00:00Z",355,1092,76435,76435,76435,44,14,31,2018,281,2299
"1333",20200505,"SC",6757,61014,NA,NA,1110,NA,NA,NA,NA,3622,"B","5/4/2020 16:35","ded92409b1c45f1fc31073aa89b3fc1ebd9131a0","2020-05-05T20:00:00Z",283,1110,67771,67771,67771,45,8,0,3452,131,3583
"1334",20200505,"SD",2721,16301,NA,75,220,NA,NA,NA,NA,1895,"C","5/4/2020 18:00","6780ec78ae5ac9150835e01d9a2efa9d89235394","2020-05-05T20:00:00Z",24,220,19022,19022,19022,46,3,9,256,53,309
"1335",20200505,"TN",13690,205172,NA,NA,1156,NA,NA,NA,NA,6356,"B","5/5/2020 15:00","8ca081c6cc720fe35854cae61d5042a11c5f44a6","2020-05-05T20:00:00Z",226,1156,218862,218862,218862,47,7,13,7300,119,7419
"1336",20200505,"TX",33369,393841,NA,1888,NA,NA,NA,NA,NA,16791,"B","5/5/2020 13:15","e75eea9ddd3f02eba2ffa4dd8a2df79b71ce6547","2020-05-05T20:00:00Z",906,NA,427210,427210,427210,48,22,0,18775,1037,19812
"1337",20200505,"UT",5449,121266,NA,NA,456,NA,NA,NA,NA,2387,"C","5/5/2020 15:00","f46e176344106b93598c1619735638324fccae69","2020-05-05T20:00:00Z",56,456,126715,126715,126715,49,6,15,1922,132,2054
"1338",20200505,"VA",20256,93452,469,1496,4113,361,NA,189,NA,2617,"A+","5/4/2020 17:00","5da8e479644b3cae196e3b40346174103a48f3cd","2020-05-05T20:00:00Z",713,4113,114177,113708,113708,51,29,103,651,764,1415
"1339",20200505,"VI",66,973,34,NA,NA,NA,NA,NA,NA,51,"C","5/4/2020 20:30","f1471b09ea632f76177743f0c9b3b9271943e717","2020-05-05T20:00:00Z",4,NA,1073,1039,1039,78,0,0,8,0,8
"1340",20200505,"VT",909,16065,NA,33,NA,2,NA,0,NA,NA,"B","5/5/2020 00:00","8261b92b4bfbfdd4db8bcddd64acf7adb0f52e9c","2020-05-05T20:00:00Z",52,NA,16974,16974,16974,50,0,0,176,3,179
"1341",20200505,"WA",16510,221029,NA,292,NA,102,NA,NA,NA,NA,"B","5/5/2020 00:00","0bbe4650115e44ca9395ea8c170a0620140ceb1f","2020-05-05T20:00:00Z",841,NA,237539,237539,237539,53,7,0,5938,248,6186
"1342",20200505,"WI",8566,83967,236,543,1663,92,414,NA,NA,4131,"A","5/5/2020 00:00","e4ba0d00f00cc8cb24d1a871fa86fcf417a8ac04","2020-05-05T20:00:00Z",353,1663,92769,92533,92533,55,13,42,3500,330,3830
"1343",20200505,"WV",1238,53585,NA,64,NA,23,NA,12,NA,630,"C","5/5/2020 10:00","9065fc831ce3829aaf56c620e5e03765dbfc254e","2020-05-05T20:00:00Z",50,NA,54823,54823,54823,54,0,0,1552,32,1584
"1344",20200505,"WY",596,10319,NA,13,60,NA,NA,NA,NA,405,"C","5/4/2020 17:02","552a7c9924dc8459d81a307d41b446111f974b88","2020-05-05T20:00:00Z",7,60,10915,10915,10915,56,0,0,451,10,461
"1345",20200504,"AK",370,21353,NA,12,NA,NA,NA,NA,NA,263,"C","5/4/2020 00:00","18ac37203518844ba0abb03f9f6f328f4abc6774","2020-05-04T20:00:00Z",9,NA,21723,21723,21723,2,0,0,143,2,145
"1346",20200504,"AL",8025,95092,NA,NA,1064,NA,411,NA,247,NA,"B","5/4/2020 00:00","5121e270d7289526977fe842ecf8eac839a7cf9f","2020-05-04T20:00:00Z",296,1064,103117,103117,103117,1,6,29,10317,300,10617
"1347",20200504,"AR",3458,50984,NA,91,438,NA,NA,16,88,2016,"B","5/3/2020 15:40","60aaf335c3391b4624ad79cdce644f9f0a8ce56b","2020-05-04T20:00:00Z",81,438,54442,54442,54442,5,5,11,1525,27,1552
"1348",20200504,"AS",0,83,NA,NA,NA,NA,NA,NA,NA,NA,"F","5/3/2020 00:00","79716c80aaa5e895276062440ab00c25a6b18608","2020-05-04T20:00:00Z",0,NA,83,83,83,60,0,0,26,0,26
"1349",20200504,"AZ",8919,76334,NA,703,1357,288,NA,200,NA,1632,"A+","5/4/2020 00:00","fe41c5b1959f7290d98723f333164af9090fd3a0","2020-05-04T20:00:00Z",362,1357,85253,85253,85253,4,0,9,3855,279,4134
"1350",20200504,"CA",54937,692937,NA,4616,NA,1464,NA,NA,NA,NA,"B","5/4/2020 14:00","b4941d5eb7b0e9b258470bc014fd97f1f34b280c","2020-05-04T20:00:00Z",2254,NA,747874,747874,747874,6,39,0,30802,1321,32123
"1351",20200504,"CO",16635,66455,NA,883,2799,NA,NA,NA,NA,2650,"B","5/2/2020 00:00","3da410a880c5304f89f1c328a6ec43712e9014d0","2020-05-04T20:00:00Z",842,2799,83090,83090,83090,8,10,6,2774,410,3184
"1352",20200504,"CT",29287,73206,NA,1488,7758,NA,NA,NA,NA,4346,"B","5/3/2020 16:00","e710920a280f95da7020779f8c63e77c1395acd4","2020-05-04T20:00:00Z",2495,7758,102493,102493,102493,9,59,0,0,0,0
"1353",20200504,"DC",5170,18625,NA,447,NA,130,NA,91,NA,666,"A+","5/3/2020 00:00","456560ab23188998e76e418eaabb7a0cfb608815","2020-05-04T20:00:00Z",258,NA,23795,23795,23795,11,7,0,539,154,693
"1354",20200504,"DE",5288,18822,NA,281,NA,NA,NA,NA,NA,1716,"B","5/3/2020 18:00","d3bf0ce73c09bc91df3a644c0a90077759e8af48","2020-05-04T20:00:00Z",182,NA,24110,24110,24110,10,5,0,293,80,373
"1355",20200504,"FL",36897,407373,1181,NA,6329,NA,NA,NA,NA,NA,"C","5/4/2020 09:12","ab9900a3978e419e37fd28c4c86ff5943dbb92e4","2020-05-04T20:00:00Z",1423,6329,445451,444270,444270,12,20,85,15262,819,16081
"1356",20200504,"GA",29368,153957,NA,NA,5526,NA,1284,NA,NA,NA,"A","5/4/2020 15:25","6411d6dad0f25353c0b9762def2e565ed0379dfe","2020-05-04T20:00:00Z",1222,5526,183325,183325,183325,13,45,133,7463,766,8229
"1357",20200504,"GU",149,3242,NA,NA,NA,NA,NA,NA,NA,125,"F","5/4/2020 07:40","c4f20dac6b74627dcbd18bd1f1d701698dcf30e0","2020-05-04T20:00:00Z",5,NA,3391,3391,3391,66,0,0,90,-1,89
"1358",20200504,"HI",620,33246,NA,NA,73,NA,NA,NA,NA,544,"B","5/3/2020 18:00","66a3d1747268d270a648e9434838daf66c78385a","2020-05-04T20:00:00Z",17,73,33866,33866,33866,15,1,1,916,0,916
"1359",20200504,"IA",9703,47458,NA,389,NA,143,NA,93,NA,3486,"B","5/3/2020 12:00","f21530001c5ac1c103040645158ac13443310bf9","2020-05-04T20:00:00Z",188,NA,57161,57161,57161,19,4,0,3441,534,3975
"1360",20200504,"ID",2061,27746,NA,NA,200,NA,83,NA,NA,1267,"C","5/2/2020 19:00","776135d94b845104c4e4135c7af3169ef7031461","2020-05-04T20:00:00Z",64,200,29807,29807,29807,16,1,0,0,0,0
"1361",20200504,"IL",63840,269307,NA,4493,NA,1232,NA,763,NA,NA,"A","5/4/2020 00:00","d782e7b14220fd17f5a776078b0bf27fbf9514a9","2020-05-04T20:00:00Z",2662,NA,333147,333147,333147,17,44,0,11493,2341,13834
"1362",20200504,"IN",20507,92790,NA,1449,NA,483,NA,249,NA,NA,"A+","5/3/2020 23:59","cacb77641fa61a9a97cf795c1c2f7c33f543e8c8","2020-05-04T20:00:00Z",1264,NA,113297,113297,113297,18,18,0,3864,574,4438
"1363",20200504,"KS",5245,33358,NA,NA,553,NA,209,NA,95,291,"A","5/3/2020 10:00","7397df9504168ef4c5f495d5a38463530f368651","2020-05-04T20:00:00Z",136,553,38603,38603,38603,20,2,6,1610,215,1825
"1364",20200504,"KY",5130,53279,NA,329,1519,170,654,NA,NA,1892,"A","5/3/2020 17:00","901067b70511db39ff4fb9a602e0c82c1b666b7d","2020-05-04T20:00:00Z",253,1519,58409,58409,58409,21,5,108,509,251,760
"1365",20200504,"LA",29673,151258,NA,1502,NA,NA,NA,220,NA,20316,"B","5/4/2020 13:00","8cfe135421928424d6f2dfbf4dde55ebc329b3f7","2020-05-04T20:00:00Z",2064,NA,180931,180931,180931,22,95,0,4438,333,4771
"1366",20200504,"MA",69087,255181,NA,3539,6622,908,NA,NA,NA,NA,"A","5/4/2020 12:00","1a42a1168f01996116b23e1093cccd1672716e08","2020-05-04T20:00:00Z",4090,6622,324268,324268,324268,25,86,115,8622,1000,9622
"1367",20200504,"MD",26408,110587,NA,1649,5199,563,NA,NA,NA,1695,"A","5/4/2020 10:00","cc43d2ca1c387c2964f811b8af214ce8c50b6cc0","2020-05-04T20:00:00Z",1317,5199,136995,136995,136995,24,36,148,3255,946,4201
"1368",20200504,"ME",1205,19546,NA,37,186,18,NA,11,NA,720,"B","5/3/2020 11:59","a63eb3cab6a90294c5517d7af8356f42051983ad","2020-05-04T20:00:00Z",57,186,20751,20751,20751,23,0,3,0,20,20
"1369",20200504,"MI",43950,178439,NA,1948,NA,839,NA,670,NA,15659,"A+","5/3/2020 11:00","f5df8b21c547527c7b78f612ea21e209d42d3642","2020-05-04T20:00:00Z",4049,NA,222389,222389,222389,26,0,0,9661,196,9857
"1370",20200504,"MN",7234,78707,NA,396,1271,166,444,NA,NA,3784,"A","5/4/2020 00:00","0035985a09e25bd764347334e4fd551dcdce2991","2020-05-04T20:00:00Z",428,1271,85941,85941,85941,27,9,72,2738,571,3309
"1371",20200504,"MO",8754,82697,NA,858,NA,NA,NA,135,NA,NA,"A","5/4/2020 15:00","bca5f7ea8a928f46d220926cfcc9264277013820","2020-05-04T20:00:00Z",358,NA,91451,91451,91451,29,6,0,8107,368,8475
"1372",20200504,"MP",14,1321,NA,NA,NA,NA,NA,NA,NA,12,"D","5/4/2020 00:00","1584828f338684ae067581e50ede927948384af2","2020-05-04T20:00:00Z",2,NA,1335,1335,1335,69,0,0,0,0,0
"1373",20200504,"MS",7877,71800,NA,646,1316,145,NA,78,NA,4421,"B","5/3/2020 19:00","c17ddbae32885a7e8e2b24adac32a266a1f309ff","2020-05-04T20:00:00Z",310,1316,79677,79677,79677,28,7,18,1757,327,2084
"1374",20200504,"MT",457,14631,NA,6,62,NA,NA,NA,NA,404,"C","5/4/2020 00:00","92e9c803d236d3326eb1bced9f906b1885f4094f","2020-05-04T20:00:00Z",16,62,15088,15088,15088,30,0,1,79,2,81
"1375",20200504,"NC",11848,134591,NA,498,NA,NA,NA,NA,NA,NA,"B","5/4/2020 10:50","45557785725faaec19a051dca4d5ee194af62d89","2020-05-04T20:00:00Z",430,NA,146439,146439,146439,37,8,0,2420,184,2604
"1376",20200504,"ND",1225,33529,NA,31,94,NA,NA,NA,NA,540,"C","5/4/2020 13:00","b75982b63a2764f33a67e11c6044c8a13f5271b4","2020-05-04T20:00:00Z",25,94,34754,34754,34754,38,0,4,1367,34,1401
"1377",20200504,"NE",5910,27844,NA,NA,NA,NA,NA,NA,NA,NA,"D","5/3/2020 20:45","d124d557ce38ca32a6f6902a2e50a8321133bb87","2020-05-04T20:00:00Z",78,NA,33754,33754,33754,31,2,0,1908,584,2492
"1378",20200504,"NH",2588,24282,244,103,286,NA,NA,NA,NA,1017,"C","5/3/2020 09:00","849f8a3379f074307517551fbd7cf790dccd0ff5","2020-05-04T20:00:00Z",86,286,27114,26870,26870,33,2,9,-1682,159,-1523
"1379",20200504,"NJ",128269,148951,647,5287,NA,1610,NA,1189,NA,15642,"A+","5/4/2020 13:00","e1538483bb2cc07c5d4c6ceae02261ddc5d5222e","2020-05-04T20:00:00Z",7910,NA,277867,277220,277220,34,39,0,629,1525,2154
"1380",20200504,"NM",3850,74127,NA,164,587,NA,NA,NA,NA,832,"C","5/3/2020 17:58","8bf814bbd34ed96963c1951fbf72cdc73ad2269d","2020-05-04T20:00:00Z",151,587,77977,77977,77977,35,12,0,2915,118,3033
"1381",20200504,"NV",5491,40675,NA,NA,NA,NA,NA,NA,NA,185,"D","5/4/2020 11:00","c77d3ff4b9ea2fee658311786263459e1a7b91a7","2020-05-04T20:00:00Z",262,NA,46166,46166,46166,32,5,0,832,65,897
"1382",20200504,"NY",318953,688357,NA,9647,69331,NA,NA,NA,NA,58950,"B","5/4/2020 00:00","ba4d074a61ad40eb9e794352cffbb05e283ba506","2020-05-04T20:00:00Z",19415,69331,1007310,1007310,1007310,36,226,595,18861,2538,21399
"1383",20200504,"OH",20474,134681,NA,1078,3809,412,1090,275,NA,NA,"B","5/4/2020 14:00","3bb8af56bf2fc6fb7949ec692f33709a7692ff45","2020-05-04T20:00:00Z",1056,3809,155155,155155,155155,39,18,40,4429,560,4989
"1384",20200504,"OK",4044,59804,NA,236,753,92,NA,NA,NA,2682,"A","5/3/2020 00:00","992629295d8601b4f2ec511f4e420e4c7b412b15","2020-05-04T20:00:00Z",238,753,63848,63848,63848,40,0,10,0,72,72
"1385",20200504,"OR",2759,60698,NA,207,608,41,NA,17,NA,860,"A+","5/4/2020 11:00","92876bef1d7f1b51551df9588c950205b875ee6d","2020-05-04T20:00:00Z",109,608,63457,63457,63457,41,0,10,1324,79,1403
"1386",20200504,"PA",50092,195498,NA,2708,NA,NA,NA,573,NA,NA,"B","5/4/2020 00:00","5fd981f1a2c6f48ffe0fa1d85a0b41be26de8f5d","2020-05-04T20:00:00Z",2458,NA,245590,245590,245590,42,14,0,4124,825,4949
"1387",20200504,"PR",1843,9313,NA,NA,NA,NA,NA,NA,NA,NA,"D","5/4/2020 06:00","468e6861a442cd42d2fb462929ef0c88a2c1826c","2020-05-04T20:00:00Z",97,NA,11156,11156,11156,72,0,0,0,35,35
"1388",20200504,"RI",9652,64484,NA,339,1061,84,NA,61,NA,601,"A+","5/4/2020 00:00","0ebc4c71667f275e02d01aae30da3ad29bcfee9d","2020-05-04T20:00:00Z",341,1061,74136,74136,74136,44,21,48,2034,175,2209
"1389",20200504,"SC",6626,57562,NA,NA,1110,NA,NA,NA,NA,3622,"B","5/3/2020 15:30","5ba28814df43672589896f9b5f39449971fa44ed","2020-05-04T20:00:00Z",275,1110,64188,64188,64188,45,0,0,0,0,0
"1390",20200504,"SD",2668,16045,NA,69,211,NA,NA,NA,NA,1830,"C","5/3/2020 18:00","57a79d1b62d112553a15700a7bcf874207ccddfa","2020-05-04T20:00:00Z",21,211,18713,18713,18713,46,0,14,259,37,296
"1391",20200504,"TN",13571,197872,NA,NA,1143,NA,NA,NA,NA,6081,"B","5/4/2020 15:00","89cd29730aed1390ac02400765c5c17823bead77","2020-05-04T20:00:00Z",219,1143,211443,211443,211443,47,9,8,6442,394,6836
"1392",20200504,"TX",32332,375066,NA,1533,NA,NA,NA,NA,NA,16090,"B","5/4/2020 13:15","cb36d38213b6cabb99b43ab2020f0788722627c8","2020-05-04T20:00:00Z",884,NA,407398,407398,407398,48,17,0,16054,784,16838
"1393",20200504,"UT",5317,119344,NA,NA,441,NA,NA,NA,NA,2342,"C","5/3/2020 15:00","4fa661b415ade0d99c06f8ca2d3137d33dcdd1d8","2020-05-04T20:00:00Z",50,441,124661,124661,124661,49,0,5,2417,142,2559
"1394",20200504,"VA",19492,92801,478,1463,4010,348,NA,192,NA,2547,"A+","5/3/2020 17:00","0ee01c6fd08327a9ffedb431edcaf15360fb1271","2020-05-04T20:00:00Z",684,4010,112771,112293,112293,51,24,100,3470,821,4291
"1395",20200504,"VI",66,965,15,NA,NA,NA,NA,NA,NA,51,"C","5/3/2020 20:30","bda7801e17d660b460fe699b714b4e351cf55746","2020-05-04T20:00:00Z",4,NA,1046,1031,1031,78,0,0,14,0,14
"1396",20200504,"VT",906,15889,NA,15,NA,NA,NA,NA,NA,NA,"C","5/4/2020 00:00","a7850f22271f096460808bea9afeb0b85e91d007","2020-05-04T20:00:00Z",52,NA,16795,16795,16795,50,0,0,319,5,324
"1397",20200504,"WA",16262,215091,NA,263,NA,86,NA,NA,NA,NA,"B","5/4/2020 00:00","84b8f7d91246fb9226f26e283e9d3a0d723bbceb","2020-05-04T20:00:00Z",834,NA,231353,231353,231353,53,4,0,6182,374,6556
"1398",20200504,"WI",8236,80467,226,573,1621,116,404,NA,NA,3973,"A","5/4/2020 00:00","c17d32b95a4467b10e1a6d6c831188dad116c119","2020-05-04T20:00:00Z",340,1621,88929,88703,88703,55,1,13,2470,272,2742
"1399",20200504,"WV",1206,52033,NA,73,NA,28,NA,15,NA,611,"C","5/4/2020 10:00","17da702f7b73d6fb20fa796b2b858e88875563f0","2020-05-04T20:00:00Z",50,NA,53239,53239,53239,54,0,0,1586,15,1601
"1400",20200504,"WY",586,9868,NA,13,60,NA,NA,NA,NA,391,"C","5/4/2020 01:56","371ea67c067e7545d949daea802ea8ef4317ea45","2020-05-04T20:00:00Z",7,60,10454,10454,10454,56,0,0,228,7,235
"1401",20200503,"AK",368,21210,NA,12,NA,NA,NA,NA,NA,262,"C","5/3/2020 14:15","47291d8d4e9d84e87ae0f5c56070e2b3b284a7fd","2020-05-03T20:00:00Z",9,NA,21578,21578,21578,2,0,0,176,3,179
"1402",20200503,"AL",7725,84775,NA,NA,1035,NA,403,NA,242,NA,"B","5/3/2020 00:00","af9d0e385c3812ffb9057c163a9179b9daac1161","2020-05-03T20:00:00Z",290,1035,92500,92500,92500,1,2,12,0,291,291
"1403",20200503,"AR",3431,49459,NA,100,427,NA,NA,20,88,1999,"B","5/3/2020 13:30","091a9db3cc083c8896fe7213039fa9e150ec43b9","2020-05-03T20:00:00Z",76,427,52890,52890,52890,5,3,13,1249,59,1308
"1404",20200503,"AS",0,57,NA,NA,NA,NA,NA,NA,NA,NA,"F","5/1/2020 00:00","033ba12d8b345376799e442ac3bcaa8a9cd092d3","2020-05-03T20:00:00Z",0,NA,57,57,57,60,0,0,0,0,0
"1405",20200503,"AZ",8640,72479,NA,732,1348,282,NA,192,NA,1597,"A+","5/3/2020 00:00","682fa257206e2e5961f7dd291cbe276b97761ded","2020-05-03T20:00:00Z",362,1348,81119,81119,81119,4,14,9,2846,276,3122
"1406",20200503,"CA",53616,662135,NA,4734,NA,1468,NA,NA,NA,NA,"B","5/3/2020 14:00","d2a4de966cdeb307363f3d53e97e6d98e0e2fa1e","2020-05-03T20:00:00Z",2215,NA,715751,715751,715751,6,44,0,27529,1419,28948
"1407",20200503,"CO",16225,63681,NA,883,2793,NA,NA,NA,NA,2607,"B","5/1/2020 00:00","6530ed7af7dcd1c1ecbd133e6a10dfeec405f193","2020-05-03T20:00:00Z",832,2793,79906,79906,79906,8,12,46,2500,457,2957
"1408",20200503,"CT",29287,73206,NA,1551,7758,NA,NA,NA,NA,4346,"B","5/2/2020 18:00","ba474df9ba3c648369c26a3eec6cc62d8e721bcc","2020-05-03T20:00:00Z",2436,7758,102493,102493,102493,9,97,0,1713,523,2236
"1409",20200503,"DC",5016,18086,NA,NA,NA,NA,NA,NA,NA,666,"B","5/2/2020 00:00","a43590ee066aaea507c3760898fa37428b1be85d","2020-05-03T20:00:00Z",251,NA,23102,23102,23102,11,11,0,879,219,1098
"1410",20200503,"DE",5208,18529,NA,284,NA,NA,NA,NA,NA,1640,"B","5/2/2020 18:00","94b68f067e8edb9d29340adbbf9453b70e536975","2020-05-03T20:00:00Z",177,NA,23737,23737,23737,10,9,0,455,170,625
"1411",20200503,"FL",36078,392111,1226,NA,6244,NA,NA,NA,NA,NA,"C","5/2/2020 10:14","b4bbb1861dfd7382b14b352add108a733db9e3c3","2020-05-03T20:00:00Z",1403,6244,429415,428189,428189,12,15,299,11562,615,12177
"1412",20200503,"GA",28602,146494,NA,NA,5393,NA,1249,NA,NA,NA,"A","5/3/2020 10:25","ca4f39e12c27dc91259a7e9a073a529310bdf34d","2020-05-03T20:00:00Z",1177,5393,175096,175096,175096,13,3,6,0,296,296
"1413",20200503,"GU",150,3152,NA,NA,NA,NA,NA,NA,NA,126,"F","5/3/2020 06:20","f4dde6237f9e084f25169ec7280990408e2b817c","2020-05-03T20:00:00Z",5,NA,3302,3302,3302,66,0,0,112,2,114
"1414",20200503,"HI",620,32330,NA,NA,72,NA,NA,NA,NA,541,"B","5/2/2020 00:00","7069622214b43bb0281d7c91a60a72f73c1fd55c","2020-05-03T20:00:00Z",16,72,32950,32950,32950,15,0,0,964,1,965
"1415",20200503,"IA",9169,44017,NA,378,NA,133,NA,93,NA,3325,"B","5/2/2020 12:00","c55f84210b7917f739f9af9eb7b2209014ffb018","2020-05-03T20:00:00Z",184,NA,53186,53186,53186,19,9,0,6309,528,6837
"1416",20200503,"ID",2061,27746,NA,NA,200,NA,83,NA,NA,1267,"C","5/2/2020 19:00","43897d0e97a0d4836faa9683b27f14d650ac41df","2020-05-03T20:00:00Z",63,200,29807,29807,29807,16,0,22,291,26,317
"1417",20200503,"IL",61499,257814,NA,4701,NA,1232,NA,759,NA,NA,"A","5/2/2020 00:00","b81126801cf1503f6be0e4422e23568b80bccb82","2020-05-03T20:00:00Z",2618,NA,319313,319313,319313,17,59,0,16423,2994,19417
"1418",20200503,"IN",19933,88926,NA,1398,NA,476,NA,242,NA,NA,"A+","5/2/2020 23:59","7f8859ede28b3a66f66bed1eba7e5658a1ef46a3","2020-05-03T20:00:00Z",1246,NA,108859,108859,108859,18,17,0,4080,638,4718
"1419",20200503,"KS",5030,31748,NA,NA,547,NA,209,NA,95,286,"A","5/3/2020 10:00","1319ccd5c823bb7052b44922ebea3bebb6fce268","2020-05-03T20:00:00Z",134,547,36778,36778,36778,20,3,6,1552,284,1836
"1420",20200503,"KY",4879,52770,NA,334,1411,178,652,NA,NA,1752,"A","5/1/2020 17:00","e6d1a477154abc49199c5d075ac25e5598c72fcd","2020-05-03T20:00:00Z",248,1411,57649,57649,57649,21,0,0,0,0,0
"1421",20200503,"LA",29340,146820,NA,1530,NA,NA,NA,213,NA,17303,"B","5/3/2020 13:00","2abd020ba879c45f70881e888e89e1e3408616b7","2020-05-03T20:00:00Z",1969,NA,176160,176160,176160,22,19,0,3102,200,3302
"1422",20200503,"MA",68087,246559,NA,3617,6507,904,NA,NA,NA,NA,"A","5/3/2020 16:00","ed7caecfe102b62bcac6f165dae94c701b763918","2020-05-03T20:00:00Z",4004,6507,314646,314646,314646,25,158,129,13828,1824,15652
"1423",20200503,"MD",25462,107332,NA,1635,5051,565,NA,NA,NA,1666,"A","5/3/2020 10:00","5be6db1574edb7d751959d95c9eb8aea8873e6a5","2020-05-03T20:00:00Z",1281,5051,132794,132794,132794,24,30,141,6283,989,7272
"1424",20200503,"ME",1185,19546,NA,33,183,18,NA,12,NA,706,"B","5/3/2020 11:45","1a2972c923961f74a197a82706ad5671bfbc3578","2020-05-03T20:00:00Z",57,183,20731,20731,20731,23,1,2,0,33,33
"1425",20200503,"MI",43754,168778,NA,2100,NA,850,NA,713,NA,15659,"A+","5/3/2020 11:00","fb2d8e3fb14b5306bff426f0750228fa947bcabf","2020-05-03T20:00:00Z",4049,NA,212532,212532,212532,26,29,0,10276,547,10823
"1426",20200503,"MN",6663,75969,NA,373,1199,155,426,NA,NA,2596,"A","5/2/2020 17:00","162a628bf43a0658ca39b36be6037b7a5061ab08","2020-05-03T20:00:00Z",419,1199,82632,82632,82632,27,24,40,3190,435,3625
"1427",20200503,"MO",8386,74590,NA,896,NA,NA,NA,141,NA,NA,"A","5/3/2020 15:00","c5bb5a599a40c9851dee2c2d7939a7361ff79ac5","2020-05-03T20:00:00Z",352,NA,82976,82976,82976,29,1,0,0,232,232
"1428",20200503,"MP",14,1321,NA,NA,NA,NA,NA,NA,NA,12,"D","5/3/2020 00:00","c0a11ea4264741d8542e008930fefda14cd2b2e9","2020-05-03T20:00:00Z",2,NA,1335,1335,1335,69,0,0,387,0,387
"1429",20200503,"MS",7550,70043,NA,667,1298,143,NA,73,NA,3413,"B","5/2/2020 19:00","c5b335c0e101eb6bb3413333733803abee8c66a8","2020-05-03T20:00:00Z",303,1298,77593,77593,77593,28,12,33,3009,109,3118
"1430",20200503,"MT",455,14552,NA,5,61,NA,NA,NA,NA,404,"C","5/3/2020 00:00","bc96f2c8b5d2da48705596282b459b2d63b6264f","2020-05-03T20:00:00Z",16,61,15007,15007,15007,30,0,0,372,0,372
"1431",20200503,"NC",11664,132171,NA,475,NA,NA,NA,NA,NA,NA,"B","5/3/2020 11:00","a624f8f089146cb8bf2d24aafdb6e06b3c1d3c32","2020-05-03T20:00:00Z",422,NA,143835,143835,143835,37,2,0,4205,155,4360
"1432",20200503,"ND",1191,32162,NA,31,90,NA,NA,NA,NA,517,"C","5/3/2020 13:00","150909d1f7deb01e242915b072c67ab3b91241ce","2020-05-03T20:00:00Z",25,90,33353,33353,33353,38,1,0,1768,38,1806
"1433",20200503,"NE",5326,25936,NA,NA,NA,NA,NA,NA,NA,NA,"D","5/2/2020 19:45","0f4ac06427802580555079d268d3ddd90688d76d","2020-05-03T20:00:00Z",76,NA,31262,31262,31262,31,3,0,1426,488,1914
"1434",20200503,"NH",2429,25964,220,103,277,NA,NA,NA,NA,1107,"C","5/2/2020 09:00","a28480d08d0d577941911c6faeaafc52725e20ae","2020-05-03T20:00:00Z",84,277,28613,28393,28393,33,3,7,3925,119,4044
"1435",20200503,"NJ",126744,148322,641,5317,NA,1623,NA,1198,NA,15642,"A+","5/3/2020 13:00","28957956d2de20c823e944c266c7c8a8afaf65f7","2020-05-03T20:00:00Z",7871,NA,275707,275066,275066,34,129,0,9727,3027,12754
"1436",20200503,"NM",3732,71212,NA,168,587,NA,NA,NA,NA,812,"C","5/2/2020 18:00","9bdc954161aa300e226d7fdaea0ce3830933ec23","2020-05-03T20:00:00Z",139,587,74944,74944,74944,35,8,0,3607,219,3826
"1437",20200503,"NV",5426,39843,NA,NA,NA,NA,NA,NA,NA,182,"D","5/3/2020 10:00","12be3eadb7ea2de1e19ea67adfe3ede9322e819d","2020-05-03T20:00:00Z",257,NA,45269,45269,45269,32,3,0,767,115,882
"1438",20200503,"NY",316415,669496,NA,9786,68736,NA,NA,NA,NA,58950,"B","5/3/2020 00:00","8269e363c3fb0c3b89f74591b6ff550750ba4882","2020-05-03T20:00:00Z",19189,68736,985911,985911,985911,36,280,846,23402,3438,26840
"1439",20200503,"OH",19914,130252,NA,931,3769,393,1078,255,NA,NA,"B","5/3/2020 14:00","faadef760a1014098af2f9afc72a051c88632082","2020-05-03T20:00:00Z",1038,3769,150166,150166,150166,39,17,57,3768,579,4347
"1440",20200503,"OK",3972,59804,NA,236,743,92,NA,NA,NA,2635,"A","5/3/2020 00:00","6432875ccdb6448681b30710a40222557cb34a21","2020-05-03T20:00:00Z",238,743,63776,63776,63776,40,0,0,0,121,121
"1441",20200503,"OR",2680,59374,NA,205,598,46,NA,21,NA,860,"A+","5/3/2020 11:00","64346cb6c25a90e06ead6ee5560742f0247f680f","2020-05-03T20:00:00Z",109,598,62054,62054,62054,41,0,3,1873,45,1918
"1442",20200503,"PA",49267,191374,NA,2645,NA,NA,NA,562,NA,NA,"B","5/3/2020 00:00","e9627649e063652cf6f55d5e0175d081799becfe","2020-05-03T20:00:00Z",2444,NA,240641,240641,240641,42,26,0,4303,962,5265
"1443",20200503,"PR",1808,9313,NA,NA,NA,NA,NA,NA,NA,NA,"D","5/3/2020 06:00","53217d1215268ee7b4ab580e5e35a6fc14d22cde","2020-05-03T20:00:00Z",97,NA,11121,11121,11121,72,2,0,0,51,51
"1444",20200503,"RI",9477,62450,NA,330,1013,83,NA,59,NA,565,"A+","5/3/2020 00:00","27273132db76d9609ecd7b67c2f284819a5e9f45","2020-05-03T20:00:00Z",320,1013,71927,71927,71927,44,24,36,1811,188,1999
"1445",20200503,"SC",6626,57562,NA,NA,1110,NA,NA,NA,NA,3622,"B","5/3/2020 15:30","72bb2dfcc255c26df4e47bb1dacc3f06325016e4","2020-05-03T20:00:00Z",275,1110,64188,64188,64188,45,8,0,2435,137,2572
"1446",20200503,"SD",2631,15786,NA,71,197,NA,NA,NA,NA,1799,"C","5/2/2020 18:00","b55dbf0cbe852237d2ef6d6c69b7e2a5ef91badd","2020-05-03T20:00:00Z",21,197,18417,18417,18417,46,0,10,283,43,326
"1447",20200503,"TN",13177,191430,NA,NA,1135,NA,NA,NA,NA,5814,"B","5/3/2020 15:00","3e052cacf993e44a1c4ded6f9179968d7bba1f06","2020-05-03T20:00:00Z",210,1135,204607,204607,204607,47,1,10,7815,516,8331
"1448",20200503,"TX",31548,359012,NA,1540,NA,NA,NA,NA,NA,15544,"B","5/2/2020 12:45","7286bb5e8d8547980a2d258ee8afb4b230ae09bf","2020-05-03T20:00:00Z",867,NA,390560,390560,390560,48,20,0,8886,1026,9912
"1449",20200503,"UT",5175,116927,NA,NA,436,NA,NA,NA,NA,2238,"C","5/3/2020 15:00","e315bfd94bc78aa467a3593243017bc1d9f2d0ab","2020-05-03T20:00:00Z",50,436,122102,122102,122102,49,1,18,4104,194,4298
"1450",20200503,"VA",18671,89331,465,1413,3910,385,NA,193,NA,2497,"B","5/2/2020 17:00","e7b54f1d94130890421d640553fc9a645d679934","2020-05-03T20:00:00Z",660,3910,108467,108002,108002,51,44,172,4966,940,5906
"1451",20200503,"VI",66,951,29,NA,NA,NA,NA,NA,NA,51,"C","5/3/2020 08:04","a194186c38a60f22859a3cd9908ba1f2fe852753","2020-05-03T20:00:00Z",4,NA,1046,1017,1017,78,0,0,29,0,29
"1452",20200503,"VT",901,15570,NA,19,NA,NA,NA,NA,NA,NA,"C","5/3/2020 00:00","e2a4417f8eaad323ffc235cc2a8685ccabbbee02","2020-05-03T20:00:00Z",52,NA,16471,16471,16471,50,1,0,338,5,343
"1453",20200503,"WA",15888,208909,NA,411,NA,120,NA,NA,NA,NA,"B","5/3/2020 00:00","9f741c10510058fc5d6ce5246fcfa24ff377ecad","2020-05-03T20:00:00Z",830,NA,224797,224797,224797,53,6,0,1289,78,1367
"1454",20200503,"WI",7964,77997,231,582,1608,118,402,NA,NA,3723,"A+","5/3/2020 00:00","5b727eaf6a6ba03492d28b8ca220416dd2c330b4","2020-05-03T20:00:00Z",339,1608,86192,85961,85961,55,5,17,2427,304,2731
"1455",20200503,"WV",1191,50447,NA,73,NA,28,NA,15,NA,611,"C","5/3/2020 10:00","2f9ffbdd9045325ad16477c11b7ee8e94148f7f4","2020-05-03T20:00:00Z",50,NA,51638,51638,51638,54,2,0,2470,22,2492
"1456",20200503,"WY",579,9640,NA,13,60,NA,NA,NA,NA,391,"C","5/2/2020 13:12","dda73c7535804608b086cdcc0eaa22c40a6efe9c","2020-05-03T20:00:00Z",7,60,10219,10219,10219,56,0,2,177,13,190
"1457",20200502,"AK",365,21034,NA,10,NA,NA,NA,NA,NA,261,"C","5/2/2020 00:00","fabbbd86b70f78c75c1dc8d7549d2f859251ab94","2020-05-02T20:00:00Z",9,NA,21399,21399,21399,2,0,0,1073,1,1074
"1458",20200502,"AL",7434,84775,NA,NA,1023,NA,335,NA,195,NA,"B","5/2/2020 00:00","0527920ee376f8c81bc5f78dc45832aedbfe8aaa","2020-05-02T20:00:00Z",288,1023,92209,92209,92209,1,9,15,0,276,276
"1459",20200502,"AR",3372,48210,NA,95,414,NA,NA,20,85,1987,"B","5/2/2020 14:47","eac9a5587a00083dc37290a030784bda6bdd4543","2020-05-02T20:00:00Z",73,414,51582,51582,51582,5,9,0,1855,51,1906
"1460",20200502,"AS",0,57,NA,NA,NA,NA,NA,NA,NA,NA,"F","5/1/2020 00:00","9c724e26018a35a4f7ec03b53fe1df683358eccd","2020-05-02T20:00:00Z",0,NA,57,57,57,60,0,0,0,0,0
"1461",20200502,"AZ",8364,69633,NA,718,1339,291,NA,198,NA,1565,"A+","5/2/2020 00:00","a6108dde6e859c460183ff114cce02ada7691b14","2020-05-02T20:00:00Z",348,1339,77997,77997,77997,4,18,136,2716,402,3118
"1462",20200502,"CA",52197,634606,NA,4722,NA,1433,NA,NA,NA,NA,"B","5/1/2020 00:00","df6c65ce351f074a2ec5e447e651df48b35faea6","2020-05-02T20:00:00Z",2171,NA,686803,686803,686803,6,98,0,30063,1755,31818
"1463",20200502,"CO",15768,61181,NA,931,2747,NA,NA,NA,NA,2553,"B","4/30/2020 00:00","937644d7fad38937e3acb28b5c07c10b380fc7e9","2020-05-02T20:00:00Z",820,2747,76949,76949,76949,8,43,50,4075,484,4559
"1464",20200502,"CT",28764,71493,NA,1592,7758,NA,NA,NA,NA,4346,"B","5/1/2020 12:00","b393ca1a0b4929c170f1dff036caa543beef788a","2020-05-02T20:00:00Z",2339,7758,100257,100257,100257,9,0,0,0,0,0
"1465",20200502,"DC",4797,17207,NA,NA,NA,NA,NA,NA,NA,666,"B","5/1/2020 00:00","71a7b1ec360be39795b9865c29a4961312601021","2020-05-02T20:00:00Z",240,NA,22004,22004,22004,11,9,0,730,139,869
"1466",20200502,"DE",5038,18074,NA,300,NA,NA,NA,NA,NA,1546,"B","5/2/2020 09:10","84e0bb361e028a941ed315c81e45fe1c2e3a4d1e","2020-05-02T20:00:00Z",168,NA,23112,23112,23112,10,9,0,407,120,527
"1467",20200502,"FL",35463,380549,NA,NA,5945,NA,NA,NA,NA,NA,"C","5/2/2020 10:14","6fef4afbf7bffe883ca0cecf9eb9683715d5781b","2020-05-02T20:00:00Z",1388,5945,416012,416012,416012,12,74,150,12578,735,13313
"1468",20200502,"GA",28306,146494,NA,NA,5387,NA,1247,NA,NA,NA,"A","5/2/2020 14:25","a783a111d4325140e0bf4ba55ac83bc6167fe0ee","2020-05-02T20:00:00Z",1174,5387,174800,174800,174800,13,20,118,5397,1036,6433
"1469",20200502,"GU",148,3040,NA,NA,NA,NA,NA,NA,NA,131,"F","5/2/2020 08:15","41083fd2ad3b852cd01cbc5b2ba0f59ad934c833","2020-05-02T20:00:00Z",5,NA,3188,3188,3188,66,0,0,181,2,183
"1470",20200502,"HI",619,31366,NA,NA,72,NA,NA,NA,NA,532,"B","5/1/2020 00:00","f165a9cefe9cc4bfb09e751d14a7e78e99b35d3c","2020-05-02T20:00:00Z",16,72,31985,31985,31985,15,0,2,890,1,891
"1471",20200502,"IA",8641,37708,NA,353,NA,131,NA,90,NA,3156,"A","5/1/2020 12:00","326eec42d63f5a7a4c2bccf1b20dc28a172f2b11","2020-05-02T20:00:00Z",175,NA,46349,46349,46349,19,5,0,0,757,757
"1472",20200502,"ID",2035,27455,NA,NA,178,NA,76,NA,NA,1215,"C","5/1/2020 19:00","ab41f85502be8d04b254f6b2f087880a8d19b1a2","2020-05-02T20:00:00Z",63,178,29490,29490,29490,16,0,0,245,20,265
"1473",20200502,"IL",58505,241391,NA,4717,NA,1250,NA,789,NA,NA,"A","5/2/2020 00:00","0bab87f3821fc68dc16c9b9f6be1f659a26f95c5","2020-05-02T20:00:00Z",2559,NA,299896,299896,299896,17,102,0,12758,2450,15208
"1474",20200502,"IN",19295,84846,NA,1456,NA,487,NA,244,NA,NA,"A+","5/1/2020 23:59","40fcb7d9db6507d7ce812030f0bd2dc9b23267ec","2020-05-02T20:00:00Z",1229,NA,104141,104141,104141,18,54,0,3837,665,4502
"1475",20200502,"KS",4746,30196,NA,NA,541,NA,206,NA,95,286,"A","5/2/2020 10:00","b3374ad7a16bab8b1ac68052105d321e576c7b67","2020-05-02T20:00:00Z",131,541,34942,34942,34942,20,1,7,1611,297,1908
"1476",20200502,"KY",4879,52770,NA,334,1411,178,652,NA,NA,1752,"A","5/1/2020 17:00","e62f7a6a57ad70b6776669619e289a70f5824e26","2020-05-02T20:00:00Z",248,1411,57649,57649,57649,21,8,36,866,171,1037
"1477",20200502,"LA",29140,143718,NA,1545,NA,NA,NA,208,NA,17303,"B","5/2/2020 13:00","6de25d471d324a23d27fc2c524f2c0a49a4d876b","2020-05-02T20:00:00Z",1950,NA,172858,172858,172858,22,23,0,4178,429,4607
"1478",20200502,"MA",66263,232731,NA,3601,6378,921,NA,NA,NA,NA,"A","5/2/2020 12:00","fae32f3a32cdb4bc1170f267062acef3f4f5b3a2","2020-05-02T20:00:00Z",3846,6378,298994,298994,298994,25,130,209,7406,1952,9358
"1479",20200502,"MD",24473,101049,NA,1657,4910,566,NA,NA,NA,1590,"A","5/2/2020 10:00","5b6a6b2154b816e1e8db6855adcc43a634e8ccb8","2020-05-02T20:00:00Z",1251,4910,125522,125522,125522,24,59,192,3538,1001,4539
"1480",20200502,"ME",1152,19546,NA,36,181,19,NA,10,NA,689,"B","5/2/2020 11:45","6626009cc00bc186075a361707c32a6b3b9830b9","2020-05-02T20:00:00Z",56,181,20698,20698,20698,23,1,4,0,29,29
"1481",20200502,"MI",43207,158502,NA,2100,NA,850,NA,713,NA,15659,"A+","5/2/2020 11:00","41a8cf48ccd74f645e91e4d9c28d6748c80ae539","2020-05-02T20:00:00Z",4020,NA,201709,201709,201709,26,154,0,10353,851,11204
"1482",20200502,"MN",6228,72779,NA,389,1159,135,404,NA,NA,2002,"A","5/1/2020 17:00","d4ab9b0412c7da5ac81bc49cfe19e4b6611c578e","2020-05-02T20:00:00Z",395,1159,79007,79007,79007,27,24,63,3680,498,4178
"1483",20200502,"MO",8154,74590,NA,896,NA,NA,NA,141,NA,NA,"A","5/2/2020 15:10","c6b8d1f733bf6f62375cde902780463292f9f9ab","2020-05-02T20:00:00Z",351,NA,82744,82744,82744,29,14,0,0,319,319
"1484",20200502,"MP",14,934,NA,NA,NA,NA,NA,NA,NA,12,"D","5/2/2020 06:37","638d9bf115f9b4069ba2b43b1b6442ced126bbac","2020-05-02T20:00:00Z",2,NA,948,948,948,69,0,0,185,0,185
"1485",20200502,"MS",7441,67034,NA,632,1265,142,NA,71,NA,3413,"B","5/1/2020 19:00","7c6cd9731c919bf9ce0583c02c32f31b0010afee","2020-05-02T20:00:00Z",291,1265,74475,74475,74475,28,10,39,2698,229,2927
"1486",20200502,"MT",455,14180,NA,5,61,NA,NA,NA,NA,404,"C","5/2/2020 00:00","3d2879316075d363d82c90e7b93f8ef91fe26088","2020-05-02T20:00:00Z",16,61,14635,14635,14635,30,0,0,430,2,432
"1487",20200502,"NC",11509,127966,NA,502,NA,NA,NA,NA,NA,NA,"B","5/2/2020 11:00","c7c8b509451ecd281ea6bb6fcf4fc5a3050fd6ed","2020-05-02T20:00:00Z",420,NA,139475,139475,139475,37,21,0,5057,586,5643
"1488",20200502,"ND",1153,30394,NA,32,90,NA,NA,NA,NA,510,"C","5/2/2020 13:00","28061b11e9963834ad277da182a8afc16890e738","2020-05-02T20:00:00Z",24,90,31547,31547,31547,38,1,4,1976,46,2022
"1489",20200502,"NE",4838,24510,NA,NA,NA,NA,NA,NA,NA,NA,"D","5/1/2020 19:45","8bed52d44b5c6482eecd50126c38bf220aadcedb","2020-05-02T20:00:00Z",73,NA,29348,29348,29348,31,3,0,1406,557,1963
"1490",20200502,"NH",2310,22039,159,103,270,NA,NA,NA,NA,980,"C","5/1/2020 09:00","0bb5033dd8a9962f93270005962f62643f7566f5","2020-05-02T20:00:00Z",81,270,24508,24349,24349,33,9,8,2136,164,2300
"1491",20200502,"NJ",123717,138595,676,5713,NA,1715,NA,1230,NA,15642,"A+","5/2/2020 13:00","d7497707a069d81c12c0ad7b360e123378c3c346","2020-05-02T20:00:00Z",7742,NA,262988,262312,262312,34,204,0,3240,2527,5767
"1492",20200502,"NM",3513,67605,NA,159,587,NA,NA,NA,NA,785,"C","5/1/2020 20:02","6eaa3976dba8653181749a0c54532aca1d57859e","2020-05-02T20:00:00Z",131,587,71118,71118,71118,35,8,51,3147,102,3249
"1493",20200502,"NV",5311,39076,NA,NA,NA,NA,NA,NA,NA,182,"D","5/2/2020 10:00","da6c0ad0835932f6c8acb23cfe4c2707f66e0223","2020-05-02T20:00:00Z",254,NA,44387,44387,44387,32,11,0,708,84,792
"1494",20200502,"NY",312977,646094,NA,10350,67890,NA,NA,NA,NA,57540,"B","5/2/2020 00:00","ca8b35a7cea1260f8ae73e966be723b767ed611d","2020-05-02T20:00:00Z",18909,67890,959071,959071,959071,36,299,710,26970,4663,31633
"1495",20200502,"OH",19335,126484,NA,1003,3712,424,1066,267,NA,NA,"B","5/2/2020 14:00","5b29bd136c437f54fd4c390cab18ada8a962c0d4","2020-05-02T20:00:00Z",1021,3712,145819,145819,145819,39,19,78,4721,592,5313
"1496",20200502,"OK",3851,59804,NA,236,743,92,NA,NA,NA,2554,"A","5/2/2020 00:00","0b5ce194b93627aee8399a87451f143befe06fb4","2020-05-02T20:00:00Z",238,743,63655,63655,63655,40,8,28,0,103,103
"1497",20200502,"OR",2635,57501,NA,209,595,50,NA,22,NA,NA,"A","5/2/2020 11:00","8e9277e0f8905f92df5331581f0b39908befb204","2020-05-02T20:00:00Z",109,595,60136,60136,60136,41,5,4,1904,56,1960
"1498",20200502,"PA",48305,187071,NA,2673,NA,NA,NA,571,NA,NA,"B","5/2/2020 00:00","6e3b05e1cc60b16ae3897ccd1169effd23e2592b","2020-05-02T20:00:00Z",2418,NA,235376,235376,235376,42,64,0,6594,1334,7928
"1499",20200502,"PR",1757,9313,NA,NA,NA,NA,NA,NA,NA,NA,"D","5/2/2020 06:00","f9c5c66d30ee70901466361ec09a7fdd0e2ec5b3","2020-05-02T20:00:00Z",95,NA,11070,11070,11070,72,3,0,0,182,182
"1500",20200502,"RI",9289,60639,NA,333,977,80,NA,54,NA,531,"A+","5/2/2020 00:00","a5d72e21d9f89be4688138a8489b2a052a75a681","2020-05-02T20:00:00Z",296,977,69928,69928,69928,44,17,40,2953,327,3280
"1501",20200502,"SC",6489,55127,NA,NA,1110,NA,NA,NA,NA,3622,"B","5/2/2020 15:45","6d068643272f8a1c86d6b02d8e129d6d584a37bf","2020-05-02T20:00:00Z",267,1110,61616,61616,61616,45,11,0,2006,231,2237
"1502",20200502,"SD",2588,15503,NA,71,187,NA,NA,NA,NA,1759,"C","5/1/2020 18:00","dda4b5bb049a9a0ae7b77e16882114db501e83e8","2020-05-02T20:00:00Z",21,187,18091,18091,18091,46,0,8,665,63,728
"1503",20200502,"TN",12661,183615,NA,NA,1125,NA,NA,NA,NA,5718,"B","5/2/2020 15:00","a92d3c57b4c2b6309ab6d13fd0d35fd705deeb89","2020-05-02T20:00:00Z",209,1125,196276,196276,196276,47,5,12,9374,770,10144
"1504",20200502,"TX",30522,350126,NA,1725,NA,NA,NA,NA,NA,14891,"B","5/2/2020 12:45","7ebc8fbb29899c1275bdc2bb060c1eadff3e2696","2020-05-02T20:00:00Z",847,NA,380648,380648,380648,48,31,0,27580,1293,28873
"1505",20200502,"UT",4981,112823,NA,NA,418,NA,NA,NA,NA,2185,"C","5/2/2020 00:00","af6de2bb8c1db9426476ee66d5b83abf956a94a0","2020-05-02T20:00:00Z",49,418,117804,117804,117804,49,3,15,5093,153,5246
"1506",20200502,"VA",17731,84365,458,1426,3738,375,NA,202,NA,2312,"B","5/2/2020 00:00","bd5f09e234a0670403ec8caf5c74a33017ef2920","2020-05-02T20:00:00Z",616,3738,102554,102096,102096,51,35,84,-5174,830,-4344
"1507",20200502,"VI",66,922,54,NA,NA,NA,NA,NA,NA,51,"C","5/1/2020 19:59","da90384960c0f4fb3020e8f5c068ee15e7fe1cef","2020-05-02T20:00:00Z",4,NA,1042,988,988,78,0,0,111,0,111
"1508",20200502,"VT",896,15232,NA,11,NA,NA,NA,NA,NA,NA,"C","5/2/2020 00:00","1610e91526a8a9e70c9c1568f8c6505ca76613ff","2020-05-02T20:00:00Z",51,NA,16128,16128,16128,50,1,0,302,11,313
"1509",20200502,"WA",15810,207620,NA,428,NA,117,NA,NA,NA,NA,"B","5/2/2020 00:00","8ce81b2c594495352e2fab45dd1e283ba90953d4","2020-05-02T20:00:00Z",824,NA,223430,223430,223430,53,10,0,2446,106,2552
"1510",20200502,"WI",7660,75570,231,582,1591,118,400,NA,NA,3698,"A+","5/2/2020 16:00","243137bad3e5206aff26352e27b4c345660dc371","2020-05-02T20:00:00Z",334,1591,83461,83230,83230,55,7,47,3004,346,3350
"1511",20200502,"WV",1169,47977,NA,76,NA,29,NA,15,NA,572,"C","5/2/2020 10:00","f3279663bbd999990587728f1b99b96c847b9f43","2020-05-02T20:00:00Z",48,NA,49146,49146,49146,54,2,0,2269,33,2302
"1512",20200502,"WY",566,9463,NA,13,58,NA,NA,NA,NA,387,"C","5/1/2020 15:49","b9b039510de7192952cbcbb1dd52de651051b5e6","2020-05-02T20:00:00Z",7,58,10029,10029,10029,56,0,2,327,7,334
"1513",20200501,"AK",364,19961,NA,25,NA,NA,NA,NA,NA,254,"C","5/1/2020 14:00","2cc6957ffff6906f6faca7c5f4d72b340a48e728","2020-05-01T20:00:00Z",9,NA,20325,20325,20325,2,0,0,1197,9,1206
"1514",20200501,"AL",7158,84775,NA,NA,1008,NA,335,NA,195,NA,"B","5/1/2020 00:00","13d9fbfdc046548c9d46fbfdd2e2fbed80489221","2020-05-01T20:00:00Z",279,1008,91933,91933,91933,1,10,30,4598,139,4737
"1515",20200501,"AR",3321,46355,NA,95,414,NA,NA,23,85,1973,"B","5/1/2020 14:50","e1125a1587778d76352b54f9d43fd17c05eb8798","2020-05-01T20:00:00Z",64,414,49676,49676,49676,5,3,12,1231,66,1297
"1516",20200501,"AS",0,57,NA,NA,NA,NA,NA,NA,NA,NA,"F","5/1/2020 00:00","22988e3786ea71b9ae117af1fa331f337a04672d","2020-05-01T20:00:00Z",0,NA,57,57,57,60,0,0,54,0,54
"1517",20200501,"AZ",7962,66917,NA,709,1203,311,NA,187,NA,1528,"A+","5/1/2020 00:00","1fb7ce8a34c9e10a3ee73df60ab6c689672958eb","2020-05-01T20:00:00Z",330,1203,74879,74879,74879,4,10,34,2779,314,3093
"1518",20200501,"CA",50442,604543,NA,4706,NA,1434,NA,NA,NA,NA,"B","4/30/2020 00:00","29609a0696566fdd88c491fe2799bb47e9a4c679","2020-05-01T20:00:00Z",2073,NA,654985,654985,654985,6,91,0,28123,1525,29648
"1519",20200501,"CO",15284,57106,NA,959,2697,NA,NA,NA,NA,2486,"B","4/29/2020 00:00","6bb89471292fc4536e197dd2204fcd088839aa37","2020-05-01T20:00:00Z",777,2697,72390,72390,72390,8,11,76,805,526,1331
"1520",20200501,"CT",28764,71493,NA,1592,7758,NA,NA,NA,NA,4346,"B","5/1/2020 12:00","3efc0df098281bbea91991091be31a2a71892834","2020-05-01T20:00:00Z",2339,7758,100257,100257,100257,9,82,7758,2060,1064,3124
"1521",20200501,"DC",4658,16477,NA,NA,NA,NA,NA,NA,NA,666,"B","4/30/2020 00:00","2057f39f7b2bc0c35eeeceb3d5a1b4a139a061c7","2020-05-01T20:00:00Z",231,NA,21135,21135,21135,11,7,0,721,335,1056
"1522",20200501,"DE",4918,17667,NA,281,NA,NA,NA,NA,NA,1403,"B","5/1/2020 13:15","8f6b90258d9c4fe3cd4c380beb3a826e04223f82","2020-05-01T20:00:00Z",159,NA,22585,22585,22585,10,7,0,581,184,765
"1523",20200501,"FL",34728,367971,NA,NA,5795,NA,NA,NA,NA,NA,"C","5/1/2020 14:32","a30019f74e7f74ea7a417b93742901aaf103bb07","2020-05-01T20:00:00Z",1314,5795,402699,402699,402699,12,24,0,19256,1038,20294
"1524",20200501,"GA",27270,141097,NA,NA,5269,NA,1215,NA,NA,NA,"A","5/1/2020 14:25","47197ec965a1e0117de1788b56e0fc266a894dcf","2020-05-01T20:00:00Z",1154,5269,168367,168367,168367,13,34,113,18208,1115,19323
"1525",20200501,"GU",146,2859,NA,NA,NA,NA,NA,NA,NA,131,"F","5/1/2020 08:15","5aa8927faae871a175d5915d0901d7d1e31821c3","2020-05-01T20:00:00Z",5,NA,3005,3005,3005,66,0,0,897,0,897
"1526",20200501,"HI",618,30476,NA,NA,70,NA,NA,NA,NA,526,"B","4/30/2020 00:00","68e384ed67ec5287b81bf2ca32bc48008ee23744","2020-05-01T20:00:00Z",16,70,31094,31094,31094,15,0,1,449,5,454
"1527",20200501,"IA",7884,37708,NA,345,NA,121,NA,91,NA,2899,"A","4/30/2020 12:00","ac35fcd56001ee16668840fbb6638363df5b7c01","2020-05-01T20:00:00Z",170,NA,45592,45592,45592,19,8,0,2186,739,2925
"1528",20200501,"ID",2015,27210,NA,NA,178,NA,75,NA,NA,1175,"C","4/30/2020 19:00","7235fd2534af2acbef1fe72c58410455d74b0e88","2020-05-01T20:00:00Z",63,178,29225,29225,29225,16,3,3,348,31,379
"1529",20200501,"IL",56055,228633,NA,4900,NA,1263,NA,777,NA,NA,"A","5/1/2020 00:00","1dc105a189f22ec6f6a9496bb39320823e2315ee","2020-05-01T20:00:00Z",2457,NA,284688,284688,284688,17,102,0,11684,3137,14821
"1530",20200501,"IN",18630,81009,NA,1431,NA,514,NA,257,NA,NA,"A+","4/30/2020 23:59","1914f3b41bfb11b61a4b274457232a718319303e","2020-05-01T20:00:00Z",1175,NA,99639,99639,99639,18,61,0,3846,795,4641
"1531",20200501,"KS",4449,28585,NA,NA,534,NA,206,NA,96,280,"A","5/1/2020 10:00","082fc564cfac6fd7b09af7fc0ec5713c4a815a6d","2020-05-01T20:00:00Z",130,534,33034,33034,33034,20,1,11,1197,211,1408
"1532",20200501,"KY",4708,51904,NA,330,1375,178,642,NA,NA,1675,"A","4/30/2020 17:00","5c910b8cd2c45e96c3db28eef44a888155189c09","2020-05-01T20:00:00Z",240,1375,56612,56612,56612,21,5,16,2342,169,2511
"1533",20200501,"LA",28711,139540,NA,1607,NA,NA,NA,230,NA,17303,"B","5/1/2020 13:00","505b179cabe29c0e460064f746e888f56c9d9155","2020-05-01T20:00:00Z",1927,NA,168251,168251,168251,22,65,0,6232,710,6942
"1534",20200501,"MA",64311,225325,NA,3716,6169,947,NA,NA,NA,NA,"A","5/1/2020 12:00","bc06e4a6772895745b676c30b586815ed2353265","2020-05-01T20:00:00Z",3716,6169,289636,289636,289636,25,154,227,11883,2106,13989
"1535",20200501,"MD",23472,97511,NA,1668,4718,568,NA,NA,NA,1517,"A","5/1/2020 10:00","52f17a7d3fc6ce10546305e0dcb654a75c0bb76d","2020-05-01T20:00:00Z",1192,4718,120983,120983,120983,24,52,159,4894,1730,6624
"1536",20200501,"ME",1123,19546,NA,37,177,17,NA,9,NA,657,"B","5/1/2020 11:45","a0dee3661c58b578b032e8238c8a6685fa8d30fe","2020-05-01T20:00:00Z",55,177,20669,20669,20669,23,2,7,0,28,28
"1537",20200501,"MI",42356,148149,NA,2319,NA,966,NA,760,NA,8342,"A+","5/1/2020 11:00","e93ca07e28f09145410e22ddd446db68443e76ff","2020-05-01T20:00:00Z",3866,NA,190505,190505,190505,26,77,0,9261,977,10238
"1538",20200501,"MN",5730,69099,NA,369,1096,118,380,NA,NA,1911,"A","4/30/2020 17:00","42abfae501b9428333fa203e513bea3e979156e0","2020-05-01T20:00:00Z",371,1096,74829,74829,74829,27,28,52,3959,594,4553
"1539",20200501,"MO",7835,74590,NA,883,NA,NA,NA,137,NA,NA,"A","5/1/2020 15:00","b13246dbfba5c2e6b3e55c721f127d86f6d4c178","2020-05-01T20:00:00Z",337,NA,82425,82425,82425,29,8,0,1465,273,1738
"1540",20200501,"MP",14,749,NA,NA,NA,NA,NA,NA,NA,12,"D","5/1/2020 06:27","5154cfb9ef528f1b0e72cf26052a24e3e5c7a2f1","2020-05-01T20:00:00Z",2,NA,763,763,763,69,0,0,164,0,164
"1541",20200501,"MS",7212,64336,NA,651,1226,160,NA,75,NA,3413,"B","4/30/2020 00:00","c6e75549e0703e89fdcdb2c378a728be8378c1cc","2020-05-01T20:00:00Z",281,1226,71548,71548,71548,28,20,51,4811,397,5208
"1542",20200501,"MT",453,13750,NA,5,61,NA,NA,NA,NA,397,"C","4/30/2020 00:00","fada72b64ad3891eaac498b0b7021eee3b0e51fa","2020-05-01T20:00:00Z",16,61,14203,14203,14203,30,0,0,289,0,289
"1543",20200501,"NC",10923,122909,NA,547,NA,NA,NA,NA,NA,NA,"B","5/1/2020 11:00","c526f70242e2979dd05b53b03f4289d0183972c9","2020-05-01T20:00:00Z",399,NA,133832,133832,133832,37,21,0,5382,414,5796
"1544",20200501,"ND",1107,28418,NA,27,86,NA,NA,NA,NA,482,"C","5/1/2020 13:00","fff18f8bb77f7edb8a74cd89e7b4a3fa4abefcec","2020-05-01T20:00:00Z",23,86,29525,29525,29525,38,4,1,2025,40,2065
"1545",20200501,"NE",4281,23104,NA,NA,NA,NA,NA,NA,NA,NA,"D","4/30/2020 19:45","b1276d260f7b5e4f9fb2c7a42e967564327a1a9d","2020-05-01T20:00:00Z",70,NA,27385,27385,27385,31,2,0,1567,497,2064
"1546",20200501,"NH",2146,19903,302,112,262,NA,NA,NA,NA,980,"C","4/30/2020 09:00","54ef5ba111d129324646b4de5e3dee5e700ac075","2020-05-01T20:00:00Z",72,262,22351,22049,22049,33,6,3,36,92,128
"1547",20200501,"NJ",121190,135355,583,5972,NA,1724,NA,1286,NA,15642,"A+","5/1/2020 13:00","04bf818537309091716016bcfd6e06b887e10ce0","2020-05-01T20:00:00Z",7538,NA,257128,256545,256545,34,310,0,6089,2538,8627
"1548",20200501,"NM",3411,64458,NA,172,536,NA,NA,NA,NA,760,"C","5/1/2020 10:55","24a4b2ab3bff777d4f9176e9c5d4c5b8272265a5","2020-05-01T20:00:00Z",123,536,67869,67869,67869,35,11,0,2586,198,2784
"1549",20200501,"NV",5227,38368,NA,NA,NA,NA,NA,NA,NA,182,"D","5/1/2020 10:00","6fea2767eab1d49a1c0d06ded4e7e44e52973e07","2020-05-01T20:00:00Z",243,NA,43595,43595,43595,32,6,0,1380,229,1609
"1550",20200501,"NY",308314,619124,NA,10993,67180,NA,NA,NA,NA,56187,"B","5/1/2020 00:00","0d53ffeae7eb1fd63bab5a7fff4b102eec154c87","2020-05-01T20:00:00Z",18610,67180,927438,927438,927438,36,289,811,22860,3942,26802
"1551",20200501,"OH",18743,121763,NA,NA,3634,NA,1056,NA,NA,NA,"B","5/1/2020 14:00","e837ef38a4192e5ce7b4a6e66cf7c07034549a56","2020-05-01T20:00:00Z",1002,3634,140506,140506,140506,39,27,101,5900,716,6616
"1552",20200501,"OK",3748,59804,NA,255,715,113,NA,NA,NA,2467,"A","5/1/2020 00:00","793537a2a7b925ddefdd29693a13eacc08601128","2020-05-01T20:00:00Z",230,715,63552,63552,63552,40,8,12,0,130,130
"1553",20200501,"OR",2579,55597,NA,208,591,49,NA,23,NA,NA,"A","5/1/2020 11:00","cdcb6c3e61f4ef814e1dae8cf380d7b8d0727e0e","2020-05-01T20:00:00Z",104,591,58176,58176,58176,41,1,13,2075,69,2144
"1554",20200501,"PA",46971,180477,NA,2683,NA,NA,NA,590,NA,NA,"B","5/1/2020 15:30","9d46559dac7e8244a33e38ab1e9e2dde3029dd43","2020-05-01T20:00:00Z",2354,NA,227448,227448,227448,42,62,0,4875,1208,6083
"1555",20200501,"PR",1575,9313,NA,NA,NA,NA,NA,NA,NA,NA,"D","5/1/2020 06:00","0f7ab6ef7f5456fd8bd3f2f43a0b7fc9012c9633","2020-05-01T20:00:00Z",92,NA,10888,10888,10888,72,0,0,0,36,36
"1556",20200501,"RI",8962,57686,NA,352,937,76,NA,51,NA,485,"A+","5/1/2020 00:00","9bf93c394c2c30ee38162cfb74182284f146e31d","2020-05-01T20:00:00Z",279,937,66648,66648,66648,44,13,41,2597,341,2938
"1557",20200501,"SC",6258,53121,NA,NA,1110,NA,NA,NA,NA,3622,"B","5/1/2020 16:00","78d4cc9a47e000a8cbc6c0fb20e2388789c82782","2020-05-01T20:00:00Z",256,1110,59379,59379,59379,45,12,110,2704,163,2867
"1558",20200501,"SD",2525,14838,NA,69,179,NA,NA,NA,NA,1686,"C","5/1/2020 11:28","c5214198c78933a356bdbd24e187c3d2ab9d9750","2020-05-01T20:00:00Z",21,179,17363,17363,17363,46,4,6,259,76,335
"1559",20200501,"TN",11891,174241,NA,NA,1113,NA,NA,NA,NA,5546,"B","5/1/2020 15:00","5b74246bc2c84384268cb84ad95a8428e5dd1a11","2020-05-01T20:00:00Z",204,1113,186132,186132,186132,47,5,68,7350,1156,8506
"1560",20200501,"TX",29229,322546,NA,1778,NA,NA,NA,NA,NA,14122,"B","5/1/2020 13:00","400c4b1147e50f54f0d3c809ec06d31acc574d33","2020-05-01T20:00:00Z",816,NA,351775,351775,351775,48,34,0,20333,1142,21475
"1561",20200501,"UT",4828,107730,NA,NA,403,NA,NA,NA,NA,2062,"C","5/1/2020 15:00","3d56ed8881b627abd200b416ebe7082f4c9ceafe","2020-05-01T20:00:00Z",46,403,112558,112558,112558,49,0,13,3901,156,4057
"1562",20200501,"VA",16901,89539,468,1431,3654,366,NA,193,NA,2196,"B","4/30/2020 17:00","86a3ae3eede4170fe4102b858c8c853e6e128a9f","2020-05-01T20:00:00Z",581,3654,106908,106440,106440,51,29,0,13876,1055,14931
"1563",20200501,"VI",66,811,68,NA,NA,NA,NA,NA,NA,51,"C","4/30/2020 20:37","872b871619d99a811f24cf4a0208ebee89cdf4c8","2020-05-01T20:00:00Z",4,NA,945,877,877,78,0,0,4,0,4
"1564",20200501,"VT",885,14930,NA,19,NA,NA,NA,NA,NA,NA,"C","5/1/2020 00:00","d4b1c287f9e1f251fb4e4c5c7b3b92e8cd583977","2020-05-01T20:00:00Z",50,NA,15815,15815,15815,50,1,0,573,6,579
"1565",20200501,"WA",15704,205174,NA,470,NA,120,NA,NA,NA,NA,"B","5/1/2020 00:00","e9d2e8e787a9889ecb6a3138af08a3e78c423b1e","2020-05-01T20:00:00Z",814,NA,220878,220878,220878,53,13,0,6076,308,6384
"1566",20200501,"WI",7314,72566,218,560,1544,127,391,NA,NA,3352,"A+","5/1/2020 16:00","9179e74e73a4ae093d2a7024194eef4b9383f9db","2020-05-01T20:00:00Z",327,1544,80098,79880,79880,55,11,32,3172,460,3632
"1567",20200501,"WV",1136,45708,NA,81,NA,33,NA,18,NA,555,"C","5/1/2020 10:00","df9f88567e187b56f7c2c8df1d0834fc98620958","2020-05-01T20:00:00Z",46,NA,46844,46844,46844,54,5,0,2285,18,2303
"1568",20200501,"WY",559,9136,NA,13,56,NA,NA,NA,NA,373,"C","4/30/2020 00:00","0b6acf00714e0bd86d6c85e97e640ec518ede824","2020-05-01T20:00:00Z",7,56,9695,9695,9695,56,0,0,234,15,249
"1569",20200430,"AK",355,18764,NA,19,NA,NA,NA,NA,NA,252,"C","4/30/2020 15:00","a0a8101c699ac035c6da259e1593907b5f8a87d7","2020-04-30T20:00:00Z",9,NA,19119,19119,19119,2,0,0,0,0,0
"1570",20200430,"AL",7019,80177,NA,NA,978,NA,335,NA,195,NA,"B","4/30/2020 00:00","af5b4f18ece0cb33a443428c795fbb15bc81bc1a","2020-04-30T20:00:00Z",269,978,87196,87196,87196,1,24,33,6570,177,6747
"1571",20200430,"AR",3255,45124,NA,95,402,NA,NA,23,85,1305,"B","4/30/2020 14:49","f43e63da5742fa45f0d979c2627df539141acdb9","2020-04-30T20:00:00Z",61,402,48379,48379,48379,5,2,13,2867,63,2930
"1572",20200430,"AS",0,3,17,NA,NA,NA,NA,NA,NA,NA,"F","4/19/2020 00:00","93551ee297f37734b00d300044b41f1473e08824","2020-04-30T20:00:00Z",0,NA,20,3,3,60,0,0,0,0,0
"1573",20200430,"AZ",7648,64138,NA,755,1169,311,NA,194,NA,1499,"A+","4/30/2020 00:00","05970d880ded59266a885d358f0698e4fa883b5b","2020-04-30T20:00:00Z",320,1169,71786,71786,71786,4,16,38,2527,446,2973
"1574",20200430,"CA",48917,576420,NA,4981,NA,1473,NA,NA,NA,NA,"B","4/29/2020 00:00","d33bbb6e9e278c4d74669c43bf8695474f11cfad","2020-04-30T20:00:00Z",1982,NA,625337,625337,625337,6,95,0,19781,2417,22198
"1575",20200430,"CO",14758,56301,NA,966,2621,NA,NA,NA,NA,2415,"B","4/28/2020 00:00","4534acfa40dbe970bc904ca0d9fa5304fe1c0d09","2020-04-30T20:00:00Z",766,2621,71059,71059,71059,8,6,11,1587,23,1610
"1576",20200430,"CT",27700,69433,NA,1650,NA,NA,NA,NA,NA,NA,"C","4/30/2020 16:00","97e94e5c42aadc5a884ae90627dd9ae7c59bb916","2020-04-30T20:00:00Z",2257,NA,97133,97133,97133,9,89,0,1382,933,2315
"1577",20200430,"DC",4323,15756,NA,NA,NA,NA,NA,NA,NA,660,"B","4/30/2020 00:00","57e73ac81e170a684c40543eae0cbd3d20c34ec2","2020-04-30T20:00:00Z",224,NA,20079,20079,20079,11,19,0,633,217,850
"1578",20200430,"DE",4734,17086,NA,296,NA,NA,NA,NA,NA,1275,"B","4/30/2020 12:10","c5e32d210db784e3316e0d3cc8c0e8d226c7fb7e","2020-04-30T20:00:00Z",152,NA,21820,21820,21820,10,8,0,203,79,282
"1579",20200430,"FL",33690,348715,1187,NA,5795,NA,NA,NA,NA,NA,"C","4/30/2020 09:44","76cbb19d5683ace16cff79455434e2b971ed617f","2020-04-30T20:00:00Z",1290,5795,383592,382405,382405,12,50,171,8420,497,8917
"1580",20200430,"GA",26155,122889,NA,NA,5156,NA,1171,NA,NA,NA,"A","4/30/2020 14:25","006789c8d78523fc04ff153d3b6b752303163f64","2020-04-30T20:00:00Z",1120,5156,149044,149044,149044,13,27,100,4522,583,5105
"1581",20200430,"GU",146,1962,NA,NA,NA,NA,NA,NA,NA,131,"F","4/30/2020 09:15","5cce3a48f16f774dac5d65d370ebac64adfe600d","2020-04-30T20:00:00Z",5,NA,2108,2108,2108,66,0,0,260,1,261
"1582",20200430,"HI",613,30027,NA,NA,69,NA,NA,NA,NA,516,"B","4/29/2020 18:00","a1ab38bb43bb048a93191d93dee7207f084ddbbc","2020-04-30T20:00:00Z",16,69,30640,30640,30640,15,0,0,1018,4,1022
"1583",20200430,"IA",7145,35522,NA,335,NA,121,NA,86,NA,2697,"B","4/29/2020 12:00","5982dc269accbb8216479252d9fb5477e7357501","2020-04-30T20:00:00Z",162,NA,42667,42667,42667,19,14,0,1028,302,1330
"1584",20200430,"ID",1984,26862,NA,NA,175,NA,74,NA,NA,1121,"C","4/29/2020 19:00","9519ae4e8dd07297b368e5e798eca6bc673015d6","2020-04-30T20:00:00Z",60,175,28846,28846,28846,16,0,2,432,32,464
"1585",20200430,"IL",52918,216949,NA,4953,NA,1289,NA,785,NA,NA,"A","4/30/2020 00:00","3671aeb0dd33aca11d7a89116deb7bec73be20a2","2020-04-30T20:00:00Z",2355,NA,269867,269867,269867,17,140,0,10637,2563,13200
"1586",20200430,"IN",17835,77163,NA,1466,NA,549,NA,275,NA,NA,"A+","4/29/2020 23:59","1a5558be667c6471c1bd326046f5bbf4331c20cd","2020-04-30T20:00:00Z",1114,NA,94998,94998,94998,18,49,0,2795,653,3448
"1587",20200430,"KS",4238,27388,NA,NA,523,NA,201,NA,93,272,"A","4/30/2020 10:00","fee4c8634da0a20250037042e9f60b056441565d","2020-04-30T20:00:00Z",129,523,31626,31626,31626,20,4,8,1668,500,2168
"1588",20200430,"KY",4539,49562,NA,325,1359,176,636,NA,NA,1668,"A","4/29/2020 17:00","bc98483e6eaa28680769f3dfe4f6c548de169f4b","2020-04-30T20:00:00Z",235,1359,54101,54101,54101,21,10,28,1526,164,1690
"1589",20200430,"LA",28001,133308,NA,1601,NA,NA,NA,231,NA,17303,"B","4/30/2020 13:00","af5eddab59ffd8e3bf9418e6dedcd259a47a9a9d","2020-04-30T20:00:00Z",1862,NA,161309,161309,161309,22,60,0,4400,341,4741
"1590",20200430,"MA",62205,213442,NA,3803,5942,1001,NA,NA,NA,NA,"A","4/30/2020 16:00","277e06348b7900c485b8ccf0ed10ea0879e8fbb4","2020-04-30T20:00:00Z",3562,5942,275647,275647,275647,25,157,184,8089,1940,10029
"1591",20200430,"MD",21742,92617,NA,1711,4559,590,NA,NA,NA,1432,"A","4/30/2020 10:00","b165947d0d332191ee6df78b0c5bf8dbbbf56f97","2020-04-30T20:00:00Z",1140,4559,114359,114359,114359,24,62,157,2537,893,3430
"1592",20200430,"ME",1095,19546,NA,35,170,18,NA,8,NA,631,"B","4/30/2020 11:45","d0893a8a60cb74857e22a7fde01d2807146f099d","2020-04-30T20:00:00Z",53,170,20641,20641,20641,23,1,4,0,39,39
"1593",20200430,"MI",41379,138888,NA,2319,NA,966,NA,760,NA,8342,"A+","4/30/2020 11:00","009e87a5ef6129fe5cdc6c132d30e1983af628cf","2020-04-30T20:00:00Z",3789,NA,180267,180267,180267,26,119,0,6935,980,7915
"1594",20200430,"MN",5136,65140,NA,365,1044,130,358,NA,NA,1829,"A","4/29/2020 17:00","6620252ef6edf1eb2ff049ca547931a81fb890ce","2020-04-30T20:00:00Z",343,1044,70276,70276,70276,27,24,94,3040,492,3532
"1595",20200430,"MO",7562,73125,NA,853,NA,NA,NA,141,NA,NA,"A","4/30/2020 15:00","26c7328139ea43597e9df30bca2e4213a288cc0f","2020-04-30T20:00:00Z",329,NA,80687,80687,80687,29,11,0,3391,137,3528
"1596",20200430,"MP",14,585,NA,NA,NA,NA,NA,NA,NA,12,"D","4/30/2020 07:00","681d2bc85dba2117a711f66ce5752b6fbf996991","2020-04-30T20:00:00Z",2,NA,599,599,599,69,0,0,375,0,375
"1597",20200430,"MS",6815,59525,NA,639,1175,146,NA,72,NA,3413,"B","4/29/2020 19:00","dc2287dde5b5e508c9b69ad45d5dfbf9495e56a3","2020-04-30T20:00:00Z",261,1175,66340,66340,66340,28,11,49,0,246,246
"1598",20200430,"MT",453,13461,NA,5,61,NA,NA,NA,NA,392,"C","4/30/2020 00:00","313655b4240373e98870028e1cb49c2bf94cefcb","2020-04-30T20:00:00Z",16,61,13914,13914,13914,30,0,0,384,2,386
"1599",20200430,"NC",10509,117527,NA,546,NA,NA,NA,NA,NA,NA,"B","4/30/2020 11:00","156a63e224c3a98e2235c3c3dad55ac6b1a3e57b","2020-04-30T20:00:00Z",378,NA,128036,128036,128036,37,24,0,9035,561,9596
"1600",20200430,"ND",1067,26393,NA,30,85,NA,NA,NA,NA,458,"C","4/30/2020 13:00","abe0b6e74726dd7b400b19ab257cb8ce1a7f85cd","2020-04-30T20:00:00Z",19,85,27460,27460,27460,38,0,3,1890,34,1924
"1601",20200430,"NE",3784,21537,NA,NA,NA,NA,NA,NA,NA,NA,"D","4/29/2020 19:45","7abcebf8062197d3a685dae32a43ffb4ac0a7e39","2020-04-30T20:00:00Z",68,NA,25321,25321,25321,31,13,0,1280,410,1690
"1602",20200430,"NH",2054,19867,272,107,259,NA,NA,NA,NA,980,"C","4/29/2020 09:00","4f9d37a0bd56cac6eab1edc7143353ee2500ec03","2020-04-30T20:00:00Z",66,259,22193,21921,21921,33,6,10,1131,44,1175
"1603",20200430,"NJ",118652,129266,478,6137,NA,1765,NA,1271,NA,15642,"A+","4/30/2020 13:00","f56cb82f813419dc609b6c2c9855c495f02f3ab2","2020-04-30T20:00:00Z",7228,NA,248396,247918,247918,34,458,0,4212,2388,6600
"1604",20200430,"NM",3213,61872,NA,163,536,NA,NA,NA,NA,734,"C","4/29/2020 20:02","54e6fe8038382314d403b0a85e1c710a472634fd","2020-04-30T20:00:00Z",112,536,65085,65085,65085,35,2,27,3101,239,3340
"1605",20200430,"NV",4998,36988,NA,NA,NA,NA,NA,NA,NA,158,"D","4/30/2020 10:00","6fb38c55c1ffabc4d3bd832f96cdc3e7b2c0e427","2020-04-30T20:00:00Z",237,NA,41986,41986,41986,32,7,0,858,100,958
"1606",20200430,"NY",304372,596264,NA,11598,66369,NA,NA,NA,NA,54771,"B","4/30/2020 00:00","f0a7b6ba7f4d1fa7aeb9f4bb15dc72dd7d9ce445","2020-04-30T20:00:00Z",18321,66369,900636,900636,900636,36,306,972,23474,4681,28155
"1607",20200430,"OH",18027,115863,NA,NA,3533,NA,1035,NA,NA,NA,"B","4/30/2020 14:00","1845c3ed2c898939606cfefa178adddff9272750","2020-04-30T20:00:00Z",975,3533,133890,133890,133890,39,38,112,4258,724,4982
"1608",20200430,"OK",3618,59804,NA,291,703,127,NA,NA,NA,2401,"A","4/29/2020 00:00","8966a3b88c23d8a9522b2710803ba7bc618fbc4d","2020-04-30T20:00:00Z",222,703,63422,63422,63422,40,8,10,2010,145,2155
"1609",20200430,"OR",2510,53522,NA,243,578,65,NA,28,NA,NA,"A","4/30/2020 11:00","6100f8b9ae5e31944e56a9a0120a3919f3b0a9d7","2020-04-30T20:00:00Z",103,578,56032,56032,56032,41,2,9,1496,64,1560
"1610",20200430,"PA",45763,175602,NA,2707,NA,NA,NA,556,NA,NA,"B","4/30/2020 00:00","a21e5063b789a7890fcf31c1f1ff0ded2a0fe978","2020-04-30T20:00:00Z",2292,NA,221365,221365,221365,42,97,0,5085,1397,6482
"1611",20200430,"PR",1539,9313,NA,NA,NA,NA,NA,NA,NA,NA,"D","4/30/2020 06:00","acf47671781904e48d5b43f44892a827b43eeaee","2020-04-30T20:00:00Z",92,NA,10852,10852,10852,72,6,0,0,106,106
"1612",20200430,"RI",8621,55089,NA,339,896,85,NA,54,NA,461,"A+","4/30/2020 00:00","3fa92c251f8a44c8178809da1e3497a434c607e5","2020-04-30T20:00:00Z",266,896,63710,63710,63710,44,15,146,3171,374,3545
"1613",20200430,"SC",6095,50417,NA,NA,1000,NA,NA,NA,NA,3252,"B","4/30/2020 16:04","675b5976db8c9e8e7c821e03509cea5d1464f068","2020-04-30T20:00:00Z",244,1000,56512,56512,56512,45,41,0,2081,214,2295
"1614",20200430,"SD",2449,14579,NA,76,173,NA,NA,NA,NA,1573,"C","4/30/2020 11:31","8075d5d958a13aad14d7c3f791e969c23c032dbc","2020-04-30T20:00:00Z",17,173,17028,17028,17028,46,4,8,119,76,195
"1615",20200430,"TN",10735,166891,NA,NA,1045,NA,NA,NA,NA,5338,"B","4/28/2020 15:00","888130d0bb375f7c9aaf84050d4df6dcd8ef987b","2020-04-30T20:00:00Z",199,1045,177626,177626,177626,47,4,32,8708,369,9077
"1616",20200430,"TX",28087,302213,NA,1686,NA,NA,NA,NA,NA,13353,"B","4/29/2020 13:00","3e86b550121260ff7f07226c771b566316634b9d","2020-04-30T20:00:00Z",782,NA,330300,330300,330300,48,50,0,14477,1033,15510
"1617",20200430,"UT",4672,103829,NA,NA,390,NA,NA,NA,NA,1939,"C","4/30/2020 15:00","79809c0c8dbd572777e78b77f0d90bcdab41fee5","2020-04-30T20:00:00Z",46,390,108501,108501,108501,49,1,7,2546,177,2723
"1618",20200430,"VA",15846,75663,583,1550,3654,372,NA,208,NA,2104,"B","4/30/2020 00:00","11fa1c8415d5fcc25713a756b5d34cf1ff6d865f","2020-04-30T20:00:00Z",552,3654,92092,91509,91509,51,30,46,4684,885,5569
"1619",20200430,"VI",66,807,43,NA,NA,NA,NA,NA,NA,51,"C","4/29/2020 18:12","0e1341cc02cf1d779dd97edb6d90a4a7ea14fc29","2020-04-30T20:00:00Z",4,NA,916,873,873,78,0,0,75,4,79
"1620",20200430,"VT",879,14357,NA,23,NA,NA,NA,NA,NA,NA,"C","4/30/2020 00:00","bac1a53bc55c702e6173654a110abea7aa1e1ee0","2020-04-30T20:00:00Z",49,NA,15236,15236,15236,50,2,0,202,13,215
"1621",20200430,"WA",15396,199098,NA,474,NA,145,NA,NA,NA,NA,"B","4/30/2020 00:00","e938db53e0f63938f355ecce09f75a19e9b1c4f1","2020-04-30T20:00:00Z",801,NA,214494,214494,214494,53,15,0,5913,241,6154
"1622",20200430,"WI",6854,69394,195,554,1512,119,382,NA,NA,3352,"A+","4/30/2020 16:00","874e739cc067fe15f7106bb0caa8173b1a85e794","2020-04-30T20:00:00Z",316,1512,76443,76248,76248,55,8,23,2764,334,3098
"1623",20200430,"WV",1118,43423,NA,84,NA,38,NA,20,NA,545,"C","4/30/2020 10:00","b3f041308d9595d8942efcf15a34821be3cca906","2020-04-30T20:00:00Z",41,NA,44541,44541,44541,54,3,0,1447,23,1470
"1624",20200430,"WY",544,8902,NA,13,56,NA,NA,NA,NA,371,"C","4/29/2020 00:00","55fecc46d8cdc7655047ae40619b3caf77c594df","2020-04-30T20:00:00Z",7,56,9446,9446,9446,56,0,0,221,8,229
"1625",20200429,"AK",355,18764,NA,14,NA,NA,NA,NA,NA,240,"B","4/28/2020 14:50","30e0f53c4a86ec53f7499d31234f683b130e67c7","2020-04-29T20:00:00Z",9,NA,19119,19119,19119,2,0,0,2026,4,2030
"1626",20200429,"AL",6842,73607,NA,NA,945,NA,335,NA,195,NA,"B","4/29/2020 00:00","410d88571d402f7e06aa6b7367a7bc8b549d4a5d","2020-04-29T20:00:00Z",245,945,80449,80449,80449,1,3,34,4467,155,4622
"1627",20200429,"AR",3192,42257,NA,93,389,NA,NA,18,82,1249,"B","4/29/2020 09:00","54d0d2ebc3cf6952f248d4880eb588056d8c6c47","2020-04-29T20:00:00Z",59,389,45449,45449,45449,5,7,389,4697,81,4778
"1628",20200429,"AS",0,3,17,NA,NA,NA,NA,NA,NA,NA,"F","4/19/2020 00:00","cfb9fe44fa861f555308be5fa55379a51e8144f1","2020-04-29T20:00:00Z",0,NA,20,3,3,60,0,0,0,0,0
"1629",20200429,"AZ",7202,61611,NA,756,1131,312,NA,191,NA,1475,"A+","4/29/2020 00:00","8d93f4217cff0f5c588cd12e5f933890c2a0afc1","2020-04-29T20:00:00Z",304,1131,68813,68813,68813,4,11,36,1121,254,1375
"1630",20200429,"CA",46500,556639,NA,5011,NA,1512,NA,NA,NA,NA,"B","4/29/2020 00:00","7a345e3a93b890ed33b23694ee702197a96b45c4","2020-04-29T20:00:00Z",1887,NA,603139,603139,603139,6,78,0,24062,1469,25531
"1631",20200429,"CO",14735,54714,NA,964,2610,NA,NA,NA,NA,2275,"B","4/27/2020 00:00","0ae582ad7de11db18267092dccaaeab990ab0700","2020-04-29T20:00:00Z",760,2610,69449,69449,69449,8,54,125,2252,856,3108
"1632",20200429,"CT",26767,68051,NA,1691,NA,NA,NA,NA,NA,NA,"C","4/29/2020 16:00","180768a68ca3a1d00263762eb469054e767c05ad","2020-04-29T20:00:00Z",2168,NA,94818,94818,94818,9,79,0,1618,455,2073
"1633",20200429,"DC",4106,15123,NA,NA,NA,NA,NA,NA,NA,660,"B","4/29/2020 00:00","9803aadf5d4a0fce87e417681e2eab536354b3e5","2020-04-29T20:00:00Z",205,NA,19229,19229,19229,11,15,0,232,112,344
"1634",20200429,"DE",4655,16883,NA,326,NA,NA,NA,NA,NA,1173,"B","4/28/2020 18:00","9632315edb02771dd52847eb638a3fbeb1d35041","2020-04-29T20:00:00Z",144,NA,21538,21538,21538,10,7,0,278,80,358
"1635",20200429,"FL",33193,340295,1252,NA,5624,NA,NA,NA,NA,NA,"C","4/29/2020 09:51","81356fd9b751e45264092c8c628acc10159c112e","2020-04-29T20:00:00Z",1240,5624,374740,373488,373488,12,86,358,6266,347,6613
"1636",20200429,"GA",25572,118367,NA,NA,5056,NA,1148,NA,NA,NA,"A","4/29/2020 14:25","afb6f52d29f3de5f987ff8d36399bd2a6acf93cc","2020-04-29T20:00:00Z",1093,5056,143939,143939,143939,13,67,242,2962,957,3919
"1637",20200429,"GU",145,1702,NA,NA,NA,NA,NA,NA,NA,130,"D","4/29/2020 09:35","4cc676650965771c90a660369fafa5be25bdcb8f","2020-04-29T20:00:00Z",5,NA,1847,1847,1847,66,0,0,164,0,164
"1638",20200429,"HI",609,29009,NA,NA,69,NA,NA,NA,NA,505,"B","4/28/2020 18:00","16cb30044d14f7f72ca7cb7a6bdaece4f7f4dfb5","2020-04-29T20:00:00Z",16,69,29618,29618,29618,15,0,1,433,2,435
"1639",20200429,"IA",6843,34494,NA,323,NA,100,NA,74,NA,2428,"B","4/28/2020 12:00","141facb078ae879fb609bd95aac14be6ecdac3ff","2020-04-29T20:00:00Z",148,NA,41337,41337,41337,19,12,0,1047,467,1514
"1640",20200429,"ID",1952,26430,NA,NA,173,NA,73,NA,NA,1087,"C","4/28/2020 19:00","984b77089cb1d4ac35c9e15aa4cfcc586d9b719f","2020-04-29T20:00:00Z",60,173,28382,28382,28382,16,2,1,8295,35,8330
"1641",20200429,"IL",50355,206312,NA,5036,NA,1290,NA,777,NA,NA,"A","4/29/2020 00:00","a3820020f97200a72a110be592bf907e12e696ca","2020-04-29T20:00:00Z",2215,NA,256667,256667,256667,17,90,0,12225,2253,14478
"1642",20200429,"IN",17182,74368,NA,1484,NA,570,NA,262,NA,NA,"A","4/28/2020 23:59","e6b223517664a7d500b5779298d8d3dac6709fec","2020-04-29T20:00:00Z",1065,NA,91550,91550,91550,18,164,0,3775,594,4369
"1643",20200429,"KS",3738,25720,NA,NA,515,NA,198,NA,88,266,"A","4/29/2020 10:00","fe5679eb4d87fd0f81fc331441a6c25679ed45a6","2020-04-29T20:00:00Z",125,515,29458,29458,29458,20,1,11,1121,247,1368
"1644",20200429,"KY",4375,48036,NA,320,1331,170,625,NA,NA,1617,"A","4/28/2020 17:00","c06571863871a29854a16bb57c1130be50278dff","2020-04-29T20:00:00Z",225,1331,52411,52411,52411,21,12,50,3383,229,3612
"1645",20200429,"LA",27660,128908,NA,1629,NA,NA,NA,244,NA,17303,"B","4/29/2020 13:00","cc85366d334d4f3d3f8ee44f917949833888e137","2020-04-29T20:00:00Z",1802,NA,156568,156568,156568,22,44,0,5086,374,5460
"1646",20200429,"MA",60265,205353,NA,3856,5758,1011,NA,NA,NA,NA,"A","4/29/2020 16:00","4d4d35a60f188e678f025b499398ae1d7dbf7f33","2020-04-29T20:00:00Z",3405,5758,265618,265618,265618,25,252,243,9155,1963,11118
"1647",20200429,"MD",20849,90080,NA,1610,4402,586,NA,NA,NA,1361,"A","4/29/2020 10:00","614cbd1ee3d73611d56e0725e5a75fc68c50ae13","2020-04-29T20:00:00Z",1078,4402,110929,110929,110929,24,62,134,2408,736,3144
"1648",20200429,"ME",1056,19546,NA,32,166,17,NA,7,NA,615,"B","4/29/2020 12:00","797bca64026f8ea2b1791509fa0d7ce1d31732b5","2020-04-29T20:00:00Z",52,166,20602,20602,20602,23,1,3,2762,16,2778
"1649",20200429,"MI",40399,131953,NA,2498,NA,997,NA,778,NA,8342,"A+","4/29/2020 11:00","1eaed93124b65bc476689005358cdab2a93313cb","2020-04-29T20:00:00Z",3670,NA,172352,172352,172352,26,103,0,6410,1137,7547
"1650",20200429,"MN",4644,62100,NA,320,950,119,337,NA,NA,1724,"A","4/28/2020 17:00","b43362ceafea91f587bb9460653d3c75b02f32b6","2020-04-29T20:00:00Z",319,950,66744,66744,66744,27,18,38,2452,463,2915
"1651",20200429,"MO",7425,69734,NA,891,NA,NA,NA,125,NA,NA,"A","4/29/2020 15:00","8610aa97755b5c16ce4d9ed3a11280bb1b6fab57","2020-04-29T20:00:00Z",318,NA,77159,77159,77159,29,4,0,3534,122,3656
"1652",20200429,"MP",14,210,NA,NA,NA,NA,NA,NA,NA,12,"D","4/29/2020 02:30","3746443d5ab1e99f0b5e4c2fb2525f81a8ab4ca4","2020-04-29T20:00:00Z",2,NA,224,224,224,69,0,0,159,0,159
"1653",20200429,"MS",6569,59525,NA,677,1126,151,NA,69,NA,3413,"B","4/28/2020 19:00","b06a36178522b7a8c539c269cb28674f08d2d244","2020-04-29T20:00:00Z",250,1126,66094,66094,66094,28,11,38,1455,227,1682
"1654",20200429,"MT",451,13077,NA,5,61,NA,NA,NA,NA,382,"C","4/29/2020 00:00","84470951831936bbf425a1d1ddc2d2cfe3941cd4","2020-04-29T20:00:00Z",16,61,13528,13528,13528,30,1,0,337,0,337
"1655",20200429,"NC",9948,108492,NA,551,NA,NA,NA,NA,NA,NA,"B","4/29/2020 11:00","850abe890cb5ce76ed3a2f6f0e8ff80f6f7f53e3","2020-04-29T20:00:00Z",354,NA,118440,118440,118440,37,12,0,5308,380,5688
"1656",20200429,"ND",1033,24503,NA,28,82,NA,NA,NA,NA,437,"C","4/29/2020 13:00","156236728a3a7408da45fe6481a4152f0a1111af","2020-04-29T20:00:00Z",19,82,25536,25536,25536,38,0,3,1771,42,1813
"1657",20200429,"NE",3374,20257,NA,NA,NA,NA,NA,NA,NA,NA,"D","4/28/2020 19:45","9f8c56f4d1a013b98a283dbc99f426826215379f","2020-04-29T20:00:00Z",55,NA,23631,23631,23631,31,0,0,10,16,26
"1658",20200429,"NH",2010,18736,81,106,249,NA,NA,NA,NA,936,"C","4/28/2020 09:00","dc4d776972e971e7e1b47f7d5e8c8ec2d3a47bdc","2020-04-29T20:00:00Z",60,249,20827,20746,20746,33,0,3,529,72,601
"1659",20200429,"NJ",116264,125054,617,6289,NA,1811,NA,1327,NA,15642,"A+","4/29/2020 13:00","6b18cda950077888bff3efbcf3ad0490a6523d1d","2020-04-29T20:00:00Z",6770,NA,241935,241318,241318,34,328,0,4551,2408,6959
"1660",20200429,"NM",2974,58771,NA,157,509,NA,NA,NA,NA,705,"C","4/28/2020 18:00","a8e95e6de8c3b17d8c8102811aba1ce07d5fd869","2020-04-29T20:00:00Z",110,509,61745,61745,61745,35,6,28,2791,151,2942
"1661",20200429,"NV",4898,36130,NA,NA,NA,NA,NA,NA,NA,100,"D","4/29/2020 10:00","f5b1d6c6ab80c1314858a5879f023402b749f10b","2020-04-29T20:00:00Z",230,NA,41028,41028,41028,32,11,0,816,93,909
"1662",20200429,"NY",299691,572790,NA,12159,65397,NA,NA,NA,NA,53238,"B","4/29/2020 00:00","2d3f87579d183c1fb170dbc1bd055d66f213d10f","2020-04-29T20:00:00Z",18015,65397,872481,872481,872481,36,377,1079,22902,4585,27487
"1663",20200429,"OH",17303,111605,NA,NA,3421,NA,1014,NA,NA,NA,"B","4/29/2020 14:00","f4d3ef89b512b121a1a2a900b40806f3f1aab198","2020-04-29T20:00:00Z",937,3421,128908,128908,128908,39,138,81,5027,1175,6202
"1664",20200429,"OK",3473,57794,NA,283,693,126,NA,NA,NA,2319,"A","4/29/2020 00:00","b6bc69ee7b430118f65229024fbf33d3bb1d28b2","2020-04-29T20:00:00Z",214,693,61267,61267,61267,40,7,37,1505,63,1568
"1665",20200429,"OR",2446,52026,NA,227,569,56,NA,24,NA,NA,"A","4/29/2020 11:00","0ba5d677d631054d472b7e6a0b948d4b5c328ffa","2020-04-29T20:00:00Z",101,569,54472,54472,54472,41,9,15,3182,92,3274
"1666",20200429,"PA",44366,170517,NA,2781,NA,NA,NA,602,NA,NA,"B","4/29/2020 00:00","45a6a0075379c47ae6192d08072bb2dfc3c40587","2020-04-29T20:00:00Z",2195,NA,214883,214883,214883,42,479,0,4693,1102,5795
"1667",20200429,"PR",1433,9313,1940,NA,NA,NA,NA,NA,NA,NA,"D","4/29/2020 06:00","f0eef0530d24af14c8134f868a11d30f795a727e","2020-04-29T20:00:00Z",86,NA,12686,10746,10746,72,0,0,0,33,33
"1668",20200429,"RI",8247,51918,NA,269,750,80,NA,55,NA,391,"A+","4/29/2020 00:00","2dc242f37774cfc3ff8ea7e0b7610079b97b33aa","2020-04-29T20:00:00Z",251,750,60165,60165,60165,44,12,18,2151,321,2472
"1669",20200429,"SC",5881,48336,NA,NA,1000,NA,NA,NA,NA,3252,"B","4/29/2020 15:30","1fcc9c253cbe09b571f5d02f0a8a9c38e79183b4","2020-04-29T20:00:00Z",203,1000,54217,54217,54217,45,26,56,1804,268,2072
"1670",20200429,"SD",2373,14460,NA,69,165,NA,NA,NA,NA,1492,"C","4/28/2020 18:00","92334745cc53978a238c8df40537799a13ab4c33","2020-04-29T20:00:00Z",13,165,16833,16833,16833,46,2,8,161,60,221
"1671",20200429,"TN",10366,158183,NA,NA,1013,NA,NA,NA,NA,5140,"B","4/28/2020 15:00","6f6690231febdc3c29ddf0b791a4f61e166a7111","2020-04-29T20:00:00Z",195,1013,168549,168549,168549,47,7,119,6307,314,6621
"1672",20200429,"TX",27054,287736,NA,1702,NA,NA,NA,NA,NA,12507,"B","4/29/2020 13:00","7d17d5ccc8084f33e6993ab03832b02380225e76","2020-04-29T20:00:00Z",732,NA,314790,314790,314790,48,42,0,13523,883,14406
"1673",20200429,"UT",4495,101283,NA,NA,383,NA,NA,NA,NA,1790,"C","4/29/2020 15:00","1e884bebabd7f5f971f3828e61d2b55af3f4aaec","2020-04-29T20:00:00Z",45,383,105778,105778,105778,49,0,13,3187,152,3339
"1674",20200429,"VA",14961,70979,620,1566,3608,387,NA,222,NA,2042,"B","4/29/2020 00:00","f34b2273e2e5935ee18dca35d29a429775d50960","2020-04-29T20:00:00Z",522,3608,86560,85940,85940,51,30,186,2020,622,2642
"1675",20200429,"VI",62,732,78,NA,NA,NA,NA,NA,NA,51,"C","4/28/2020 20:30","8582c9a0358ec96391964e51ee217f66be58c913","2020-04-29T20:00:00Z",4,NA,872,794,794,78,0,0,13,3,16
"1676",20200429,"VT",866,14155,NA,26,NA,NA,NA,NA,NA,NA,"C","4/29/2020 00:00","cd8d281863619efe2a56547ba6fa7877861ea83f","2020-04-29T20:00:00Z",47,NA,15021,15021,15021,50,0,0,208,4,212
"1677",20200429,"WA",15155,193185,NA,490,NA,156,NA,NA,NA,NA,"B","4/29/2020 00:00","b20c7dc814d8d07bfe3683eab86e9492c31907af","2020-04-29T20:00:00Z",786,NA,208340,208340,208340,53,21,0,6246,318,6564
"1678",20200429,"WI",6520,66630,227,577,1489,121,363,NA,NA,NA,"A","4/29/2020 00:00","cb945148137c326981c1d2e4367c315da0fcd014","2020-04-29T20:00:00Z",308,1489,73377,73150,73150,55,8,33,3095,231,3326
"1679",20200429,"WV",1095,41976,NA,102,NA,40,NA,21,NA,504,"C","4/29/2020 10:00","aa960228e30153e73fd12039bfd26e8b57eafcbe","2020-04-29T20:00:00Z",38,NA,43071,43071,43071,54,1,0,0,16,16
"1680",20200429,"WY",536,8681,NA,12,56,NA,NA,NA,NA,362,"C","4/29/2020 00:00","c1fa73a0929520c142e54b1cb83999cd45509a14","2020-04-29T20:00:00Z",7,56,9217,9217,9217,56,0,0,455,147,602
"1681",20200428,"AK",351,16738,NA,16,NA,NA,NA,NA,NA,228,"B","4/28/2020 14:50","f72a9f858da8a3ad531c3878fe7599f21b56447c","2020-04-28T20:00:00Z",9,NA,17089,17089,17089,2,0,0,827,6,833
"1682",20200428,"AL",6687,69140,NA,NA,911,NA,335,NA,195,NA,"B","4/28/2020 00:00","6e80436b03653332acc21abdb595f210e59966b6","2020-04-28T20:00:00Z",242,911,75827,75827,75827,1,20,39,1642,188,1830
"1683",20200428,"AR",3111,37560,NA,104,NA,NA,NA,20,NA,1146,"B","4/28/2020 09:00","2583b472987ea7aa1c2614dbb977aeee0fc70f9a","2020-04-28T20:00:00Z",52,NA,40671,40671,40671,5,2,0,120,94,214
"1684",20200428,"AS",0,3,17,NA,NA,NA,NA,NA,NA,NA,"F","4/19/2020 00:00","bd3e544709c0ecdb2d9a85f8f0fe3566ae5c4755","2020-04-28T20:00:00Z",0,NA,20,3,3,60,0,0,0,0,0
"1685",20200428,"AZ",6948,60490,NA,737,1095,303,NA,193,NA,1450,"A+","4/27/2020 00:00","1b96003d77f9e859165b07135ef22cf45f05a0a9","2020-04-28T20:00:00Z",293,1095,67438,67438,67438,4,18,44,663,232,895
"1686",20200428,"CA",45031,532577,NA,4983,NA,1485,NA,NA,NA,NA,"B","4/27/2020 00:00","478925b117873a198f328034c049b79b99c8ec6d","2020-04-28T20:00:00Z",1809,NA,577608,577608,577608,6,54,0,22632,1567,24199
"1687",20200428,"CO",13879,52462,NA,994,2485,NA,NA,NA,NA,2275,"B","4/26/2020 00:00","793561800a8c1d36008137e04fc07e4a2de23789","2020-04-28T20:00:00Z",706,2485,66341,66341,66341,8,26,47,2629,438,3067
"1688",20200428,"CT",26312,66433,NA,1732,NA,NA,NA,NA,NA,NA,"C","4/28/2020 16:00","31f0080d261e868b86a370ce11dbc78da4ebbc72","2020-04-28T20:00:00Z",2089,NA,92745,92745,92745,9,91,0,11891,1043,12934
"1689",20200428,"DC",3994,14891,NA,NA,NA,NA,NA,NA,NA,660,"B","4/27/2020 00:00","5951b8cc7ad70686c26cf301c0d9ce0b537a39f3","2020-04-28T20:00:00Z",190,NA,18885,18885,18885,11,5,0,367,102,469
"1690",20200428,"DE",4575,16605,NA,337,NA,NA,NA,NA,NA,1096,"B","4/27/2020 18:00","8cd8803861579d5107e63aaa3da792a6233b2160","2020-04-28T20:00:00Z",137,NA,21180,21180,21180,10,12,0,1151,413,1564
"1691",20200428,"FL",32846,334029,1216,NA,5266,NA,NA,NA,NA,NA,"C","4/28/2020 09:36","91426e1052c657c54c9a3d110e5b7b1ee613ab0c","2020-04-28T20:00:00Z",1154,5266,368091,366875,366875,12,53,55,9704,708,10412
"1692",20200428,"GA",24615,115405,NA,NA,4814,NA,1087,NA,NA,NA,"B","4/28/2020 13:25","3eb31a9938f92adfadf168fb13b81adec67bbbd4","2020-04-28T20:00:00Z",1026,4814,140020,140020,140020,13,55,133,12149,702,12851
"1693",20200428,"GU",145,1538,NA,3,NA,NA,NA,NA,NA,129,"D","4/28/2020 09:15","b95671679cbf922d5ba184a13808a5ba7f1d9dc0","2020-04-28T20:00:00Z",5,NA,1683,1683,1683,66,0,0,114,1,115
"1694",20200428,"HI",607,28576,NA,NA,68,NA,NA,NA,NA,493,"C","4/27/2020 18:00","67a94d2657ecc1830e66d515e8a9a8247840372c","2020-04-28T20:00:00Z",16,68,29183,29183,29183,15,2,0,172,1,173
"1695",20200428,"IA",6376,33447,NA,304,NA,98,NA,64,NA,2164,"B","4/27/2020 12:00","318d93838b1ac51dda707172f22575f485385fee","2020-04-28T20:00:00Z",136,NA,39823,39823,39823,19,9,0,1165,508,1673
"1696",20200428,"ID",1917,18135,NA,NA,172,NA,73,NA,NA,1039,"C","4/27/2020 19:00","df5f2b87c062b8c425b886884d464788f697195d","2020-04-28T20:00:00Z",58,172,20052,20052,20052,16,2,3,8,20,28
"1697",20200428,"IL",48102,194087,NA,4738,NA,1245,NA,778,NA,NA,"A","4/28/2020 00:00","7d92f7ceda01feada4a05e2661a854bb7c5b1b0f","2020-04-28T20:00:00Z",2125,NA,242189,242189,242189,17,142,0,12342,2219,14561
"1698",20200428,"IN",16588,70593,NA,1518,NA,546,NA,275,NA,NA,"B","4/27/2020 23:59","1e377adbd97825b77bb73e8a25ea961992c339c2","2020-04-28T20:00:00Z",901,NA,87181,87181,87181,18,57,0,2078,627,2705
"1699",20200428,"KS",3491,24599,NA,NA,504,NA,NA,NA,NA,NA,"C","4/28/2020 10:00","c96251c65cef6359d29830dd92548a4aecf38501","2020-04-28T20:00:00Z",124,504,28090,28090,28090,20,4,8,760,163,923
"1700",20200428,"KY",4146,44653,NA,313,1281,165,612,NA,NA,1521,"A","4/27/2020 17:00","c9a617024cab2af3c3e4f5c071b5cb4c9769557a","2020-04-28T20:00:00Z",213,1281,48799,48799,48799,21,5,7,253,72,325
"1701",20200428,"LA",27286,123822,NA,1666,NA,NA,NA,244,NA,17303,"B","4/28/2020 13:00","7658c301aabeb4206a1b3943ded2e46cb66b93cc","2020-04-28T20:00:00Z",1758,NA,151108,151108,151108,22,61,0,3901,218,4119
"1702",20200428,"MA",58302,196198,NA,3875,5515,1005,NA,NA,NA,NA,"B","4/28/2020 16:00","57a44ae2a16048d73f271414ec949f95397751a0","2020-04-28T20:00:00Z",3153,5515,254500,254500,254500,25,150,278,7773,1840,9613
"1703",20200428,"MD",20113,87672,NA,1528,4268,551,NA,NA,NA,1295,"A","4/28/2020 10:00","f565989c4734d1a8f4f9d6c365098494ced879f7","2020-04-28T20:00:00Z",1016,4268,107785,107785,107785,24,71,167,2183,626,2809
"1704",20200428,"ME",1040,16784,NA,33,163,17,NA,7,NA,585,"B","4/28/2020 11:45","fbcd2a5be3b8520d727c90b50d360b0a4b94d0c2","2020-04-28T20:00:00Z",51,163,17824,17824,17824,23,0,2,0,17,17
"1705",20200428,"MI",39262,125543,NA,2623,NA,1027,NA,801,NA,8342,"A+","4/28/2020 11:00","b84979a5e070dc307b5943c039063b7972e7c889","2020-04-28T20:00:00Z",3567,NA,164805,164805,164805,26,160,0,5993,1052,7045
"1706",20200428,"MN",4181,59648,NA,314,912,120,324,NA,NA,1611,"A","4/27/2020 17:00","2765133a2e855c9f4dd60c6b415b3fa8c9898979","2020-04-28T20:00:00Z",301,912,63829,63829,63829,27,15,51,2196,365,2561
"1707",20200428,"MO",7303,66200,NA,655,NA,NA,NA,105,NA,NA,"B","4/28/2020 15:00","f91d9393b7dc28a6d0b0e003c77e18d636021307","2020-04-28T20:00:00Z",314,NA,73503,73503,73503,29,26,0,2265,132,2397
"1708",20200428,"MP",14,51,NA,NA,NA,NA,NA,NA,NA,12,"D","4/28/2020 00:00","1a9f5f05a2d88229862c13a0ff9198af538dcfc0","2020-04-28T20:00:00Z",2,NA,65,65,65,69,0,0,0,0,0
"1709",20200428,"MS",6342,58070,NA,639,1088,162,NA,77,NA,NA,"B","4/27/2020 19:00","b9c4e11052e310ffc6eb2fba0471ee2434c30bff","2020-04-28T20:00:00Z",239,1088,64412,64412,64412,28,10,28,702,248,950
"1710",20200428,"MT",451,12740,NA,10,61,NA,NA,NA,NA,356,"C","4/28/2020 00:00","86f2b476f4981c120142250e3b8cadd853fb2f94","2020-04-28T20:00:00Z",15,61,13191,13191,13191,30,1,0,156,2,158
"1711",20200428,"NC",9568,103184,NA,463,NA,NA,NA,NA,NA,NA,"B","4/28/2020 11:00","92472bbae66c5dda9088675a85e04ec090b096b0","2020-04-28T20:00:00Z",342,NA,112752,112752,112752,37,36,0,2406,426,2832
"1712",20200428,"ND",991,22732,NA,25,79,NA,NA,NA,NA,409,"C","4/28/2020 13:00","3b899f51655795d2c5817cbc98767a6254846f57","2020-04-28T20:00:00Z",19,79,23723,23723,23723,38,0,2,1240,49,1289
"1713",20200428,"NE",3358,20247,NA,NA,NA,NA,NA,NA,NA,NA,"D","4/27/2020 19:45","c61ed3fe4906118a1073a0bc179686af276a20d1","2020-04-28T20:00:00Z",55,NA,23605,23605,23605,31,-1,0,912,330,1242
"1714",20200428,"NH",1938,18207,223,99,246,NA,NA,NA,NA,798,"C","4/27/2020 09:00","39869125d3e8f7ff52811e1ddee12042b8181486","2020-04-28T20:00:00Z",60,246,20368,20145,20145,33,0,4,347,74,421
"1715",20200428,"NJ",113856,120503,NA,6476,NA,1809,NA,1262,NA,15642,"A+","4/28/2020 13:00","f25f4ed36ca442a4c43a5360e7fe5985bae17fba","2020-04-28T20:00:00Z",6442,NA,234359,234359,234359,34,398,0,3916,2668,6584
"1716",20200428,"NM",2823,55980,NA,155,481,NA,NA,NA,NA,666,"C","4/27/2020 18:04","3137562ab6d93e2f60b39dfb0cc373bcfd64332a","2020-04-28T20:00:00Z",104,481,58803,58803,58803,35,5,69,2091,97,2188
"1717",20200428,"NV",4805,35314,NA,NA,NA,NA,NA,NA,NA,NA,"F","4/28/2020 10:00","cebcabe4c94cfec60d2a4a826a06ed7033df6573","2020-04-28T20:00:00Z",219,NA,40119,40119,40119,32,13,0,1191,115,1306
"1718",20200428,"NY",295106,549888,NA,12645,64318,NA,NA,NA,NA,51673,"B","4/28/2020 00:00","4d41e4e4ab0e18c4bd5a7b73cba1e8cd3bd45cd7","2020-04-28T20:00:00Z",17638,64318,844994,844994,844994,36,335,748,15789,3110,18899
"1719",20200428,"OH",16128,106578,NA,NA,3340,NA,1004,NA,NA,NA,"B","4/28/2020 14:00","af6494aa5297754f15437e9938a44a4d5dfd2744","2020-04-28T20:00:00Z",799,3340,122706,122706,122706,39,46,108,2886,429,3315
"1720",20200428,"OK",3410,56289,NA,288,656,118,NA,NA,NA,2260,"A","4/28/2020 00:00","7b8fca66bf26cbd7938a59cd75a6ed3f211ffd97","2020-04-28T20:00:00Z",207,656,59699,59699,59699,40,10,0,6398,130,6528
"1721",20200428,"OR",2354,48844,NA,249,554,71,NA,31,NA,NA,"B","4/27/2020 11:00","975d629f7d489958d8f5c0fbbad6f133f0a2377a","2020-04-28T20:00:00Z",92,554,51198,51198,51198,41,0,0,0,0,0
"1722",20200428,"PA",43264,165824,NA,2781,NA,NA,NA,616,NA,NA,"B","4/28/2020 00:00","f811945572c641bdaf4ebcd2870a333c0beb8a45","2020-04-28T20:00:00Z",1716,NA,209088,209088,209088,42,119,0,4452,1214,5666
"1723",20200428,"PR",1400,9313,1940,NA,NA,NA,NA,NA,NA,NA,"D","4/28/2020 06:30","637eb58d1688ac31798d4050ff695a985ef84510","2020-04-28T20:00:00Z",86,NA,12653,10713,10713,72,2,0,0,11,11
"1724",20200428,"RI",7926,49767,NA,266,732,84,NA,55,NA,466,"A+","4/28/2020 00:00","baa5b45b6668f88e2586655f76b3a65597f477f0","2020-04-28T20:00:00Z",239,732,57693,57693,57693,44,6,14,1590,218,1808
"1725",20200428,"SC",5613,46532,NA,NA,944,NA,NA,NA,NA,2830,"B","4/27/2020 16:30","8612f696e380990e756d91a66f7cd37bff4f41f4","2020-04-28T20:00:00Z",177,944,52145,52145,52145,45,3,0,1261,123,1384
"1726",20200428,"SD",2313,14299,NA,69,157,NA,NA,NA,NA,1392,"C","4/27/2020 18:00","50107de0934aea54a97d291ea9f21d70150fdc8f","2020-04-28T20:00:00Z",11,157,16612,16612,16612,46,0,7,169,68,237
"1727",20200428,"TN",10052,151876,NA,NA,894,NA,NA,NA,NA,4921,"B","4/28/2020 15:00","d80a2665013880eddb424f1e4c3038c1fc3888c2","2020-04-28T20:00:00Z",188,894,161928,161928,161928,47,4,57,7392,134,7526
"1728",20200428,"TX",26171,274213,NA,1682,NA,NA,NA,NA,NA,11786,"B","4/28/2020 13:00","2593f001bb55c0370b076f6a6bafcb8e88a02d1c","2020-04-28T20:00:00Z",690,NA,300384,300384,300384,48,27,0,8993,874,9867
"1729",20200428,"UT",4343,98096,NA,NA,370,NA,NA,NA,NA,1704,"C","4/28/2020 15:00","e7707887ca27628920261ab7e669b48d44f49ca3","2020-04-28T20:00:00Z",45,370,102439,102439,102439,49,4,21,2134,110,2244
"1730",20200428,"VA",14339,68959,560,1508,3422,376,NA,217,NA,1914,"B","4/27/2020 17:00","e0223aaa34684856cf8949ac7fbedb68eba52f52","2020-04-28T20:00:00Z",492,3422,83858,83298,83298,51,34,124,1815,804,2619
"1731",20200428,"VI",59,719,57,NA,NA,NA,NA,NA,NA,51,"D","4/27/2020 00:00","256b92a959d4deb33953316182889df376b93d25","2020-04-28T20:00:00Z",4,NA,835,778,778,78,0,0,3,0,3
"1732",20200428,"VT",862,13947,NA,29,NA,NA,NA,NA,NA,NA,"C","4/28/2020 00:00","3956e125b5662cee3e98a9682e9192ca2de1a393","2020-04-28T20:00:00Z",47,NA,14809,14809,14809,50,0,0,128,0,128
"1733",20200428,"WA",14837,186939,NA,436,NA,158,NA,NA,NA,NA,"B","4/28/2020 00:00","e9592f9cce85a51c19b991864fee99db1b327588","2020-04-28T20:00:00Z",765,NA,201776,201776,201776,53,16,0,6463,280,6743
"1734",20200428,"WI",6289,63535,193,544,1456,123,363,NA,NA,NA,"A","4/28/2020 16:00","ebdbd94cbca038257307191c0eeb04110562792c","2020-04-28T20:00:00Z",300,1456,70017,69824,69824,55,19,41,2224,208,2432
"1735",20200428,"WV",1079,41976,NA,87,NA,28,NA,15,NA,481,"B","4/28/2020 10:00","7364000017e275bd2733c2d318a11bbe1d035e37","2020-04-28T20:00:00Z",37,NA,43055,43055,43055,54,1,0,0,16,16
"1736",20200428,"WY",389,8226,NA,16,56,NA,NA,NA,NA,343,"C","4/27/2020 17:05","32fd1e90fd2b78819993ee6a4b36ad7e6336aea8","2020-04-28T20:00:00Z",7,56,8615,8615,8615,56,0,2,429,19,448
"1737",20200427,"AK",345,15911,NA,10,NA,NA,NA,NA,NA,218,"B","4/27/2020 14:00","ab6f56eba38b18bcc3341eb287c25d592ea68221","2020-04-27T20:00:00Z",9,NA,16256,16256,16256,2,0,0,75,4,79
"1738",20200427,"AL",6499,67498,NA,NA,872,NA,335,NA,195,NA,"B","4/27/2020 00:00","49ba2fb8808f98fd06f2360780cfc6e3d8114b98","2020-04-27T20:00:00Z",222,872,73997,73997,73997,1,6,27,217,229,446
"1739",20200427,"AR",3017,37440,NA,109,NA,NA,NA,25,NA,987,"B","4/27/2020 15:00","dce758e653f27f19342ba3825057e9f5478a9df1","2020-04-27T20:00:00Z",50,NA,40457,40457,40457,5,1,0,912,76,988
"1740",20200427,"AS",0,3,17,NA,NA,NA,NA,NA,NA,NA,"F","4/19/2020 00:00","ebceb244ccfbf625faa066632fcdd5d7f29bc771","2020-04-27T20:00:00Z",0,NA,20,3,3,60,0,0,0,0,0
"1741",20200427,"AZ",6716,59827,NA,647,1051,328,NA,200,NA,1418,"A+","4/27/2020 00:00","7489872122608a89b314a96765267aa7e407c7ed","2020-04-27T20:00:00Z",275,1051,66543,66543,66543,4,0,14,1542,190,1732
"1742",20200427,"CA",43464,509945,NA,4878,NA,1499,NA,NA,NA,NA,"B","4/27/2020 00:00","b1b0155f48709638589ad99f4d07c55fca0a3df5","2020-04-27T20:00:00Z",1755,NA,553409,553409,553409,6,45,0,26025,1300,27325
"1743",20200427,"CO",13441,49833,NA,1007,2438,NA,NA,NA,NA,2150,"B","4/25/2020 00:00","b5fa9e78da34e3bd4849338fe732374f4fe12712","2020-04-27T20:00:00Z",680,2438,63274,63274,63274,8,8,28,3010,473,3483
"1744",20200427,"CT",25269,54542,NA,1758,NA,NA,NA,NA,NA,NA,"C","4/27/2020 16:27","f4a6ec8077a1d07c3ade574b8d0045a4931e7bc4","2020-04-27T20:00:00Z",1998,NA,79811,79811,79811,9,74,0,0,0,0
"1745",20200427,"DC",3892,14524,NA,402,NA,NA,NA,NA,NA,659,"B","4/26/2020 00:00","e6b252c745b17caf678e2e59fcd07f73651d7d89","2020-04-27T20:00:00Z",185,NA,18416,18416,18416,11,7,0,297,51,348
"1746",20200427,"DE",4162,15454,NA,325,NA,NA,NA,NA,NA,996,"B","4/26/2020 18:00","7c0c9f3006c8b512f7a87253cfa6d7e070d9d89a","2020-04-27T20:00:00Z",125,NA,19616,19616,19616,10,5,0,239,128,367
"1747",20200427,"FL",32138,324325,1099,NA,5211,NA,NA,NA,NA,NA,"C","4/27/2020 09:24","eb1119517a71b9f39d65a5a34dafb0d44f34fd49","2020-04-27T20:00:00Z",1101,5211,357562,356463,356463,12,7,56,11240,610,11850
"1748",20200427,"GA",23913,103256,NA,NA,4681,NA,1057,NA,NA,NA,"B","4/27/2020 11:27","0b82dc3da58580f56a1b2647cd08a26187d5f923","2020-04-27T20:00:00Z",971,4681,127169,127169,127169,13,59,322,3434,512,3946
"1749",20200427,"GU",144,1424,NA,3,NA,NA,NA,NA,NA,128,"D","4/27/2020 07:20","2dc9a261ba95591176bb67c89d5d7fec877fccc3","2020-04-27T20:00:00Z",5,NA,1568,1568,1568,66,0,0,37,3,40
"1750",20200427,"HI",606,28404,NA,NA,68,NA,NA,NA,NA,488,"C","4/26/2020 18:00","45abf37754b3a5dffb72a5a7c7b7020ae5f80b24","2020-04-27T20:00:00Z",14,68,29010,29010,29010,15,0,0,524,3,527
"1751",20200427,"IA",5868,32282,NA,300,NA,100,NA,58,NA,2021,"B","4/25/2020 12:00","387caee8d3c8cc763e5e4a14bc8e83180b58bf16","2020-04-27T20:00:00Z",127,NA,38150,38150,38150,19,9,0,1668,392,2060
"1752",20200427,"ID",1897,18127,NA,NA,169,NA,71,NA,NA,983,"C","4/26/2020 19:00","15114c96ff1ca63913d5114f966a6a4d7f790983","2020-04-27T20:00:00Z",56,169,20024,20024,20024,16,0,0,516,10,526
"1753",20200427,"IL",45883,181745,NA,4672,NA,1249,NA,763,NA,NA,"A","4/27/2020 00:00","e8d34a183eff93424946852aacef72a146df70c0","2020-04-27T20:00:00Z",1983,NA,227628,227628,227628,17,50,0,10696,1980,12676
"1754",20200427,"IN",15961,68515,NA,1493,NA,581,NA,284,NA,NA,"B","4/26/2020 23:59","2b107c01dadcfbf22816c5a3faa3f5a20a4aa267","2020-04-27T20:00:00Z",844,NA,84476,84476,84476,18,31,0,1819,949,2768
"1755",20200427,"KS",3328,23839,NA,NA,496,NA,NA,NA,NA,NA,"C","4/26/2020 11:00","53a2430f9d6221057685156e56cfa9b29ea9d725","2020-04-27T20:00:00Z",120,496,27167,27167,27167,20,2,11,786,154,940
"1756",20200427,"KY",4074,44400,NA,308,1274,166,608,NA,NA,1511,"A","4/26/2020 17:00","bfde663eda37d669e7d9ba1eb67b43fde2f4a6c1","2020-04-27T20:00:00Z",208,1274,48474,48474,48474,21,3,8,1747,169,1916
"1757",20200427,"LA",27068,119921,NA,1683,NA,NA,NA,262,NA,17303,"B","4/27/2020 13:00","73cc56a93adf3be56864c8b48206b5399898529e","2020-04-27T20:00:00Z",1697,NA,146989,146989,146989,22,27,0,3658,295,3953
"1758",20200427,"MA",56462,188425,NA,3892,5237,1089,NA,NA,NA,NA,"B","4/27/2020 16:00","fb18ae5a100535fb7ee61c53b6423cd43613f1d9","2020-04-27T20:00:00Z",3003,5237,244887,244887,244887,25,104,133,7263,1524,8787
"1759",20200427,"MD",19487,85489,NA,1513,4101,535,NA,NA,NA,1263,"A","4/27/2020 10:00","b73a7a706bf12620657b80b6afde0cee3128e02f","2020-04-27T20:00:00Z",945,4101,104976,104976,104976,24,35,139,7405,906,8311
"1760",20200427,"ME",1023,16784,NA,39,161,16,NA,7,NA,549,"B","4/27/2020 11:15","fef5dd04756543794c11d0acd7f45db7c409fa41","2020-04-27T20:00:00Z",51,161,17807,17807,17807,23,1,2,0,8,8
"1761",20200427,"MI",38210,119550,NA,2667,NA,1059,NA,832,NA,8342,"A+","4/27/2020 11:00","dec324880d5323c316ea1e785a28e18c56bb1b6a","2020-04-27T20:00:00Z",3407,NA,157760,157760,157760,26,92,0,6322,432,6754
"1762",20200427,"MN",3816,57452,NA,292,861,122,316,NA,NA,1556,"A","4/26/2020 17:00","057bb569f80b1d9ec9a17586d374e757533183e3","2020-04-27T20:00:00Z",286,861,61268,61268,61268,27,14,32,2067,214,2281
"1763",20200427,"MO",7171,63935,NA,679,NA,NA,NA,109,NA,NA,"B","4/27/2020 15:00","eafa29e3b6343ea6102706b1d36bf5e594909c41","2020-04-27T20:00:00Z",288,NA,71106,71106,71106,29,14,0,1184,174,1358
"1764",20200427,"MP",14,51,NA,NA,NA,NA,NA,NA,NA,11,"D","4/27/2020 00:00","d33319cc0c917cf64d655bb8654ce9bf02e9b4a1","2020-04-27T20:00:00Z",2,NA,65,65,65,69,0,0,0,0,0
"1765",20200427,"MS",6094,57368,NA,590,1060,142,NA,71,NA,NA,"B","4/26/2020 19:00","578126a119e5c74556d9be8eb706ba157fb4db2e","2020-04-27T20:00:00Z",229,1060,63462,63462,63462,28,2,59,2491,183,2674
"1766",20200427,"MT",449,12584,NA,11,61,NA,NA,NA,NA,352,"C","4/27/2020 00:00","4a1f2762f9240a017c2311cabf8d4ac86b37e66c","2020-04-27T20:00:00Z",14,61,13033,13033,13033,30,0,0,170,1,171
"1767",20200427,"NC",9142,100778,NA,473,NA,NA,NA,NA,NA,NA,"B","4/27/2020 10:20","0807ba3c14d6e11d839eec0eb2eebd7618fb86ea","2020-04-27T20:00:00Z",306,NA,109920,109920,109920,37,7,0,1714,312,2026
"1768",20200427,"ND",942,21492,NA,23,77,NA,NA,NA,NA,350,"C","4/27/2020 13:00","5c52b8288bf66fd5f5072095b5180a09e85d1468","2020-04-27T20:00:00Z",19,77,22434,22434,22434,38,2,6,1642,75,1717
"1769",20200427,"NE",3028,19335,NA,NA,NA,NA,NA,NA,NA,NA,"D","4/26/2020 19:45","8914914a0bc0de8a9c58080c8d47e30f51ff3ed4","2020-04-27T20:00:00Z",56,NA,22363,22363,22363,31,3,0,839,296,1135
"1770",20200427,"NH",1864,17860,270,101,242,NA,NA,NA,NA,779,"C","4/26/2020 09:00","9b35756d7c5b2e599e4f7e64f52108d8c98a6e19","2020-04-27T20:00:00Z",60,242,19994,19724,19724,33,0,4,896,77,973
"1771",20200427,"NJ",111188,116587,NA,6407,NA,1801,NA,1303,NA,NA,"A","4/26/2020 11:00","704e9323b878b2df6db0823fc632101b88cae418","2020-04-27T20:00:00Z",6044,NA,227775,227775,227775,34,106,0,2481,2150,4631
"1772",20200427,"NM",2726,53889,NA,148,412,NA,NA,NA,NA,650,"C","4/26/2020 18:01","e714ae8df918ace6971c3fba0dd1c100669f8e54","2020-04-27T20:00:00Z",99,412,56615,56615,56615,35,6,0,2814,66,2880
"1773",20200427,"NV",4690,34123,NA,NA,NA,NA,NA,NA,NA,NA,"F","4/27/2020 10:00","9018e40618c5d0a50a53a84027eb5c7826214236","2020-04-27T20:00:00Z",206,NA,38813,38813,38813,32,0,0,539,88,627
"1774",20200427,"NY",291996,534099,NA,12819,63570,NA,NA,NA,NA,50751,"B","4/27/2020 00:00","e621daf236a826a05dc95cfe924c35dd3884df10","2020-04-27T20:00:00Z",17303,63570,826095,826095,826095,36,337,1044,16794,3951,20745
"1775",20200427,"OH",15699,103692,NA,NA,3232,NA,978,NA,NA,NA,"B","4/27/2020 14:00","6ea2bcb1f783f2ebf94b4c4e16ca1452358ebbf8","2020-04-27T20:00:00Z",753,3232,119391,119391,119391,39,25,54,3269,-264,3005
"1776",20200427,"OK",3280,49891,NA,306,656,150,NA,NA,NA,2167,"A","4/27/2020 00:00","ff89cc50daee75852767d41a04b6d94bbee733a2","2020-04-27T20:00:00Z",197,656,53171,53171,53171,40,2,3,0,27,27
"1777",20200427,"OR",2354,48844,NA,249,554,71,NA,31,NA,NA,"B","4/27/2020 11:00","fc5f62088c26c2b10f541913c441307b868c9ea3","2020-04-27T20:00:00Z",92,554,51198,51198,51198,41,1,8,2191,43,2234
"1778",20200427,"PA",42050,161372,NA,2800,NA,NA,NA,629,NA,NA,"B","4/27/2020 12:00","92d39ffc2dfac4117f9f8cfaeffe635abc400174","2020-04-27T20:00:00Z",1597,NA,203422,203422,203422,42,47,0,3944,885,4829
"1779",20200427,"PR",1389,9313,1940,NA,NA,NA,NA,NA,NA,NA,"D","4/27/2020 06:00","d5049f94e056131d76cd97012700969fa8b77035","2020-04-27T20:00:00Z",84,NA,12642,10702,10702,72,0,0,0,18,18
"1780",20200427,"RI",7708,48177,NA,266,718,81,NA,56,NA,452,"A+","4/27/2020 00:00","666db3886a7c98e76c33227742708546eed642c8","2020-04-27T20:00:00Z",233,718,55885,55885,55885,44,7,27,2213,269,2482
"1781",20200427,"SC",5490,45271,NA,NA,944,NA,NA,NA,NA,3701,"B","4/26/2020 15:30","df361784e562bc68884111e99f5f2faa4e2a272c","2020-04-27T20:00:00Z",174,944,50761,50761,50761,45,0,0,0,0,0
"1782",20200427,"SD",2245,14130,NA,61,150,NA,NA,NA,NA,1316,"C","4/26/2020 18:00","e02d7ff19b7d8df322ebad547d788d1cbf7b204c","2020-04-27T20:00:00Z",11,150,16375,16375,16375,46,0,15,68,33,101
"1783",20200427,"TN",9918,144484,NA,NA,837,NA,NA,NA,NA,4720,"B","4/27/2020 15:00","63282b3d508ae3ed46da50f1f1096c5e9f5011b8","2020-04-27T20:00:00Z",184,837,154402,154402,154402,47,3,9,6677,251,6928
"1784",20200427,"TX",25297,265220,NA,1563,NA,NA,NA,NA,NA,11170,"B","4/27/2020 13:10","71e0a846ca395cb44d760afda797d76a58c2e3b6","2020-04-27T20:00:00Z",663,NA,290517,290517,290517,48,15,0,13830,666,14496
"1785",20200427,"UT",4233,95962,NA,NA,349,NA,NA,NA,NA,1641,"C","4/27/2020 15:00","1e55f271d9dda64f90be344064c40abb35d1892e","2020-04-27T20:00:00Z",41,349,100195,100195,100195,49,0,4,4383,110,4493
"1786",20200427,"VA",13535,67144,542,1455,3298,389,NA,217,NA,1843,"B","4/27/2020 00:00","7a56898bef7129127db55002d636c8093d3f4e25","2020-04-27T20:00:00Z",458,3298,81221,80679,80679,51,10,1284,3514,565,4079
"1787",20200427,"VI",59,716,5,NA,NA,NA,NA,NA,NA,51,"D","4/26/2020 00:00","0d67c46a3e9f235ea3e072cb9cbed8c4c45e8a72","2020-04-27T20:00:00Z",4,NA,780,775,775,78,0,0,16,2,18
"1788",20200427,"VT",862,13819,NA,33,NA,NA,NA,NA,NA,NA,"C","4/27/2020 00:00","7cf193548a4be0863f44225e8d7027488d5e9910","2020-04-27T20:00:00Z",47,NA,14681,14681,14681,50,1,0,301,7,308
"1789",20200427,"WA",14557,180476,NA,536,NA,115,NA,NA,NA,NA,"B","4/27/2020 00:00","5ebcc693d2b522926b214a518dcfd97e3d1101e3","2020-04-27T20:00:00Z",749,NA,195033,195033,195033,53,11,0,6600,353,6953
"1790",20200427,"WI",6081,61311,204,337,1415,124,355,NA,NA,NA,"A","4/27/2020 16:00","64457017e0711d8850db8d377af8379686e83b6a","2020-04-27T20:00:00Z",281,1415,67596,67392,67392,55,9,18,2076,170,2246
"1791",20200427,"WV",1063,41976,NA,100,NA,38,NA,20,NA,455,"B","4/27/2020 10:00","2d3df91e2ec20c6037da629decf047dc927d14ab","2020-04-27T20:00:00Z",36,NA,43039,43039,43039,54,2,0,3957,19,3976
"1792",20200427,"WY",370,7797,NA,16,54,NA,NA,NA,NA,342,"C","4/26/2020 13:58","b0656b07fd36d968f45aaa525a29fbabde94a283","2020-04-27T20:00:00Z",7,54,8167,8167,8167,56,0,0,0,8,8
"1793",20200426,"AK",341,15836,NA,14,NA,NA,NA,NA,NA,217,"B","4/26/2020 14:15","6ab39d2fb1ad164eea6affb92618298dbc12ec44","2020-04-26T20:00:00Z",9,NA,16177,16177,16177,2,0,0,443,2,445
"1794",20200426,"AL",6270,67281,NA,NA,845,NA,288,NA,170,NA,"B","4/26/2020 00:00","ed9e3ee360ef06edeecadca62135cb70d5ae7912","2020-04-26T20:00:00Z",216,845,73551,73551,73551,1,4,6,2074,133,2207
"1795",20200426,"AR",2941,36528,NA,104,291,NA,NA,25,57,985,"B","4/26/2020 10:00","7c51b6bf39bd410bbd059f354066029e902ff7fd","2020-04-26T20:00:00Z",49,291,39469,39469,39469,5,2,0,1304,112,1416
"1796",20200426,"AS",0,3,17,NA,NA,NA,NA,NA,NA,NA,"F","4/19/2020 00:00","334e80fba6f5a0cd329ee24e0dc587dc60182997","2020-04-26T20:00:00Z",0,NA,20,3,3,60,0,0,0,0,0
"1797",20200426,"AZ",6526,58285,NA,671,1037,308,NA,200,NA,1383,"A+","4/26/2020 00:00","32cd8f42b9b3f32ea2a0ff4c62cc460439796098","2020-04-26T20:00:00Z",275,1037,64811,64811,64811,4,9,15,2057,246,2303
"1798",20200426,"CA",42164,483920,NA,4928,NA,1473,NA,NA,NA,NA,"B","4/25/2020 00:00","b0772bea60b2d5bc5065af016fdbf08514b9dcbf","2020-04-26T20:00:00Z",1710,NA,526084,526084,526084,6,59,0,19022,1027,20049
"1799",20200426,"CO",12968,46823,NA,1046,2410,NA,NA,NA,NA,2150,"B","4/24/2020 00:00","9d457e955bae2d92d5bb2c7f411e8d2bd88edf60","2020-04-26T20:00:00Z",672,2410,59791,59791,59791,8,-2,44,2290,712,3002
"1800",20200426,"CT",25269,54542,NA,1766,NA,NA,NA,NA,NA,NA,"C","4/26/2020 16:00","bbd0be3d6ad3c54f60bdb25b13a88098ca461e8d","2020-04-26T20:00:00Z",1924,NA,79811,79811,79811,9,62,0,1522,687,2209
"1801",20200426,"DC",3841,14227,NA,402,NA,120,NA,69,NA,657,"B","4/25/2020 00:00","26b6797faf44f1e75d80bbcdc7ebc01e585e4d9a","2020-04-26T20:00:00Z",178,NA,18068,18068,18068,11,13,0,624,142,766
"1802",20200426,"DE",4034,15215,NA,317,NA,NA,NA,NA,NA,911,"B","4/25/2020 18:00","752ca8e42f55771aa973d3896d1fb0c89663f169","2020-04-26T20:00:00Z",120,NA,19249,19249,19249,10,8,0,1093,458,1551
"1803",20200426,"FL",31528,313085,1183,NA,5155,NA,NA,NA,NA,NA,"C","4/26/2020 09:32","10b942ef8949681fad3306cf36898e014d15bb08","2020-04-26T20:00:00Z",1094,5155,345796,344613,344613,12,19,110,10825,689,11514
"1804",20200426,"GA",23401,99822,NA,NA,4359,NA,NA,NA,NA,NA,"B","4/26/2020 11:28","570e23bc54d896e24e41e2caeba47760dc9741d1","2020-04-26T20:00:00Z",912,4359,123223,123223,123223,13,8,33,3503,706,4209
"1805",20200426,"GU",141,1387,NA,2,NA,NA,NA,NA,NA,128,"D","4/26/2020 07:30","bf2fb37d24f393de1115b19b6ddbf380b2af9a59","2020-04-26T20:00:00Z",5,NA,1528,1528,1528,66,0,0,79,0,79
"1806",20200426,"HI",603,27880,NA,NA,68,NA,NA,NA,NA,482,"C","4/25/2020 18:00","ed680e03c2bd651440953436c70b8b3cdd6f2fa6","2020-04-26T20:00:00Z",14,68,28483,28483,28483,15,1,1,441,2,443
"1807",20200426,"IA",5476,30614,NA,286,NA,99,NA,55,NA,1900,"B","4/25/2020 12:00","0a8128bb79fcd85376592bc6c570a15367a4d433","2020-04-26T20:00:00Z",118,NA,36090,36090,36090,19,6,0,1356,384,1740
"1808",20200426,"ID",1887,17611,NA,NA,169,NA,72,NA,NA,938,"C","4/25/2020 19:00","bc92464668298a733bd259a0f3917a382c43c04a","2020-04-26T20:00:00Z",56,169,19498,19498,19498,16,2,1,0,17,17
"1809",20200426,"IL",43903,171049,NA,4595,NA,1267,NA,772,NA,NA,"A","4/26/2020 00:00","c0e75f2f23875d29bbb33d7770607140f886abbd","2020-04-26T20:00:00Z",1933,NA,214952,214952,214952,17,59,0,11209,2126,13335
"1810",20200426,"IN",15012,66696,NA,1446,NA,589,NA,310,NA,NA,"B","4/25/2020 23:59","88b158f5e73d75db240945f2809c7d4c57b7688e","2020-04-26T20:00:00Z",813,NA,81708,81708,81708,18,28,0,1317,617,1934
"1811",20200426,"KS",3174,23053,NA,NA,485,NA,NA,NA,NA,NA,"C","4/26/2020 11:00","060dcb99cea0b0671a55dd1370e6bf4b1334cd17","2020-04-26T20:00:00Z",118,485,26227,26227,26227,20,1,11,910,118,1028
"1812",20200426,"KY",3905,42653,NA,301,1266,164,605,NA,NA,1501,"A","4/25/2020 17:00","06996037449a479364019c20b5f639a6cb2bdf09","2020-04-26T20:00:00Z",205,1266,46558,46558,46558,21,5,123,1470,126,1596
"1813",20200426,"LA",26773,116263,NA,1701,NA,NA,NA,265,NA,14927,"B","4/26/2020 13:00","4d28d1dd8d41f2f22d82a4fdd2cfe3e671a56a8a","2020-04-26T20:00:00Z",1670,NA,143036,143036,143036,22,26,0,3773,261,4034
"1814",20200426,"MA",54938,181162,NA,3879,5104,1077,NA,NA,NA,NA,"B","4/26/2020 16:00","cfb119d1a92fa393b14a3cfaff062c3c549b4cbf","2020-04-26T20:00:00Z",2899,5104,236100,236100,236100,25,22,139,7665,1590,9255
"1815",20200426,"MD",18581,78084,NA,1463,3962,530,NA,NA,NA,1177,"A","4/26/2020 10:00","40a280451cc65d41dd97406b392dea4617c58b86","2020-04-26T20:00:00Z",910,3962,96665,96665,96665,24,35,202,6727,815,7542
"1816",20200426,"ME",1015,16784,NA,39,159,19,NA,7,NA,532,"B","4/26/2020 10:30","08dc607fddc37dbd8a8c7fc0227e5bcaa5e14648","2020-04-26T20:00:00Z",50,159,17799,17799,17799,23,0,3,0,25,25
"1817",20200426,"MI",37778,113228,NA,2757,NA,1099,NA,871,NA,8342,"A+","4/26/2020 11:00","d341cf05b932d50502e809574980705057eaab82","2020-04-26T20:00:00Z",3315,NA,151006,151006,151006,26,41,0,6387,575,6962
"1818",20200426,"MN",3602,55385,NA,285,829,115,301,NA,NA,1502,"A","4/26/2020 12:00","83131cc7391f8a31ce64f544be092aa9e56a1133","2020-04-26T20:00:00Z",272,829,58987,58987,58987,27,28,32,2234,156,2390
"1819",20200426,"MO",6997,62751,NA,679,NA,NA,NA,109,NA,NA,"B","4/26/2020 15:00","c5eb46e4afbbd1369bbc58eceb0c4be60b287582","2020-04-26T20:00:00Z",274,NA,69748,69748,69748,29,1,0,2359,171,2530
"1820",20200426,"MP",14,51,NA,NA,NA,NA,NA,NA,NA,11,"D","4/26/2020 00:00","2d145adb826225c104c52ae5912b85d1b6867c65","2020-04-26T20:00:00Z",2,NA,65,65,65,69,0,0,0,0,0
"1821",20200426,"MS",5911,54877,NA,644,1001,146,NA,67,NA,NA,"B","4/25/2020 00:00","0315479b31f5a6c36818eadc52066adc2db6bc81","2020-04-26T20:00:00Z",227,1001,60788,60788,60788,28,6,5,1638,193,1831
"1822",20200426,"MT",448,12414,NA,11,61,NA,NA,NA,NA,339,"C","4/26/2020 00:00","4c3994f126d35404816d9846b4aa9a6a89a9a266","2020-04-26T20:00:00Z",14,61,12862,12862,12862,30,0,0,362,3,365
"1823",20200426,"NC",8830,99064,NA,451,NA,NA,NA,NA,NA,NA,"B","4/26/2020 11:00","b6fe23e4c582b0130ebc7c5929d51ee111b315df","2020-04-26T20:00:00Z",299,NA,107894,107894,107894,37,10,0,2422,207,2629
"1824",20200426,"ND",867,19850,NA,18,71,NA,NA,NA,NA,326,"C","4/26/2020 13:00","75b8a2cc2498153ff856ba77ceac6d59d9567269","2020-04-26T20:00:00Z",17,71,20717,20717,20717,38,1,1,1303,64,1367
"1825",20200426,"NE",2732,18496,NA,NA,NA,NA,NA,NA,NA,NA,"D","4/25/2020 19:45","e66b79878ed81532842baeb6708bd451e96dba0e","2020-04-26T20:00:00Z",53,NA,21228,21228,21228,31,3,0,944,311,1255
"1826",20200426,"NH",1787,16964,550,95,238,NA,NA,NA,NA,777,"C","4/25/2020 09:00","c54ecaa5bd31ee9c09d9372631983a3e4d31d0f3","2020-04-26T20:00:00Z",60,238,19301,18751,18751,33,7,14,957,67,1024
"1827",20200426,"NJ",109038,114106,NA,6573,NA,1804,NA,1418,NA,NA,"A","4/26/2020 11:00","1c63b0609288fa1eb9a7cd646ab50f7489efc757","2020-04-26T20:00:00Z",5938,NA,223144,223144,223144,34,75,0,5943,3515,9458
"1828",20200426,"NM",2660,51075,NA,152,412,NA,NA,NA,NA,614,"C","4/25/2020 20:24","f2cb2065af2d8f2be86756cb51e564a738b34ad8","2020-04-26T20:00:00Z",93,412,53735,53735,53735,35,9,0,2086,139,2225
"1829",20200426,"NV",4602,33584,NA,NA,NA,NA,NA,NA,NA,NA,"F","4/26/2020 12:00","3d6bea067e7771df1922abbfcda4904c23ec6fd0","2020-04-26T20:00:00Z",206,NA,38186,38186,38186,32,2,0,915,63,978
"1830",20200426,"NY",288045,517305,NA,12839,62526,5016,NA,NA,NA,49687,"B","4/26/2020 00:00","e6a2c02a9afad5aeb5175c2dd206e33740c6ff47","2020-04-26T20:00:00Z",16966,62526,805350,805350,805350,36,367,1067,21880,5902,27782
"1831",20200426,"OH",15963,100423,NA,NA,3178,NA,952,NA,NA,NA,"B","4/26/2020 14:00","8114364a8aaff1e2dce0670c5690873730a994bf","2020-04-26T20:00:00Z",728,3178,116386,116386,116386,39,17,63,4027,376,4403
"1832",20200426,"OK",3253,49891,NA,306,653,150,NA,NA,NA,2139,"A","4/26/2020 00:00","6124531242734b864ee98ee8b00d3d1c255f6836","2020-04-26T20:00:00Z",195,653,53144,53144,53144,40,1,16,0,60,60
"1833",20200426,"OR",2311,46653,NA,249,546,71,NA,31,NA,NA,"B","4/26/2020 11:00","191022916550c0fa24bafccf5031087733585a92","2020-04-26T20:00:00Z",91,546,48964,48964,48964,41,4,10,1529,58,1587
"1834",20200426,"PA",41165,157428,NA,2736,NA,NA,NA,632,NA,NA,"B","4/26/2020 12:00","9b0a74eab5ea2b6f84716d7ae836d4dfe47b624a","2020-04-26T20:00:00Z",1550,NA,198593,198593,198593,42,13,0,4542,1116,5658
"1835",20200426,"PR",1371,9313,1940,NA,NA,NA,NA,NA,NA,NA,"D","4/26/2020 06:00","6f760e2f5cad4c6d5d9d08e8d528e69f526d95b1","2020-04-26T20:00:00Z",84,NA,12624,10684,10684,72,1,0,0,64,64
"1836",20200426,"RI",7439,45964,NA,258,691,78,NA,53,NA,433,"A+","4/26/2020 00:00","0ffe9c59fe3084420b3207d8b07840ec1fbdaa44","2020-04-26T20:00:00Z",226,691,53403,53403,53403,44,11,115,2202,310,2512
"1837",20200426,"SC",5490,45271,NA,NA,944,NA,NA,NA,NA,3701,"B","4/26/2020 15:30","be81461758c41202ae7ae8dd2d1de6083490ecd1","2020-04-26T20:00:00Z",174,944,50761,50761,50761,45,8,0,1510,237,1747
"1838",20200426,"SD",2212,14062,NA,64,135,NA,NA,NA,NA,1257,"C","4/25/2020 18:00","c4b0777f6334fd1068e029b6add015ab9ad3b256","2020-04-26T20:00:00Z",11,135,16274,16274,16274,46,1,7,613,65,678
"1839",20200426,"TN",9667,137807,NA,NA,828,NA,NA,NA,NA,4527,"B","4/26/2020 15:00","8208eaca9e2873360d632137b1952494512b4c1a","2020-04-26T20:00:00Z",181,828,147474,147474,147474,47,3,7,5590,478,6068
"1840",20200426,"TX",24631,251390,NA,1542,NA,NA,NA,NA,NA,10763,"B","4/26/2020 12:40","29637f963b5add57304a3f09d8c2c27cd12a343c","2020-04-26T20:00:00Z",648,NA,276021,276021,276021,48,25,0,12347,858,13205
"1841",20200426,"UT",4123,91579,NA,NA,345,NA,NA,NA,NA,1568,"C","4/26/2020 15:00","c706eeadc34418fcad78ceccceb6f4156f6cdadf","2020-04-26T20:00:00Z",41,345,95702,95702,95702,49,0,16,5321,175,5496
"1842",20200426,"VA",12970,63630,539,1436,2014,387,NA,217,NA,1815,"B","4/26/2020 00:00","fe5fb68831ba847c96c01e83ceec58bc8b052645","2020-04-26T20:00:00Z",448,2014,77139,76600,76600,51,12,72,3354,604,3958
"1843",20200426,"VI",57,700,19,NA,NA,NA,NA,NA,NA,51,"D","4/26/2020 00:00","306166f17cc29821aa78951ef80c88f954e591c5","2020-04-26T20:00:00Z",4,NA,776,757,757,78,1,0,7,2,9
"1844",20200426,"VT",855,13518,NA,34,NA,NA,NA,NA,NA,NA,"C","4/26/2020 00:00","acbd90a3972fffc0789e72378173d1290836c75e","2020-04-26T20:00:00Z",46,NA,14373,14373,14373,50,0,0,248,3,251
"1845",20200426,"WA",14204,173876,NA,508,NA,145,NA,NA,NA,NA,"B","4/26/2020 00:00","41749a023849282e8c8158c4a1fa42f8ac385380","2020-04-26T20:00:00Z",738,NA,188080,188080,188080,53,73,0,1586,106,1692
"1846",20200426,"WI",5911,59235,197,337,1397,136,353,NA,NA,NA,"A","4/26/2020 16:00","267f5981f565558feb6a91f98f843a3867ce4b22","2020-04-26T20:00:00Z",272,1397,65343,65146,65146,55,6,21,2097,224,2321
"1847",20200426,"WV",1044,38019,NA,100,NA,38,NA,20,NA,455,"B","4/26/2020 10:00","d8bc5cb9e0ddd4f8a407ef8adbbfa4a0d7316498","2020-04-26T20:00:00Z",34,NA,39063,39063,39063,54,2,0,6073,24,6097
"1848",20200426,"WY",362,7797,NA,16,54,NA,NA,NA,NA,334,"C","4/25/2020 17:20","d3f5a6d52704662f7d178c0b35d38fa954af2ea3","2020-04-26T20:00:00Z",7,54,8159,8159,8159,56,0,0,0,13,13
"1849",20200425,"AK",339,15393,NA,32,NA,NA,NA,NA,NA,217,"B","4/25/2020 16:00","38b933181a960ab000b1b46afb87de5047a9ba49","2020-04-25T20:00:00Z",9,NA,15732,15732,15732,2,0,0,3451,0,3451
"1850",20200425,"AL",6137,65207,NA,NA,839,NA,288,NA,170,NA,"B","4/25/2020 00:00","bb87dd4e1e46e49d21a95aac64f980307176d49f","2020-04-25T20:00:00Z",212,839,71344,71344,71344,1,15,71,18344,305,18649
"1851",20200425,"AR",2829,35224,NA,104,291,NA,NA,25,57,964,"B","4/25/2020 10:47","5015b17230e8d8937c262729f44aab9d0741c616","2020-04-25T20:00:00Z",47,291,38053,38053,38053,5,2,0,2387,88,2475
"1852",20200425,"AS",0,3,17,NA,NA,NA,NA,NA,NA,NA,"F","4/19/2020 00:00","abc3a1eb49566dda33ec1fb9a469cddb9f6acda8","2020-04-25T20:00:00Z",0,NA,20,3,3,60,0,0,0,0,0
"1853",20200425,"AZ",6280,56228,NA,697,1022,313,NA,191,NA,1345,"A+","4/25/2020 00:00","87bbc454eb5decc324bfda524aaf2cdb918fda26","2020-04-25T20:00:00Z",266,1022,62508,62508,62508,4,0,38,1559,235,1794
"1854",20200425,"CA",41137,464898,NA,4847,NA,1458,NA,NA,NA,NA,"B","4/23/2020 00:00","fabe51c7f8b1824b84e560ffeccfc891b69bd4a0","2020-04-25T20:00:00Z",1651,NA,506035,506035,506035,6,89,0,9979,1883,11862
"1855",20200425,"CO",12256,44533,NA,1084,2366,NA,NA,NA,NA,2086,"B","4/23/2020 00:00","18d628774ac050948f4a44bf8324e784edf2d65f","2020-04-25T20:00:00Z",674,2366,56789,56789,56789,8,122,129,3471,994,4465
"1856",20200425,"CT",24582,53020,NA,1810,NA,NA,NA,NA,NA,NA,"C","4/25/2020 16:00","30385634fbca61b84eb9ba3c6c7ac09945c7e683","2020-04-25T20:00:00Z",1862,NA,77602,77602,77602,9,98,0,2903,661,3564
"1857",20200425,"DC",3699,13603,NA,402,NA,120,NA,69,NA,652,"B","4/24/2020 00:00","0897a99d04e176582295650179dd7b14c9190657","2020-04-25T20:00:00Z",165,NA,17302,17302,17302,11,12,0,598,171,769
"1858",20200425,"DE",3576,14122,NA,300,NA,NA,NA,NA,NA,809,"B","4/24/2020 18:00","ff456c12e8e3e7e03217295431b6ff3d9b1f1105","2020-04-25T20:00:00Z",112,NA,17698,17698,17698,10,12,0,185,134,319
"1859",20200425,"FL",30839,302260,1292,NA,5045,NA,NA,NA,NA,NA,"C","4/25/2020 09:36","2b945d84f36d4519e6f5cf87ffdf186f3a14cc0b","2020-04-25T20:00:00Z",1075,5045,334391,333099,333099,12,44,157,15475,665,16140
"1860",20200425,"GA",22695,96319,NA,NA,4326,NA,NA,NA,NA,NA,"B","4/25/2020 11:28","8712d16a3b343d12e1b348312e6a57cd92c09262","2020-04-25T20:00:00Z",904,4326,119014,119014,119014,13,12,105,11290,548,11838
"1861",20200425,"GU",141,1308,NA,2,NA,NA,NA,NA,NA,128,"D","4/25/2020 07:30","ea7b856b532dccebbd36cdea4ea4efc8a12af606","2020-04-25T20:00:00Z",5,NA,1449,1449,1449,66,0,0,75,0,75
"1862",20200425,"HI",601,27439,NA,NA,67,NA,NA,NA,NA,463,"C","4/24/2020 18:00","1b65aaf7d8cd7df16eb153c59e780a7060013f20","2020-04-25T20:00:00Z",13,67,28040,28040,28040,15,1,4,1148,5,1153
"1863",20200425,"IA",5092,29258,NA,293,NA,108,NA,60,NA,1723,"B","4/24/2020 12:00","f057b47e7fbc315a3071cd6450ac96041d3a939a","2020-04-25T20:00:00Z",112,NA,34350,34350,34350,19,5,0,1730,647,2377
"1864",20200425,"ID",1870,17611,NA,NA,168,NA,71,NA,NA,867,"C","4/24/2020 19:00","a82d32bf6d3a07a53667117ec4ba00c81e7bee45","2020-04-25T20:00:00Z",54,168,19481,19481,19481,16,0,2,0,34,34
"1865",20200425,"IL",41777,159840,NA,4699,NA,1244,NA,763,NA,NA,"A","4/25/2020 00:00","f0bb33f2593fce78bb7b1ad1dbb3f76a4b8f1e99","2020-04-25T20:00:00Z",1874,NA,201617,201617,201617,17,79,0,9866,2119,11985
"1866",20200425,"IN",14395,65379,NA,1515,NA,598,NA,324,NA,NA,"B","4/24/2020 23:59","89c8bc59c0f8a9af3e7c62cd8a4d35c1eb69866c","2020-04-25T20:00:00Z",785,NA,79774,79774,79774,18,44,0,3506,715,4221
"1867",20200425,"KS",3056,22143,NA,NA,474,NA,NA,NA,NA,NA,"C","4/25/2020 11:00","30dae57b4cc358992e1c4d1920ee30bdaa2f8faa","2020-04-25T20:00:00Z",117,474,25199,25199,25199,20,6,17,1332,279,1611
"1868",20200425,"KY",3779,41183,NA,303,1143,164,575,NA,NA,1341,"A","4/24/2020 17:00","3d4dcfc4f1268839fd39641e3bf01766f50052b6","2020-04-25T20:00:00Z",200,1143,44962,44962,44962,21,9,28,1820,298,2118
"1869",20200425,"LA",26512,112490,NA,1700,NA,NA,NA,268,NA,14927,"B","4/25/2020 13:00","ece985b725dc43e92e028c17a874aa4ce4b9ab8a","2020-04-25T20:00:00Z",1644,NA,139002,139002,139002,22,43,0,518,372,890
"1870",20200425,"MA",53348,173497,NA,3879,4965,1058,NA,NA,NA,NA,"B","4/25/2020 16:00","9a3326f2aeee57bdb3495bfb650239ad688f0878","2020-04-25T20:00:00Z",2877,4965,226845,226845,226845,25,0,213,9253,2379,11632
"1871",20200425,"MD",17766,71357,NA,1408,3760,538,NA,NA,NA,1165,"A","4/25/2020 10:00","669090633c8833dc5b83f490f51ecc904a53e4b8","2020-04-25T20:00:00Z",875,3760,89123,89123,89123,24,77,142,3257,1150,4407
"1872",20200425,"ME",990,16784,NA,39,156,17,NA,7,NA,519,"B","4/25/2020 12:00","d6c979d6301b0873a399119fdee024cfc9a050b1","2020-04-25T20:00:00Z",50,156,17774,17774,17774,23,3,4,0,25,25
"1873",20200425,"MI",37203,106841,NA,2889,NA,1164,NA,934,NA,8342,"A+","4/25/2020 11:00","3185415f7bb7846ba5ae333ae79da04e8df2e02f","2020-04-25T20:00:00Z",3274,NA,144044,144044,144044,26,189,0,7186,562,7748
"1874",20200425,"MN",3446,53151,NA,288,797,109,291,NA,NA,1410,"A","4/24/2020 17:00","6c06e1fddecba4a5e25ab5005cb3454b7b57cd8d","2020-04-25T20:00:00Z",244,797,56597,56597,56597,27,23,41,2549,261,2810
"1875",20200425,"MO",6826,60392,NA,850,NA,NA,NA,142,NA,NA,"B","4/25/2020 15:00","55c393c1bf82cc4c3086f5d319d138b90138a62f","2020-04-25T20:00:00Z",273,NA,67218,67218,67218,29,11,0,1810,201,2011
"1876",20200425,"MP",14,51,NA,NA,NA,NA,NA,NA,NA,11,"D","4/25/2020 00:00","7dcb3f05f839f2b63e1f4d441f3440405b303eda","2020-04-25T20:00:00Z",2,NA,65,65,65,69,0,0,0,0,0
"1877",20200425,"MS",5718,53239,NA,649,996,152,NA,78,NA,NA,"B","4/24/2020 19:00","94427f34942b359d9242573bfcee466a876818fc","2020-04-25T20:00:00Z",221,996,58957,58957,58957,28,12,26,3003,284,3287
"1878",20200425,"MT",445,12052,NA,11,61,NA,NA,NA,NA,339,"C","4/25/2020 00:00","0cbc0b356c4f761431ce993232ed00c339efa9b4","2020-04-25T20:00:00Z",14,61,12497,12497,12497,30,0,2,369,1,370
"1879",20200425,"NC",8623,96642,NA,456,NA,NA,NA,NA,NA,NA,"B","4/25/2020 11:00","d990298ad058e5ebd91fcf9041789c609c2a946d","2020-04-25T20:00:00Z",289,NA,105265,105265,105265,37,20,0,4110,571,4681
"1880",20200425,"ND",803,18547,NA,17,70,NA,NA,NA,NA,310,"C","4/25/2020 13:00","6209dc62a4f26ee6994f531e1d922e500799308a","2020-04-25T20:00:00Z",16,70,19350,19350,19350,38,1,3,1846,55,1901
"1881",20200425,"NE",2421,17552,NA,NA,NA,NA,NA,NA,NA,NA,"D","4/24/2020 19:45","831fd32ad42849803c66060509567bdbc90f0215","2020-04-25T20:00:00Z",50,NA,19973,19973,19973,31,3,0,1064,297,1361
"1882",20200425,"NH",1720,16007,398,89,224,NA,NA,NA,NA,578,"C","4/24/2020 09:00","fc0faba5112f18b65462472b4f0027743deab9a0","2020-04-25T20:00:00Z",53,224,18125,17727,17727,33,2,6,868,50,918
"1883",20200425,"NJ",105523,108163,NA,6722,NA,1971,NA,1442,NA,NA,"A","4/25/2020 13:00","1e36ec66cf93392632c933f972877f7ff93f5866","2020-04-25T20:00:00Z",5863,NA,213686,213686,213686,34,246,0,4397,3327,7724
"1884",20200425,"NM",2521,48989,NA,152,412,NA,NA,NA,NA,614,"C","4/25/2020 13:59","7da7e24acccad186164d98c655a28e8ded6a1b5f","2020-04-25T20:00:00Z",84,412,51510,51510,51510,35,6,45,4805,142,4947
"1885",20200425,"NV",4539,32669,NA,NA,NA,NA,NA,NA,NA,NA,"F","4/25/2020 10:00","5fad93958c425ca0f1d75753315a96328403cc82","2020-04-25T20:00:00Z",204,NA,37208,37208,37208,32,7,0,875,141,1016
"1886",20200425,"NY",282143,495425,NA,13524,61459,5016,NA,NA,NA,47935,"B","4/25/2020 00:00","567bdc8704e75f2a6fa3063f208f9968b394a6b7","2020-04-25T20:00:00Z",16599,61459,777568,777568,777568,36,437,1045,36359,10553,46912
"1887",20200425,"OH",15587,96396,NA,NA,3115,NA,938,NA,NA,NA,"B","4/25/2020 14:00","df484b3236d9468905fa45a5d22ccc5d302ce58f","2020-04-25T20:00:00Z",711,3115,111983,111983,111983,39,21,62,3868,418,4286
"1888",20200425,"OK",3193,49891,NA,306,637,150,NA,NA,NA,2080,"A","4/25/2020 00:00","49e14226dbdbc9d804fc5dedadbc942b71d9699e","2020-04-25T20:00:00Z",194,637,53084,53084,53084,40,6,0,6872,72,6944
"1889",20200425,"OR",2253,45124,NA,261,536,60,NA,29,NA,NA,"B","4/25/2020 11:00","385950bcf85d021e679d1c8f1d6bd8f9949180c0","2020-04-25T20:00:00Z",87,536,47377,47377,47377,41,1,16,1809,76,1885
"1890",20200425,"PA",40049,152886,NA,2748,NA,NA,NA,640,NA,NA,"B","4/25/2020 00:00","02e636e6d2ebaae9b9f830e2644f0d16fd318c63","2020-04-25T20:00:00Z",1537,NA,192935,192935,192935,42,45,0,5395,1397,6792
"1891",20200425,"PR",1307,9313,1940,NA,NA,NA,NA,NA,NA,NA,"D","4/25/2020 06:30","4defc2e3dc4d3270610e351c7acefa8559ede228","2020-04-25T20:00:00Z",83,NA,12560,10620,10620,72,6,0,0,31,31
"1892",20200425,"RI",7129,43762,NA,263,576,77,NA,52,NA,410,"A+","4/25/2020 00:00","4e00c7d1195bc4c3ca7f656d84d201c7e44f7fc5","2020-04-25T20:00:00Z",215,576,50891,50891,50891,44,13,0,3204,430,3634
"1893",20200425,"SC",5253,43761,NA,NA,944,NA,NA,NA,NA,3701,"B","4/25/2020 15:39","4b6861dc007fc2cad1d97db9f288cb9f4b3bf7d8","2020-04-25T20:00:00Z",166,944,49014,49014,49014,45,16,107,4215,336,4551
"1894",20200425,"SD",2147,13449,NA,61,128,NA,NA,NA,NA,1223,"C","4/24/2020 18:00","f1da231855c6255d7f368c6612ea3a97e5060965","2020-04-25T20:00:00Z",10,128,15596,15596,15596,46,0,4,665,107,772
"1895",20200425,"TN",9189,132217,NA,NA,821,NA,NA,NA,NA,4467,"B","4/25/2020 15:00","a68c7799182ce2b2fd692f9f2541ed972d57b52c","2020-04-25T20:00:00Z",178,821,141406,141406,141406,47,10,13,9615,463,10078
"1896",20200425,"TX",23773,239043,NA,1597,NA,NA,NA,NA,NA,9986,"B","4/25/2020 13:00","c5cb5223ee422958c90d30c1bda432e9d722f5f7","2020-04-25T20:00:00Z",623,NA,262816,262816,262816,48,30,0,19302,967,20269
"1897",20200425,"UT",3948,86258,NA,NA,329,NA,NA,NA,NA,1399,"C","4/25/2020 15:00","1799c232ff0cd485c0a4c410352ac8e1558e90af","2020-04-25T20:00:00Z",41,329,90206,90206,90206,49,2,14,5343,166,5509
"1898",20200425,"VA",12366,60276,1405,1405,1942,357,NA,223,NA,1717,"B","4/25/2020 00:00","e76621fb6568ee874c3df8adca7e4413f199dfb8","2020-04-25T20:00:00Z",436,1942,74047,72642,72642,51,26,105,2430,772,3202
"1899",20200425,"VI",55,693,22,NA,NA,NA,NA,NA,NA,51,"D","4/25/2020 00:00","9284943497a7e4cd7f169d8d1282ea04d8dbca2a","2020-04-25T20:00:00Z",3,NA,770,748,748,78,0,0,51,1,52
"1900",20200425,"VT",852,13270,NA,37,NA,NA,NA,NA,NA,NA,"C","4/25/2020 00:00","657b317e164eafcca90eab53e342c16082f5236a","2020-04-25T20:00:00Z",46,NA,14122,14122,14122,50,2,0,462,9,471
"1901",20200425,"WA",14098,172290,NA,455,NA,174,NA,NA,NA,NA,"B","4/25/2020 00:00","44cabbc30933aafc8a24d568a900dce132729e9f","2020-04-25T20:00:00Z",665,NA,186388,186388,186388,53,6,0,3194,165,3359
"1902",20200425,"WI",5687,57138,241,337,1376,136,353,NA,NA,NA,"A","4/25/2020 16:00","f6c5215d36c5be4a09ab6149951c30bc7b81e948","2020-04-25T20:00:00Z",266,1376,63066,62825,62825,55,4,23,2565,331,2896
"1903",20200425,"WV",1020,31946,NA,97,NA,36,NA,19,NA,439,"B","4/25/2020 10:00","6c9b9c748a317cff5ebe473f437f35265a06bbeb","2020-04-25T20:00:00Z",32,NA,32966,32966,32966,54,0,0,3123,32,3155
"1904",20200425,"WY",349,7797,NA,16,54,NA,NA,NA,NA,321,"C","4/24/2020 16:02","1982bff02e7c5ff3fe7494a750b2904b79d96bd3","2020-04-25T20:00:00Z",7,54,8146,8146,8146,56,0,0,101,0,101
"1905",20200424,"AK",339,11942,NA,36,NA,NA,NA,NA,NA,208,"A","4/24/2020 15:00","51edc21bea12880f24b5e8ebe30a60da5735a1f4","2020-04-24T20:00:00Z",9,NA,12281,12281,12281,2,0,0,118,2,120
"1906",20200424,"AL",5832,46863,NA,NA,768,NA,288,NA,170,NA,"B","4/24/2020 00:00","46d122fe5572e0c5a7dc5c4827493441be92ccc1","2020-04-24T20:00:00Z",197,768,52695,52695,52695,1,0,0,0,54,54
"1907",20200424,"AR",2741,32837,NA,101,291,NA,NA,24,57,929,"A","4/24/2020 10:47","84ab202b87bb4e4d793bf81068f41eb14fcfdbf2","2020-04-24T20:00:00Z",45,291,35578,35578,35578,5,0,0,3712,276,3988
"1908",20200424,"AS",0,3,17,NA,NA,NA,NA,NA,NA,NA,"","4/19/2020 00:00","1eb7a7f0f9beb8cba417471c20acec923682dd7b","2020-04-24T20:00:00Z",NA,NA,20,3,3,60,0,0,0,0,0
"1909",20200424,"AZ",6045,54669,NA,639,984,332,NA,186,NA,1313,"B","4/24/2020 00:00","430dcec1d3c925eac7989af58b2bde4705f2df76","2020-04-24T20:00:00Z",266,984,60714,60714,60714,4,17,984,1741,276,2017
"1910",20200424,"CA",39254,454919,NA,4880,NA,1521,NA,NA,NA,NA,"B","4/23/2020 00:00","51dad047074e4b5f3986c734c4b42ccf8e6cc95c","2020-04-24T20:00:00Z",1562,NA,494173,494173,494173,6,93,0,10191,1885,12076
"1911",20200424,"CO",11262,41062,NA,1084,2237,NA,NA,NA,NA,NA,"A","4/22/2020 00:00","8041bb95704faba79ef0d94470327d58da7adad7","2020-04-24T20:00:00Z",552,2237,52324,52324,52324,8,44,114,1295,384,1679
"1912",20200424,"CT",23921,50117,NA,1877,NA,NA,NA,NA,NA,NA,"A","4/24/2020 16:00","a3f7c322eb0ef5ae771256a53efd9dc35078a825","2020-04-24T20:00:00Z",1764,NA,74038,74038,74038,9,125,0,1720,821,2541
"1913",20200424,"DC",3528,13005,NA,402,NA,120,NA,69,NA,651,"A","4/23/2020 00:00","2752115dc5abb5a0a228b65bdbdb2f0336912c29","2020-04-24T20:00:00Z",153,NA,16533,16533,16533,11,14,0,436,167,603
"1914",20200424,"DE",3442,13937,NA,277,NA,NA,NA,NA,NA,703,"A","4/23/2020 18:00","20f20bbe9b68306b6857af6bdd0212d8be45aaa1","2020-04-24T20:00:00Z",100,NA,17379,17379,17379,10,8,0,333,134,467
"1915",20200424,"FL",30174,286785,1287,NA,4888,NA,NA,NA,NA,NA,"A","4/24/2020 16:39","10cf9bad112657e5025495aa9ad30feb665248b3","2020-04-24T20:00:00Z",1031,4888,318246,316959,316959,12,52,195,18909,1342,20251
"1916",20200424,"GA",22147,85029,NA,NA,4221,NA,NA,NA,NA,NA,"A","4/24/2020 18:28","4a6768849a7ea2f6d44407477a77f7791e6e33ed","2020-04-24T20:00:00Z",892,4221,107176,107176,107176,13,20,152,5479,635,6114
"1917",20200424,"GU",141,1233,NA,2,NA,NA,NA,NA,NA,126,"","4/24/2020 07:40","a955776efdefa9cfbb7377e8495555d03ba227c5","2020-04-24T20:00:00Z",5,NA,1374,1374,1374,66,0,0,53,6,59
"1918",20200424,"HI",596,26291,NA,NA,63,NA,NA,NA,NA,455,"A","4/24/2020 18:00","260d612cdcab2293bbbde13c7eccabeea80269fc","2020-04-24T20:00:00Z",12,63,26887,26887,26887,15,0,0,755,4,759
"1919",20200424,"IA",4445,27528,NA,278,NA,104,NA,60,NA,1604,"A","4/23/2020 12:00","2416bb6ac33b65171d664e43e6c27e36483e80b4","2020-04-24T20:00:00Z",107,NA,31973,31973,31973,19,11,0,2190,521,2711
"1920",20200424,"ID",1836,17611,NA,NA,166,NA,63,NA,NA,822,"A","4/24/2020 19:00","3e3ec8d869830fb907ad5ace621c4c30e60152a8","2020-04-24T20:00:00Z",54,166,19447,19447,19447,16,0,4,241,34,275
"1921",20200424,"IL",39658,149974,NA,4828,NA,1225,NA,709,NA,NA,"A","4/24/2020 00:00","450b2c8cec73886a10c5af8e20cef93f1d1aaf7c","2020-04-24T20:00:00Z",1795,NA,189632,189632,189632,17,107,0,13592,2724,16316
"1922",20200424,"IN",13680,61873,NA,NA,NA,621,NA,325,NA,NA,"B","4/23/2020 23:59","82db7e0b77148236e60f15915caf238597ca48d0","2020-04-24T20:00:00Z",741,NA,75553,75553,75553,18,35,0,2872,641,3513
"1923",20200424,"KS",2777,20811,NA,NA,457,NA,NA,NA,NA,NA,"B","4/24/2020 10:00","b5d41c46f1adc26776bb44875802e8b7cba23c36","2020-04-24T20:00:00Z",111,457,23588,23588,23588,20,-1,15,1975,295,2270
"1924",20200424,"KY",3481,39363,NA,302,1115,163,570,NA,NA,1335,"A","4/24/2020 17:00","5575526767b02839b26689b98c2648024c8a12fe","2020-04-24T20:00:00Z",191,1115,42844,42844,42844,21,6,10,6661,108,6769
"1925",20200424,"LA",26140,111972,NA,1697,NA,NA,NA,286,NA,14927,"A","4/24/2020 13:00","b3f2d2af35a4820068aedfc9150b4547437d7d2a","2020-04-24T20:00:00Z",1601,NA,138112,138112,138112,22,61,0,198,401,599
"1926",20200424,"MA",50969,164244,NA,3847,4752,1034,NA,NA,NA,NA,"B","4/24/2020 12:00","8e1f31feed42d831c493c743a7f6c89283468373","2020-04-24T20:00:00Z",2877,4752,215213,215213,215213,25,108,259,7920,2977,10897
"1927",20200424,"MD",16616,68100,NA,1425,3618,547,NA,NA,NA,1108,"A","4/24/2020 10:00","968879e8fb197066eb97203a0dab89ef84532217","2020-04-24T20:00:00Z",798,3618,84716,84716,84716,24,50,141,3737,879,4616
"1928",20200424,"ME",965,16784,NA,39,152,17,NA,7,NA,499,"A","4/24/2020 12:00","fdc863695510b65dceb83215cd27654150d86ef6","2020-04-24T20:00:00Z",47,152,17749,17749,17749,23,3,2,0,28,28
"1929",20200424,"MI",36641,99655,NA,3022,NA,1176,NA,965,NA,3237,"B","4/24/2020 11:00","d676f31a2582055ccdff24b4107bb1c72802d63b","2020-04-24T20:00:00Z",3085,NA,136296,136296,136296,26,108,0,6625,1350,7975
"1930",20200424,"MN",3185,50602,NA,278,756,111,281,NA,NA,1373,"A","4/23/2020 17:00","df101e18cc2867626879d8c7949dfdc003a2e79c","2020-04-24T20:00:00Z",221,756,53787,53787,53787,27,21,44,1996,243,2239
"1931",20200424,"MO",6625,58582,NA,877,NA,NA,NA,NA,NA,NA,"A","4/24/2020 00:00","e607f056b5209622e3757fbb0148db1a6076abc6","2020-04-24T20:00:00Z",262,NA,65207,65207,65207,29,44,0,5453,304,5757
"1932",20200424,"MP",14,51,NA,NA,NA,NA,NA,NA,NA,11,"","4/24/2020 00:00","faec6e446507afc43917cd52b2dd9065d2f150ad","2020-04-24T20:00:00Z",2,NA,65,65,65,69,0,0,0,0,0
"1933",20200424,"MS",5434,50236,NA,586,970,148,NA,74,NA,NA,"A","4/23/2020 19:00","bff6b5663bc794f79a1969d64edcb5cbd639181f","2020-04-24T20:00:00Z",209,970,55670,55670,55670,28,8,24,0,281,281
"1934",20200424,"MT",444,11683,NA,12,59,NA,NA,NA,NA,325,"A","4/24/2020 00:00","c749ab04061eb7b5477cf1c33811038e4146e99c","2020-04-24T20:00:00Z",14,59,12127,12127,12127,30,0,0,250,2,252
"1935",20200424,"NC",8052,92532,NA,477,NA,NA,NA,NA,NA,NA,"A","4/24/2020 11:00","9400d89043eeed758e17a48dd99586e61681c11f","2020-04-24T20:00:00Z",269,NA,100584,100584,100584,37,16,0,3955,444,4399
"1936",20200424,"ND",748,16701,NA,17,67,NA,NA,NA,NA,285,"B","4/24/2020 13:00","1b5c86957d68cb55c7141d4181de11c268c121b0","2020-04-24T20:00:00Z",15,67,17449,17449,17449,38,0,2,1080,39,1119
"1937",20200424,"NE",2124,16488,NA,NA,NA,NA,NA,NA,NA,NA,"A","4/24/2020 19:45","000007641434292a415d60540bdbf88e872c5a39","2020-04-24T20:00:00Z",47,NA,18612,18612,18612,31,2,0,941,311,1252
"1938",20200424,"NH",1670,15139,424,92,218,NA,NA,NA,NA,551,"B","4/23/2020 09:00","4c3bcda332bf87dd3982c864e3bc1ffbe2b4fb02","2020-04-24T20:00:00Z",51,218,17233,16809,16809,33,3,5,715,82,797
"1939",20200424,"NJ",102196,103766,NA,6847,NA,1933,NA,1487,NA,NA,"A","4/24/2020 13:00","5cf816a5d9c737ac77f520ebd1133b3d38426760","2020-04-24T20:00:00Z",5617,NA,205962,205962,205962,34,249,0,3607,2207,5814
"1940",20200424,"NM",2379,44184,NA,123,367,NA,NA,NA,NA,573,"A","4/24/2020 20:17","12a464d81eaba556c65b981789026c5ddc87b2e4","2020-04-24T20:00:00Z",78,367,46563,46563,46563,35,7,36,5162,169,5331
"1941",20200424,"NV",4398,31794,NA,NA,NA,NA,NA,NA,NA,NA,"A","4/24/2020 10:00","153e765411bb9992138322fc9d226346dd3799d4","2020-04-24T20:00:00Z",197,NA,36192,36192,36192,32,8,0,1253,190,1443
"1942",20200424,"NY",271590,459066,NA,14258,60414,5016,NA,NA,NA,46156,"A","4/24/2020 00:00","ccbdc9d54c4ec5d1d6b847426d095f360e225264","2020-04-24T20:00:00Z",16162,60414,730656,730656,730656,36,422,1149,26606,8130,34736
"1943",20200424,"OH",15169,92528,NA,NA,3053,NA,920,NA,NA,NA,"B","4/24/2020 14:00","32bc746d39ad3cd593345b14b1286c87c045b961","2020-04-24T20:00:00Z",690,3053,107697,107697,107697,39,34,93,4345,475,4820
"1944",20200424,"OK",3121,43019,NA,310,637,155,NA,NA,NA,1961,"B","4/24/2020 00:00","04eb551388304cea8e415cef28f660730f528314","2020-04-24T20:00:00Z",188,637,46140,46140,46140,40,9,15,0,104,104
"1945",20200424,"OR",2177,43315,NA,258,520,56,NA,29,NA,NA,"A","4/24/2020 11:00","2ac367e229acbca535ffab87a77d3008fef0ed2c","2020-04-24T20:00:00Z",86,520,45492,45492,45492,41,3,8,1466,50,1516
"1946",20200424,"PA",38652,147491,NA,2746,NA,NA,NA,679,NA,NA,"A","4/24/2020 00:00","d050fbd9057a3bb529c8c4d46cbcb49618f8acff","2020-04-24T20:00:00Z",1492,NA,186143,186143,186143,42,71,0,5430,1599,7029
"1947",20200424,"PR",1276,9313,1940,NA,NA,NA,NA,NA,NA,NA,"A","4/24/2020 06:30","a6a36ba696e70f9fd38adf09eccc920903a0e606","2020-04-24T20:00:00Z",77,NA,12529,10589,10589,72,8,0,0,361,361
"1948",20200424,"RI",6699,40558,NA,267,576,77,NA,48,NA,377,"B","4/24/2020 00:00","bd3337acf4a889e3c4efb4446c96a293a018638c","2020-04-24T20:00:00Z",202,576,47257,47257,47257,44,-11,-181,2395,437,2832
"1949",20200424,"SC",4917,39546,NA,NA,837,NA,NA,NA,NA,3317,"B","4/24/2020 17:24","ffc7eb3f2953d7797f0da89cdea1ba557b03fe62","2020-04-24T20:00:00Z",150,837,44463,44463,44463,45,0,0,0,0,0
"1950",20200424,"SD",2040,12784,NA,61,124,NA,NA,NA,NA,1190,"A","4/23/2020 18:00","8017644df532a8557bf58c0bba7705d7ee597d1e","2020-04-24T20:00:00Z",10,124,14824,14824,14824,46,1,5,675,84,759
"1951",20200424,"TN",8726,122602,NA,NA,808,NA,NA,NA,NA,4370,"A","4/23/2020 15:00","8e7c6ddc91fa77b61e5c110b8eaf53be03261038","2020-04-24T20:00:00Z",168,808,131328,131328,131328,47,-2,15,7768,460,8228
"1952",20200424,"TX",22806,219741,NA,1674,NA,NA,NA,NA,NA,9156,"A","4/24/2020 12:30","cfc7d7d8d8e5e4e2f63cafe53fd7f575cba8085e","2020-04-24T20:00:00Z",593,NA,242547,242547,242547,48,32,0,16607,862,17469
"1953",20200424,"UT",3782,80915,NA,NA,315,NA,NA,NA,NA,1252,"A","4/24/2020 15:00","b377f8c1c48095221db88d2610ac997c82c46ce3","2020-04-24T20:00:00Z",39,315,84697,84697,84697,49,4,14,3900,170,4070
"1954",20200424,"VA",11594,57846,487,1399,1837,379,NA,220,NA,1672,"A","4/24/2020 00:00","76dc187f1e12f6c8c4d0aeb8540e17e8486a378f","2020-04-24T20:00:00Z",410,1837,69927,69440,69440,51,38,84,3955,596,4551
"1955",20200424,"VI",54,642,35,NA,NA,NA,NA,NA,NA,50,"","4/23/2020 00:00","5c3826593dabfb149f6256331a6b98283837e5ce","2020-04-24T20:00:00Z",3,NA,731,696,696,78,0,0,59,0,59
"1956",20200424,"VT",843,12808,NA,32,NA,NA,NA,NA,NA,NA,"A","4/24/2020 00:00","a41f4e82eca928bd958f4d43560554b2e0988b14","2020-04-24T20:00:00Z",44,NA,13651,13651,13651,50,1,0,388,9,397
"1957",20200424,"WA",13933,169096,NA,551,NA,164,NA,NA,NA,NA,"C","4/24/2020 00:00","42d22e22f2b96b2937f4406af88de08db0245901","2020-04-24T20:00:00Z",659,NA,183029,183029,183029,53,5,0,6498,344,6842
"1958",20200424,"WI",5356,54573,206,361,1353,143,346,NA,NA,NA,"A","4/24/2020 16:00","7bb8290ed489dc69afa083551bf14d0fc8baf153","2020-04-24T20:00:00Z",262,1353,60135,59929,59929,55,5,35,3117,304,3421
"1959",20200424,"WV",988,28823,NA,97,NA,36,NA,19,NA,439,"B","4/24/2020 10:00","0026ab521a6b6986dafe1f84cc3bae516117b888","2020-04-24T20:00:00Z",32,NA,29811,29811,29811,54,3,0,1885,21,1906
"1960",20200424,"WY",349,7696,NA,16,54,NA,NA,NA,NA,321,"A","4/24/2020 00:00","96619f8ccfb25668bba95e68c1f3f4850d19ae9e","2020-04-24T20:00:00Z",7,54,8045,8045,8045,56,0,2,455,23,478
"1961",20200423,"AK",337,11824,NA,42,NA,NA,NA,NA,NA,209,"A","4/23/2020 14:00","1a1256af32724ea2e6f8a0a631d24b9c749cce34","2020-04-23T20:00:00Z",9,NA,12161,12161,12161,2,0,0,0,2,2
"1962",20200423,"AL",5778,46863,NA,NA,768,NA,288,NA,170,NA,"B","4/23/2020 00:00","8e33f70da48298e973ea72dc3e2a8b2eb1862528","2020-04-23T20:00:00Z",197,768,52641,52641,52641,1,3,38,3568,313,3881
"1963",20200423,"AR",2465,29125,NA,101,291,NA,NA,24,57,902,"A","4/23/2020 14:48","0c3ac1c09b51363b70e7573474076f176261f8af","2020-04-23T20:00:00Z",45,291,31590,31590,31590,5,3,0,1688,189,1877
"1964",20200423,"AS",0,3,17,NA,NA,NA,NA,NA,NA,NA,"","4/6/2020 00:00","dc9f0ced554665a45d589beead20486a644533e9","2020-04-23T20:00:00Z",NA,NA,20,3,3,60,0,0,0,0,0
"1965",20200423,"AZ",5769,52928,NA,699,NA,305,NA,201,NA,1282,"B","4/23/2020 00:00","5c4a77b96e92b706e24bc501b726e96566e8d5a0","2020-04-23T20:00:00Z",249,NA,58697,58697,58697,4,20,0,1786,310,2096
"1966",20200423,"CA",37369,444728,NA,4929,NA,1531,NA,NA,NA,NA,"B","4/22/2020 00:00","847e6eab7b528f13600da1fd142b1ba64dd72517","2020-04-23T20:00:00Z",1469,NA,482097,482097,482097,6,115,0,14797,1973,16770
"1967",20200423,"CO",10878,39767,NA,859,2123,NA,NA,NA,NA,NA,"A","4/21/2020 00:00","064e51aca68db8d2bf823bee613e8d9e85ffc580","2020-04-23T20:00:00Z",508,2123,50645,50645,50645,8,22,120,1510,431,1941
"1968",20200423,"CT",23100,48397,NA,1947,NA,NA,NA,NA,NA,NA,"A","4/23/2020 16:00","0cbd8c9b8e8886c47e363790d3f456ea904e41cd","2020-04-23T20:00:00Z",1639,NA,71497,71497,71497,9,95,0,948,631,1579
"1969",20200423,"DC",3361,12569,NA,402,NA,120,NA,200,NA,648,"A","4/22/2020 00:00","b4e665c7ecb4e4e75f936fc7645958b2c7fc7647","2020-04-23T20:00:00Z",139,NA,15930,15930,15930,11,12,0,273,155,428
"1970",20200423,"DE",3308,13604,NA,290,NA,NA,NA,NA,NA,643,"A","4/22/2020 18:00","b50ac5c82a9e542f95353927711c84ab27e8ee44","2020-04-23T20:00:00Z",92,NA,16912,16912,16912,10,3,0,251,108,359
"1971",20200423,"FL",28832,267876,1301,NA,4693,NA,NA,NA,NA,NA,"A","4/23/2020 18:27","5aa42f6202932d2b6ad685a71e40b6d4d16f8f01","2020-04-23T20:00:00Z",979,4693,298009,296708,296708,12,69,224,7558,523,8081
"1972",20200423,"GA",21512,79550,NA,NA,4069,NA,NA,NA,NA,NA,"A","4/23/2020 18:28","7f209ef285db02d8a7f183770e3a6767bb21690f","2020-04-23T20:00:00Z",872,4069,101062,101062,101062,13,36,110,6218,772,6990
"1973",20200423,"GU",135,1180,NA,2,NA,NA,NA,NA,NA,126,"","4/23/2020 07:45","62736dc6cd3a658b183a75bd58f56ef735546a23","2020-04-23T20:00:00Z",5,NA,1315,1315,1315,66,0,0,94,1,95
"1974",20200423,"HI",592,25536,NA,NA,63,NA,NA,NA,NA,444,"A","4/22/2020 18:00","41ec8818871d1252014476fa40bc75845c0d6673","2020-04-23T20:00:00Z",12,63,26128,26128,26128,15,0,7,776,10,786
"1975",20200423,"IA",3924,25338,NA,282,NA,102,NA,55,NA,1492,"A","4/22/2020 12:00","630510f7a0fb9467748755fee8d89d10a3e45e98","2020-04-23T20:00:00Z",96,NA,29262,29262,29262,19,6,0,842,176,1018
"1976",20200423,"ID",1802,17370,NA,NA,162,NA,60,NA,NA,767,"A","4/23/2020 19:00","5e6c215df288383286ea8fe24818a59c75fe3a73","2020-04-23T20:00:00Z",54,162,19172,19172,19172,16,3,4,966,36,1002
"1977",20200423,"IL",36934,136382,NA,4877,NA,1268,NA,766,NA,NA,"A","4/23/2020 00:00","e9a897ea84d5fb1a1b9a03d1b3cdeb9e66e5b87b","2020-04-23T20:00:00Z",1688,NA,173316,173316,173316,17,123,0,7144,1826,8970
"1978",20200423,"IN",13039,59001,NA,NA,NA,652,NA,333,NA,NA,"B","4/22/2020 23:59","4446a9a6fc8d3c961861184bd9bca6b26c35f6af","2020-04-23T20:00:00Z",706,NA,72040,72040,72040,18,45,0,1969,601,2570
"1979",20200423,"KS",2482,18836,NA,NA,442,NA,NA,NA,NA,NA,"B","4/23/2020 10:45","2be7cfde5cb523c2c5566ba9d801b95005108fb9","2020-04-23T20:00:00Z",112,442,21318,21318,21318,20,2,10,844,271,1115
"1980",20200423,"KY",3373,32702,NA,301,1105,161,564,NA,NA,1311,"A","4/23/2020 17:00","9f9dacb74550305e5cf0c5500334d52ca7a115d0","2020-04-23T20:00:00Z",185,1105,36075,36075,36075,21,14,29,2566,181,2747
"1981",20200423,"LA",25739,111774,NA,1727,NA,NA,NA,274,NA,14927,"A","4/23/2020 13:00","cebcffc50b11dcedea770f9b1587f04f0d009fe8","2020-04-23T20:00:00Z",1540,NA,137513,137513,137513,22,67,0,186,481,667
"1982",20200423,"MA",47992,156324,NA,3851,4493,1034,NA,NA,NA,NA,"B","4/22/2020 16:00","f695f30270629b80947a6f60087073793a9f7780","2020-04-23T20:00:00Z",2769,4493,204316,204316,204316,25,172,237,11535,3079,14614
"1983",20200423,"MD",15737,64363,NA,1405,3477,515,NA,NA,NA,1040,"A","4/23/2020 10:00","b41928e5b2d705bb1e1a807b7de587b5d3de392a","2020-04-23T20:00:00Z",748,3477,80100,80100,80100,24,50,152,2609,962,3571
"1984",20200423,"ME",937,16784,NA,42,150,18,NA,11,NA,485,"A","4/23/2020 11:45","9423261924fb50b198f5853faacc4899d8df0256","2020-04-23T20:00:00Z",44,150,17721,17721,17721,23,5,6,0,30,30
"1985",20200423,"MI",35291,93030,NA,3611,NA,1148,NA,1027,NA,3237,"B","4/23/2020 16:00","fdff33877e7c61ed5cbaa758f023da6141fe6215","2020-04-23T20:00:00Z",2977,NA,128321,128321,128321,26,164,0,8771,1325,10096
"1986",20200423,"MN",2942,48606,NA,268,712,104,274,NA,NA,1336,"A","4/22/2020 17:00","f953fbb946e0b87fc837c07e725c44240179d793","2020-04-23T20:00:00Z",200,712,51548,51548,51548,27,21,52,1983,221,2204
"1987",20200423,"MO",6321,53129,NA,884,NA,NA,NA,NA,NA,NA,"A","4/23/2020 15:00","8694f4ae5f918a4aca5bf24015172fe6c9b2287e","2020-04-23T20:00:00Z",218,NA,59450,59450,59450,29,10,0,1110,184,1294
"1988",20200423,"MP",14,51,NA,NA,NA,NA,NA,NA,NA,11,"","4/23/2020 22:35","f83c51fa2871673226747964e99b18944d2b26f3","2020-04-23T20:00:00Z",2,NA,65,65,65,69,0,0,0,0,0
"1989",20200423,"MS",5153,50236,NA,595,946,156,NA,78,NA,NA,"A","4/22/2020 19:00","eda4ddcac66aa68b62388921f40f8330b956fc4a","2020-04-23T20:00:00Z",201,946,55389,55389,55389,28,8,36,1295,259,1554
"1990",20200423,"MT",442,11433,NA,13,59,NA,NA,NA,NA,306,"A","4/23/2020 00:00","5704dfb8e374ed43db61d73db82e10b3f7ee833d","2020-04-23T20:00:00Z",14,59,11875,11875,11875,30,0,0,289,3,292
"1991",20200423,"NC",7608,88577,NA,486,NA,NA,NA,NA,NA,NA,"A","4/23/2020 11:00","15a2b024cc3590458f36542a5060dc2aed7d8527","2020-04-23T20:00:00Z",253,NA,96185,96185,96185,37,11,0,5461,388,5849
"1992",20200423,"ND",709,15621,NA,18,65,NA,NA,NA,NA,269,"B","4/23/2020 13:02","5cd3e6906dcc6b3a839bacfdc5c80a6ce9456b08","2020-04-23T20:00:00Z",15,65,16330,16330,16330,38,1,3,711,30,741
"1993",20200423,"NE",1813,15547,NA,NA,NA,NA,NA,NA,NA,NA,"A","4/23/2020 19:45","3be5438766e2e262557b5b384fca69aac6028788","2020-04-23T20:00:00Z",45,NA,17360,17360,17360,31,7,0,590,91,681
"1994",20200423,"NH",1588,14424,265,91,213,NA,NA,NA,NA,550,"B","4/23/2020 09:00","aef7984c10b1e8cc345667682b1cfdfdfff08e9c","2020-04-23T20:00:00Z",48,213,16277,16012,16012,33,6,7,874,97,971
"1995",20200423,"NJ",99989,100159,NA,7240,NA,1990,NA,1462,NA,NA,"A","4/23/2020 13:00","4bef794eec6f925642ac74bb2fc249a4fae4c95a","2020-04-23T20:00:00Z",5368,NA,200148,200148,200148,34,305,0,4365,4124,8489
"1996",20200423,"NM",2210,39022,NA,121,331,NA,NA,NA,NA,547,"A","4/23/2020 09:11","faeb4a71d2802bb42fa2a9719ebe3826081a26b0","2020-04-23T20:00:00Z",71,331,41232,41232,41232,35,6,25,217,138,355
"1997",20200423,"NV",4208,30541,NA,NA,NA,NA,NA,NA,NA,NA,"A","4/23/2020 20:00","c64cc251daab1b4d1db2b97081807be4645a12fd","2020-04-23T20:00:00Z",189,NA,34749,34749,34749,32,17,0,734,127,861
"1998",20200423,"NY",263460,432460,NA,15021,59265,5016,NA,NA,NA,44244,"A","4/23/2020 00:00","0501298aeed32d6f9ed8c5bb9ab37f54d9cb8982","2020-04-23T20:00:00Z",15740,59265,695920,695920,695920,36,438,1358,19694,6244,25938
"1999",20200423,"OH",14694,88183,NA,NA,2960,NA,900,NA,NA,NA,"B","4/23/2020 14:00","ccf677cf4b26a3bcdcf9d8bf99c5692087bf92c2","2020-04-23T20:00:00Z",656,2960,102877,102877,102877,39,46,78,3794,577,4371
"2000",20200423,"OK",3017,43019,NA,284,622,156,NA,NA,NA,1884,"B","4/23/2020 00:00","96d870d8df2b2203054dd3d9e9543d8c15b78b15","2020-04-23T20:00:00Z",179,622,46036,46036,46036,40,9,34,0,123,123
"2001",20200423,"OR",2127,41849,NA,304,512,74,NA,36,NA,NA,"A","4/23/2020 11:00","6c2682a589104ad62c83d44e26c1bf6e828a5cb3","2020-04-23T20:00:00Z",83,512,43976,43976,43976,41,5,24,2723,68,2791
"2002",20200423,"PA",37053,142061,NA,2750,NA,NA,NA,679,NA,NA,"A","4/23/2020 00:00","ef27b8dfb02f0f0adfaa30394ef1c27792c09815","2020-04-23T20:00:00Z",1421,NA,179114,179114,179114,42,-201,0,5789,1369,7158
"2003",20200423,"PR",915,9313,1951,NA,NA,NA,NA,NA,NA,NA,"A","4/23/2020 06:20","3bd50d3b7c1f7add6297a53c91e30ac4db1491cc","2020-04-23T20:00:00Z",69,NA,12179,10228,10228,72,2,0,471,0,471
"2004",20200423,"RI",6262,38163,NA,316,757,72,NA,45,NA,342,"B","4/23/2020 00:00","b87a08198811749440037af646ba09901c78ef21","2020-04-23T20:00:00Z",213,757,44425,44425,44425,44,12,40,2282,417,2699
"2005",20200423,"SC",4917,39546,NA,NA,837,NA,NA,NA,NA,3317,"B","4/22/2020 23:59","503a4c9bde9974d355a2f7a0ec4c0d9649b28df2","2020-04-23T20:00:00Z",150,837,44463,44463,44463,45,10,0,1196,156,1352
"2006",20200423,"SD",1956,12109,NA,58,119,NA,NA,NA,NA,1064,"A","4/22/2020 18:00","9edf89332cae1c884950623cf18f5754ad437b9b","2020-04-23T20:00:00Z",9,119,14065,14065,14065,46,1,8,521,98,619
"2007",20200423,"TN",8266,114834,NA,NA,793,NA,NA,NA,NA,4193,"A","4/23/2020 15:00","e903a8158d9b3debcee9d9d0063c646b6dbd221b","2020-04-23T20:00:00Z",170,793,123100,123100,123100,47,4,18,7696,424,8120
"2008",20200423,"TX",21944,203134,NA,1649,NA,NA,NA,NA,NA,8025,"A","4/23/2020 12:30","28e7069b8dd99bfb69bd325d2c342a078b38ecc1","2020-04-23T20:00:00Z",561,NA,225078,225078,225078,48,18,0,7420,875,8295
"2009",20200423,"UT",3612,77015,NA,NA,301,NA,NA,NA,NA,1050,"A","4/23/2020 15:00","8e9d9a923ce56f6b4790ff7608da0288f0c3b4f4","2020-04-23T20:00:00Z",35,301,80627,80627,80627,49,1,13,4000,167,4167
"2010",20200423,"VA",10998,53891,492,1379,1753,400,NA,249,NA,1567,"A","4/23/2020 00:00","168d95ec09ccd4cb232bf235d86f3f89df513f6c","2020-04-23T20:00:00Z",372,1753,65381,64889,64889,51,23,94,3379,732,4111
"2011",20200423,"VI",54,583,31,NA,NA,NA,NA,NA,NA,48,"","4/23/2020 20:30","294beb467a024040615187fdfad7480cd65abddd","2020-04-23T20:00:00Z",3,NA,668,637,637,78,0,0,0,0,0
"2012",20200423,"VT",834,12420,NA,44,NA,NA,NA,NA,NA,NA,"A","4/23/2020 00:00","2ca1d2590e4a79fe69c463c8f535c50376f30393","2020-04-23T20:00:00Z",43,NA,13254,13254,13254,50,3,0,323,3,326
"2013",20200423,"WA",13589,162598,NA,544,NA,151,NA,NA,NA,NA,"C","4/23/2020 00:00","75fce77581185f7d063763c98e53d1358bade96f","2020-04-23T20:00:00Z",654,NA,176187,176187,176187,53,7,0,5160,261,5421
"2014",20200423,"WI",5052,51456,201,349,1318,146,342,NA,NA,NA,"A","4/23/2020 16:00","ac6f4ff15cd40393ff20905594b73789cfd7777f","2020-04-23T20:00:00Z",257,1318,56709,56508,56508,55,11,16,1954,207,2161
"2015",20200423,"WV",967,26938,NA,108,NA,44,NA,24,NA,380,"B","4/23/2020 17:00","2ed51d849688095eecc942322a3d9069be676cf2","2020-04-23T20:00:00Z",29,NA,27905,27905,27905,54,3,0,2041,28,2069
"2016",20200423,"WY",326,7241,NA,NA,52,NA,NA,NA,NA,275,"A","4/23/2020 16:27","e370898018aecb5d52105fd56d79ce0c587806c6","2020-04-23T20:00:00Z",7,52,7567,7567,7567,56,1,0,-60,4,-56
"2017",20200422,"AK",335,11824,NA,39,36,NA,NA,NA,NA,196,"A","4/22/2020 14:00","cd070a966b49a2f982188c2c3a0f923fb9aefc4c","2020-04-22T20:00:00Z",9,36,12159,12159,12159,2,0,0,1034,6,1040
"2018",20200422,"AL",5465,43295,NA,NA,730,NA,288,NA,170,NA,"B","4/22/2020 00:00","56f2613ed87ad0c4313cbc75665617ca85836560","2020-04-22T20:00:00Z",194,730,48760,48760,48760,1,17,31,0,234,234
"2019",20200422,"AR",2276,27437,NA,97,291,NA,NA,23,57,863,"A","4/22/2020 16:01","0eabe652e679eb099e9d27cfc2f1a1a35da9abaf","2020-04-22T20:00:00Z",42,291,29713,29713,29713,5,-1,0,2223,49,2272
"2020",20200422,"AS",0,3,17,NA,NA,NA,NA,NA,NA,NA,"","4/6/2020 00:00","22496289c1cb05aa4f7843c3d968ec06f7bc0751","2020-04-22T20:00:00Z",NA,NA,20,3,3,60,0,0,0,0,0
"2021",20200422,"AZ",5459,51142,NA,664,NA,300,NA,195,NA,1265,"B","4/22/2020 00:00","521e6faa60a58b06e2cf953537855225903a1b39","2020-04-22T20:00:00Z",229,NA,56601,56601,56601,4,21,0,1241,208,1449
"2022",20200422,"CA",35396,429931,NA,4984,NA,1551,NA,NA,NA,NA,"B","4/21/2020 00:00","59c585124c114a6d62b9816a38cff2c78fed54b1","2020-04-22T20:00:00Z",1354,NA,465327,465327,465327,6,86,0,163092,2135,165227
"2023",20200422,"CO",10447,38257,NA,851,2003,NA,NA,NA,NA,NA,"A","4/20/2020 00:00","155e0912e7d2cfd48aa4d810e4a14f01674cb6b5","2020-04-22T20:00:00Z",486,2003,48704,48704,48704,8,37,123,897,341,1238
"2024",20200422,"CT",22469,47449,NA,1972,NA,NA,NA,NA,NA,NA,"A","4/22/2020 16:00","9af21292475900c329b8a360de6c63f494afd80a","2020-04-22T20:00:00Z",1544,NA,69918,69918,69918,9,121,0,3617,2109,5726
"2025",20200422,"DC",3206,12296,NA,402,NA,120,NA,69,NA,645,"A","4/21/2020 00:00","9eab8d62a2ab9365bf4a8c4bea0d144f108c3fba","2020-04-22T20:00:00Z",127,NA,15502,15502,15502,11,15,0,455,108,563
"2026",20200422,"DE",3200,13353,NA,269,NA,NA,NA,NA,NA,599,"A","4/21/2020 18:00","f85949252b10cff0a300c507ecfde6876420f966","2020-04-22T20:00:00Z",89,NA,16553,16553,16553,10,7,0,418,269,687
"2027",20200422,"FL",28309,260318,1258,NA,4469,NA,NA,NA,NA,NA,"A","4/22/2020 11:17","aca97fe56e559e525635cc99736b88936f54a311","2020-04-22T20:00:00Z",910,4469,289885,288627,288627,12,54,234,10754,814,11568
"2028",20200422,"GA",20740,73332,NA,NA,3959,NA,NA,NA,NA,NA,"A","4/22/2020 18:28","a3db43d11143724dd668a160ab613cbd32d6cbbe","2020-04-22T20:00:00Z",836,3959,94072,94072,94072,13,37,180,5073,859,5932
"2029",20200422,"GU",134,1086,NA,3,NA,2,NA,NA,NA,119,"","4/22/2020 07:45","1b4604acf1f1ae26201714e62990ad3c07e0e82f","2020-04-22T20:00:00Z",5,NA,1220,1220,1220,66,0,0,53,1,54
"2030",20200422,"HI",582,24760,NA,NA,56,NA,NA,NA,NA,437,"A","4/22/2020 18:00","9d88a46c8c5fb6d38c133f9c450bd24c6f7a5f7f","2020-04-22T20:00:00Z",12,56,25342,25342,25342,15,2,1,648,-2,646
"2031",20200422,"IA",3748,24496,NA,272,NA,92,NA,57,NA,1428,"A","4/21/2020 12:00","277e3a5b18a9b16d86a6b5b57ea693a1bf2c6b24","2020-04-22T20:00:00Z",90,NA,28244,28244,28244,19,7,0,522,107,629
"2032",20200422,"ID",1766,16404,NA,NA,158,NA,58,NA,NA,710,"A","4/22/2020 19:00","3946e24072355aef4da4b038b511ab988ff43ae6","2020-04-22T20:00:00Z",51,158,18170,18170,18170,16,3,1,333,30,363
"2033",20200422,"IL",35108,129238,NA,4665,NA,1220,NA,747,NA,NA,"A","4/22/2020 00:00","8b338b8f6d042e417369a3edaaa1e938908d9c6c","2020-04-22T20:00:00Z",1565,NA,164346,164346,164346,17,97,0,7300,2049,9349
"2034",20200422,"IN",12438,57032,NA,NA,NA,633,NA,334,NA,NA,"B","4/21/2020 23:59","289665de212272ea328e935fe8b7c8283d67b65b","2020-04-22T20:00:00Z",661,NA,69470,69470,69470,18,31,0,1865,341,2206
"2035",20200422,"KS",2211,17992,NA,NA,432,NA,NA,NA,NA,NA,"B","4/22/2020 12:00","094121aa582cd63290480b4cbfb6361372deb7d7","2020-04-22T20:00:00Z",110,432,20203,20203,20203,20,3,13,916,186,1102
"2036",20200422,"KY",3192,30136,NA,286,1076,165,558,NA,NA,1266,"A","4/22/2020 17:00","6614991b1cd55cdcb78f5c2aed3815683dc54fef","2020-04-22T20:00:00Z",171,1076,33328,33328,33328,21,17,17,366,142,508
"2037",20200422,"LA",25258,111588,NA,1747,NA,NA,NA,287,NA,14927,"A","4/22/2020 13:00","f167fd75485e91fac92c15b9290f966e37b574ea","2020-04-22T20:00:00Z",1473,NA,136846,136846,136846,22,68,0,0,404,404
"2038",20200422,"MA",44913,144789,NA,3890,4256,1050,NA,NA,NA,NA,"B","4/22/2020 16:00","f6e0182b548ceff26a49dbc5650a0551b819253f","2020-04-22T20:00:00Z",2597,4256,189702,189702,189702,25,148,247,3345,1745,5090
"2039",20200422,"MD",14775,61754,NA,1432,3325,527,NA,NA,NA,981,"A","4/21/2020 10:00","a4c31581c81a87f7b42a665efeaaeba8ab880e53","2020-04-22T20:00:00Z",698,3325,76529,76529,76529,24,46,167,2312,582,2894
"2040",20200422,"ME",907,16784,NA,42,144,18,NA,10,NA,455,"A","4/22/2020 11:45","fc7f482d7857e4d5239a231c762f0cd9920f40e5","2020-04-22T20:00:00Z",39,144,17691,17691,17691,23,3,5,2708,19,2727
"2041",20200422,"MI",33966,84259,NA,3305,NA,1350,NA,1065,NA,3237,"B","4/22/2020 11:00","281540e98a97714fa2a2cf70ae026a7b537c648d","2020-04-22T20:00:00Z",2813,NA,118225,118225,118225,26,113,0,0,999,999
"2042",20200422,"MN",2721,46623,NA,240,660,107,262,NA,NA,1138,"A","4/21/2020 17:00","0130f531d19b9aa3cbcb2a0ed7e08828b9e17bff","2020-04-22T20:00:00Z",179,660,49344,49344,49344,27,19,31,1493,154,1647
"2043",20200422,"MO",6137,52019,NA,1001,NA,NA,NA,NA,NA,NA,"A","4/22/2020 15:00","d6e088157b1f9bf0f33f7c73208da0d447908b13","2020-04-22T20:00:00Z",208,NA,58156,58156,58156,29,19,0,840,196,1036
"2044",20200422,"MP",14,51,NA,NA,NA,NA,NA,NA,NA,11,"","4/23/2020 00:00","664a96538149b0d2bc51216597002166421ea872","2020-04-22T20:00:00Z",2,NA,65,65,65,69,0,0,0,0,0
"2045",20200422,"MS",4894,48941,NA,628,910,162,NA,86,NA,NA,"A","4/21/2020 19:00","99343c781907dacfb196bf1322311a55e5f63ae7","2020-04-22T20:00:00Z",193,910,53835,53835,53835,28,10,52,1293,178,1471
"2046",20200422,"MT",439,11144,NA,13,59,NA,NA,NA,NA,296,"A","4/22/2020 00:00","10012d42402e7b692a7e006267c9b81eb06aa0e7","2020-04-22T20:00:00Z",14,59,11583,11583,11583,30,2,0,340,2,342
"2047",20200422,"NC",7220,83116,NA,434,NA,NA,NA,NA,NA,NA,"A","4/22/2020 11:00","50b74d0c3e1c7d03123998034dd49994d8e8aa1d","2020-04-22T20:00:00Z",242,NA,90336,90336,90336,37,29,0,6736,269,7005
"2048",20200422,"ND",679,14910,NA,23,62,NA,NA,NA,NA,229,"B","4/22/2020 13:10","5afe195020e0b0d9ca874af732d20550d1db32cc","2020-04-22T20:00:00Z",14,62,15589,15589,15589,38,1,8,567,35,602
"2049",20200422,"NE",1722,14957,NA,NA,NA,NA,NA,NA,NA,NA,"A","4/22/2020 19:45","3e4a9a5437208d4fa764a6fc1affae3dd9bf535b","2020-04-22T20:00:00Z",38,NA,16679,16679,16679,31,5,0,233,74,307
"2050",20200422,"NH",1491,13550,225,94,206,NA,NA,NA,NA,546,"B","4/22/2020 09:00","3c55c7dc42053e7e9e6574ec730b026b56bc4930","2020-04-22T20:00:00Z",42,206,15266,15041,15041,33,0,0,702,0,702
"2051",20200422,"NJ",95865,95794,NA,7210,NA,1983,NA,1570,NA,NA,"A","4/22/2020 13:00","4b159435442726423eca078e6d5902d38965abd6","2020-04-22T20:00:00Z",5063,NA,191659,191659,191659,34,310,0,3355,3478,6833
"2052",20200422,"NM",2072,38805,NA,119,306,NA,NA,NA,NA,529,"A","4/22/2020 19:11","976b4c8cfa4c42cab158ab455f07fcfe1bc6d2f0","2020-04-22T20:00:00Z",65,306,40877,40877,40877,35,7,15,2021,101,2122
"2053",20200422,"NV",4081,29807,NA,NA,NA,NA,NA,NA,NA,NA,"A","4/22/2020 10:00","e356b30e1adac6e6ac6f1c90faf21558d07f4f23","2020-04-22T20:00:00Z",172,NA,33888,33888,33888,32,9,0,689,144,833
"2054",20200422,"NY",257216,412766,NA,15599,57907,5016,NA,NA,NA,42308,"A","4/22/2020 00:00","5a991363a77735bfe5f67d504bf8ac0660b1065f","2020-04-22T20:00:00Z",15302,57907,669982,669982,669982,36,474,1381,15131,5526,20657
"2055",20200422,"OH",14117,84389,NA,NA,2882,NA,880,NA,NA,NA,"B","4/22/2020 14:00","5811e1d3be6557281277e1d3d206b8dcac440b0a","2020-04-22T20:00:00Z",610,2882,98506,98506,98506,39,53,103,3400,392,3792
"2056",20200422,"OK",2894,43019,NA,298,588,147,NA,NA,NA,1772,"B","4/22/2020 00:00","adc9a1ffae80e4b61cbe2b0ce5fef277259d8729","2020-04-22T20:00:00Z",170,588,45913,45913,45913,40,6,27,1482,87,1569
"2057",20200422,"OR",2059,39126,NA,302,488,67,NA,35,NA,NA,"A","4/22/2020 11:00","9a70f256fc5123565d1f15931a2e037e966dee8c","2020-04-22T20:00:00Z",78,488,41185,41185,41185,41,0,17,0,57,57
"2058",20200422,"PA",35684,136272,NA,2764,NA,NA,NA,685,NA,NA,"A","4/22/2020 00:00","5aadc0d7f00e885017930c2497e09428f5ea7555","2020-04-22T20:00:00Z",1622,NA,171956,171956,171956,42,58,0,3949,1156,5105
"2059",20200422,"PR",915,8842,1954,NA,NA,NA,NA,NA,NA,NA,"A","4/22/2020 06:05","85edb40b4a16370467ca1f3558d3f6a4c8c4b299","2020-04-22T20:00:00Z",67,NA,11711,9757,9757,72,3,0,53,-383,-330
"2060",20200422,"RI",5845,35881,NA,314,717,71,NA,44,NA,315,"B","4/22/2020 00:00","85626683521763aafbb5c36e31ee1bb6695659e8","2020-04-22T20:00:00Z",201,717,41726,41726,41726,44,15,43,2048,378,2426
"2061",20200422,"SC",4761,38350,NA,NA,837,NA,NA,NA,NA,3317,"B","4/21/2020 23:59","13a54cb47238658d834fe9db94b38a2003f7301e","2020-04-22T20:00:00Z",140,837,43111,43111,43111,45,16,61,1512,322,1834
"2062",20200422,"SD",1858,11588,NA,62,111,NA,NA,NA,NA,937,"A","4/22/2020 11:40","46fbf8f08971c032e5e15bc2b47affda9d03c4ba","2020-04-22T20:00:00Z",8,111,13446,13446,13446,46,0,11,528,103,631
"2063",20200422,"TN",7842,107138,NA,NA,775,NA,NA,NA,NA,4012,"A","4/22/2020 15:00","163f6f1224a1fad158390ad2900c5aa5f4d7aaf7","2020-04-22T20:00:00Z",166,775,114980,114980,114980,47,9,15,6350,448,6798
"2064",20200422,"TX",21069,195714,NA,1678,NA,NA,NA,NA,NA,7341,"A","4/22/2020 13:15","a0689bbda67a37abe8d2647b861e532de6a81dd3","2020-04-22T20:00:00Z",543,NA,216783,216783,216783,48,26,0,10511,873,11384
"2065",20200422,"UT",3445,73015,NA,NA,288,NA,NA,NA,NA,970,"A","4/22/2020 15:00","bcb09903b8d187a91bb1cdea3114c9c3f2e781e7","2020-04-22T20:00:00Z",34,288,76460,76460,76460,49,2,11,3953,149,4102
"2066",20200422,"VA",10266,50512,477,1374,1659,419,NA,244,NA,1497,"A","4/22/2020 00:00","c75ad10b79833dda982121a6f8c89cd4bb5e5d36","2020-04-22T20:00:00Z",349,1659,61255,60778,60778,51,25,78,1788,636,2424
"2067",20200422,"VI",54,583,31,NA,NA,NA,NA,NA,NA,48,"","4/22/2020 20:30","87b9ec52ca98a143f336ffb431f244513e632d5f","2020-04-22T20:00:00Z",3,NA,668,637,637,78,0,0,9,0,9
"2068",20200422,"VT",831,12097,NA,37,NA,NA,NA,NA,NA,NA,"A","4/22/2020 00:00","3e622d64dc2da271268e6507f21c2b1a3748cbcd","2020-04-22T20:00:00Z",40,NA,12928,12928,12928,50,0,0,330,3,333
"2069",20200422,"WA",13328,157438,NA,543,NA,161,NA,NA,NA,NA,"C","4/22/2020 00:00","7d4a29366f15c304c03efffa6c251b9639d4bdbe","2020-04-22T20:00:00Z",647,NA,170766,170766,170766,53,7,0,4969,277,5246
"2070",20200422,"WI",4845,49502,229,355,1302,139,324,NA,NA,NA,"A","4/22/2020 16:00","b879b05ba07c03b950a6d811409ea46c6d657202","2020-04-22T20:00:00Z",246,1302,54576,54347,54347,55,4,50,1661,225,1886
"2071",20200422,"WV",939,24897,NA,103,NA,41,NA,23,NA,330,"B","4/22/2020 17:00","c4240397946560da233242fd79c0a38a38f7255c","2020-04-22T20:00:00Z",26,NA,25836,25836,25836,54,0,0,3048,25,3073
"2072",20200422,"WY",322,7301,NA,19,52,NA,NA,NA,NA,254,"A","4/22/2020 23:00","970877fd4ebe6208a3fea0682f0c2235145046db","2020-04-22T20:00:00Z",6,52,7623,7623,7623,56,0,0,0,2,2
"2073",20200421,"AK",329,10790,NA,42,36,NA,NA,NA,NA,168,"A","4/21/2020 15:15","8dd6e5e1d79ec1aeef04e2c80bf24d9b34d2a4c9","2020-04-21T20:00:00Z",9,36,11119,11119,11119,2,0,0,987,8,995
"2074",20200421,"AL",5231,43295,NA,NA,699,NA,260,NA,157,NA,"B","4/21/2020 00:00","e92b2cc1a8ed575ca1862fe6b7a963922958bbdf","2020-04-21T20:00:00Z",177,699,48526,48526,48526,1,10,58,2420,206,2626
"2075",20200421,"AR",2227,25214,NA,86,291,NA,NA,27,57,809,"A","4/21/2020 00:00","c1c5d60936d5f43d8939a0ce28295b0518e7c6e2","2020-04-21T20:00:00Z",43,291,27441,27441,27441,5,1,0,584,304,888
"2076",20200421,"AS",0,3,17,NA,NA,NA,NA,NA,NA,NA,"","4/6/2020 00:00","bb6eb1372cddf397eb8ba071ad5da598067d6951","2020-04-21T20:00:00Z",NA,NA,20,3,3,60,0,0,0,0,0
"2077",20200421,"AZ",5251,49901,NA,637,NA,285,NA,181,NA,1155,"B","4/21/2020 00:00","a8e31d7a0a9e98c7889c3b4526fce0ae50e1dc97","2020-04-21T20:00:00Z",208,NA,55152,55152,55152,4,21,0,465,187,652
"2078",20200421,"CA",33261,266839,NA,4886,NA,1502,NA,NA,NA,NA,"B","4/21/2020 00:00","a068953fdb478e84a2ce8f95f3a37a6e0a7dd111","2020-04-21T20:00:00Z",1268,NA,300100,300100,300100,6,60,0,7317,2283,9600
"2079",20200421,"CO",10106,37360,NA,861,1880,NA,NA,NA,NA,NA,"A","4/19/2020 00:00","315c512512eddf1f6936ac28d1dd8b8945b0b9e3","2020-04-21T20:00:00Z",449,1880,47466,47466,47466,8,27,67,895,376,1271
"2080",20200421,"CT",20360,43832,NA,1949,NA,NA,NA,NA,NA,NA,"A","4/21/2020 00:00","a03e2e85f2363ef5563f29b5658cc29be3666d8a","2020-04-21T20:00:00Z",1423,NA,64192,64192,64192,9,92,0,841,545,1386
"2081",20200421,"DC",3098,11841,NA,402,NA,120,NA,69,NA,636,"A","4/20/2020 00:00","d3700846dd2d09f4c093d3fa36f6430f6e9bf31a","2020-04-21T20:00:00Z",112,NA,14939,14939,14939,11,7,0,655,171,826
"2082",20200421,"DE",2931,12935,NA,263,NA,NA,NA,NA,NA,565,"A","4/20/2020 18:00","be446ae74f41ef3982e74ebc305bb71d3e23c51c","2020-04-21T20:00:00Z",82,NA,15866,15866,15866,10,10,0,427,186,613
"2083",20200421,"FL",27495,249564,1203,NA,4235,NA,NA,NA,NA,NA,"A","4/21/2020 16:19","dc949320c1322ed9266f95f2bfd173aa8b5495f5","2020-04-21T20:00:00Z",856,4235,278262,277059,277059,12,50,225,9999,835,10834
"2084",20200421,"GA",19881,68259,NA,NA,3779,NA,NA,NA,NA,NA,"A","4/21/2020 18:28","653304f4cef14208590a361a0d7ece55361b9671","2020-04-21T20:00:00Z",799,3779,88140,88140,88140,13,66,229,2878,934,3812
"2085",20200421,"GU",133,1033,NA,3,NA,2,NA,NA,NA,114,"","4/21/2020 08:05","6277952006d50b3283e2bd5140cbbc6a36cee19f","2020-04-21T20:00:00Z",5,NA,1166,1166,1166,66,0,0,42,0,42
"2086",20200421,"HI",584,24112,NA,NA,55,NA,NA,NA,NA,423,"A","4/21/2020 19:30","86ca90775d4b9c3babb38f26a4ecb111e416fe36","2020-04-21T20:00:00Z",10,55,24696,24696,24696,15,0,3,517,4,521
"2087",20200421,"IA",3641,23974,NA,214,NA,89,NA,60,NA,1293,"A","4/20/2020 12:00","1373d3fad6b56f6772ebfaec6de02682bc0fc692","2020-04-21T20:00:00Z",83,NA,27615,27615,27615,19,4,0,1313,482,1795
"2088",20200421,"ID",1736,16071,NA,NA,157,NA,58,NA,NA,660,"A","4/21/2020 19:00","100d44bf651a1331f43cd2e40505c015773912fd","2020-04-21T20:00:00Z",48,157,17807,17807,17807,16,3,6,298,64,362
"2089",20200421,"IL",33059,121938,NA,4776,NA,1226,NA,781,NA,NA,"A","4/21/2020 00:00","83141b4b6b9f48bb1e0dda4d5ed1dd41ed8f9232","2020-04-21T20:00:00Z",1468,NA,154997,154997,154997,17,119,0,5088,1551,6639
"2090",20200421,"IN",12097,55167,NA,NA,NA,676,NA,368,NA,NA,"B","4/20/2020 23:59","0bf1cce3ba995abe1f75bc846e8e0669f1a7d7a1","2020-04-21T20:00:00Z",630,NA,67264,67264,67264,18,61,0,2214,411,2625
"2091",20200421,"KS",2025,17076,NA,NA,419,NA,NA,NA,NA,NA,"B","4/21/2020 12:00","4c0020670a2df9e3c0a804abb5c70534d0bc6736","2020-04-21T20:00:00Z",107,419,19101,19101,19101,20,7,14,301,39,340
"2092",20200421,"KY",3050,29770,NA,263,1059,147,582,NA,NA,1174,"A","4/21/2020 17:00","ea2e66655dba0e2712754719254bd1fbce22a3ec","2020-04-21T20:00:00Z",154,1059,32820,32820,32820,21,6,0,158,90,248
"2093",20200421,"LA",24854,111588,NA,1798,NA,NA,NA,297,NA,NA,"A","4/21/2020 13:00","89077be9d0223c4afaa0f40c976eb5f4310adfba","2020-04-21T20:00:00Z",1405,NA,136442,136442,136442,22,77,0,0,331,331
"2094",20200421,"MA",43168,141444,NA,3977,4009,1040,NA,NA,NA,NA,"B","4/21/2020 16:00","a8f32b361f0f591ed7a1661f78446f619fe376a2","2020-04-21T20:00:00Z",2449,4009,184612,184612,184612,25,146,137,5398,1752,7150
"2095",20200421,"MD",14193,59442,NA,1433,3158,526,NA,NA,NA,930,"A","4/21/2020 10:00","8b970f31e5f547127490c3a8c75c0d4dfce9b752","2020-04-21T20:00:00Z",652,3158,73635,73635,73635,24,70,144,1729,509,2238
"2096",20200421,"ME",888,14076,NA,40,139,16,NA,8,NA,443,"A","4/21/2020 11:45","58845e780c3adccba8524a27fdb3390f36b8c812","2020-04-21T20:00:00Z",36,139,14964,14964,14964,23,1,1,0,13,13
"2097",20200421,"MI",32967,84259,NA,3357,NA,1346,NA,1107,NA,3237,"B","4/21/2020 11:00","95e2a1b08f9cd288c7e4fbb16b8934266cb39cdb","2020-04-21T20:00:00Z",2700,NA,117226,117226,117226,26,232,0,2461,967,3428
"2098",20200421,"MN",2567,45130,NA,237,629,117,253,NA,NA,1094,"A","4/20/2020 17:00","6271bcac91140a1831cdbb59c72321517e80548c","2020-04-21T20:00:00Z",160,629,47697,47697,47697,27,17,27,750,97,847
"2099",20200421,"MO",5941,51179,NA,1001,NA,NA,NA,NA,NA,NA,"A","4/21/2020 15:00","59baf56600a84d8356f665c9209bcde87df8c091","2020-04-21T20:00:00Z",189,NA,57120,57120,57120,29,12,0,973,134,1107
"2100",20200421,"MP",14,51,NA,NA,NA,NA,NA,NA,NA,11,"","4/21/2020 19:25","ee7de9815bf3212896a1b8e1e17ea19b5dcc374b","2020-04-21T20:00:00Z",2,NA,65,65,65,69,0,0,0,0,0
"2101",20200421,"MS",4716,47648,NA,548,858,146,NA,89,NA,NA,"A","4/20/2020 19:00","b954421ce8a9a46202b344f6091990546b8929bb","2020-04-21T20:00:00Z",183,858,52364,52364,52364,28,14,39,726,204,930
"2102",20200421,"MT",437,10804,NA,14,59,NA,NA,NA,NA,273,"A","4/21/2020 11:56","1d54a1fedac1d2438b60f1798a16768f176c1404","2020-04-21T20:00:00Z",12,59,11241,11241,11241,30,2,2,186,4,190
"2103",20200421,"NC",6951,76380,NA,427,NA,NA,NA,NA,NA,NA,"A","4/21/2020 10:35","a2fa33ef18fa59ade611b4cb369e9ce5866e60cd","2020-04-21T20:00:00Z",213,NA,83331,83331,83331,37,34,0,3660,187,3847
"2104",20200421,"ND",644,14343,NA,17,54,NA,NA,NA,NA,214,"B","4/20/2020 13:17","f4fd190ba31aebbea5e92d63044c73eb2c9ecebb","2020-04-21T20:00:00Z",13,54,14987,14987,14987,38,0,1,223,17,240
"2105",20200421,"NE",1648,14724,NA,NA,NA,NA,NA,NA,NA,NA,"A","4/21/2020 19:45","99ca56f1f829fb5725da2a81479d8553b3253b83","2020-04-21T20:00:00Z",33,NA,16372,16372,16372,31,5,0,518,174,692
"2106",20200421,"NH",1491,12848,244,78,206,NA,NA,NA,NA,521,"B","4/21/2020 09:00","0170c95358bcfc81a718f08f637e50e04b23fd1f","2020-04-21T20:00:00Z",42,206,14583,14339,14339,33,1,8,122,99,221
"2107",20200421,"NJ",92387,92439,NA,7594,NA,1930,NA,1501,NA,NA,"A","4/21/2020 13:00","0096a8c4edd1945c20682973c66e865127457567","2020-04-21T20:00:00Z",4753,NA,184826,184826,184826,34,376,0,3188,3581,6769
"2108",20200421,"NM",1971,36784,NA,116,291,NA,NA,NA,NA,501,"A","4/21/2020 10:22","e236b5b6d1a15de92f2035784737ea592fda72a3","2020-04-21T20:00:00Z",58,291,38755,38755,38755,35,3,17,1587,126,1713
"2109",20200421,"NV",3937,29118,NA,NA,NA,NA,NA,NA,NA,NA,"A","4/21/2020 10:00","30c4143fe24444a38285ba56f74c3970354e355e","2020-04-21T20:00:00Z",163,NA,33055,33055,33055,32,5,0,601,107,708
"2110",20200421,"NY",251690,397635,NA,16044,56526,5016,NA,NA,NA,40482,"A","4/21/2020 00:00","bed8c86d7beba5d9610951b5cb6427e53a7eafe1","2020-04-21T20:00:00Z",14828,56526,649325,649325,649325,36,481,1338,11286,4178,15464
"2111",20200421,"OH",13725,80989,NA,NA,2779,NA,838,NA,NA,NA,"B","4/21/2020 14:00","7d64a516c32fe76141c000784e92060f7bc1c5a9","2020-04-21T20:00:00Z",557,2779,94714,94714,94714,39,48,126,3069,806,3875
"2112",20200421,"OK",2807,41537,NA,346,561,164,NA,NA,NA,1702,"B","4/21/2020 00:00","e38da84c5cfea87e609c23d816bc6bc6e496fcad","2020-04-21T20:00:00Z",164,561,44344,44344,44344,40,21,20,8571,127,8698
"2113",20200421,"OR",2002,39126,NA,297,471,70,NA,35,NA,NA,"A","4/21/2020 11:00","b044711a64671fea90ad016293befb82cb7cbec9","2020-04-21T20:00:00Z",78,471,41128,41128,41128,41,3,6,1037,46,1083
"2114",20200421,"PA",34528,132323,NA,2743,NA,NA,NA,673,NA,NA,"A","4/21/2020 14:00","8341da3db785621d30d1176d04fc0d62aee6d131","2020-04-21T20:00:00Z",1564,NA,166851,166851,166851,42,360,0,2603,1296,3899
"2115",20200421,"PR",1298,8789,1761,NA,NA,NA,NA,NA,NA,NA,"A","4/21/2020 06:30","ab09d89b5cea0eb3ec47a16d5ff8ca1f84af3cc7","2020-04-21T20:00:00Z",64,NA,11848,10087,10087,72,1,0,303,46,349
"2116",20200421,"RI",5467,33833,NA,309,674,67,NA,43,NA,315,"B","4/21/2020 00:00","e9595a4ad78cd950702d10d02c4336c2cf4f974b","2020-04-21T20:00:00Z",186,674,39300,39300,39300,44,11,45,1843,369,2212
"2117",20200421,"SC",4439,36838,NA,NA,776,NA,NA,NA,NA,2063,"B","4/21/2020 16:30","d1fdcac8327cb0e5938df1117601ad9055c71397","2020-04-21T20:00:00Z",124,776,41277,41277,41277,45,4,0,735,62,797
"2118",20200421,"SD",1755,11060,NA,65,100,NA,NA,NA,NA,824,"A","4/20/2020 18:00","24ab76274ea63c0a46b38407c1236e9f60f524e5","2020-04-21T20:00:00Z",8,100,12815,12815,12815,46,1,13,419,70,489
"2119",20200421,"TN",7394,100788,NA,NA,760,NA,NA,NA,NA,3828,"A","4/21/2020 15:00","2448b245719583b4a0d004fbcb4845644478e260","2020-04-21T20:00:00Z",157,760,108182,108182,108182,47,5,30,7337,156,7493
"2120",20200421,"TX",20196,185203,NA,1419,NA,NA,NA,NA,NA,6486,"A","4/21/2020 13:00","ec0c26abcb0e026a407bcd12c4fd79d73ec1acc9","2020-04-21T20:00:00Z",517,NA,205399,205399,205399,48,22,0,14267,738,15005
"2121",20200421,"UT",3296,69062,NA,NA,277,NA,NA,NA,NA,888,"A","4/21/2020 15:00","675ebd883729986329d088ddaf60539674b255f5","2020-04-21T20:00:00Z",32,277,72358,72358,72358,49,4,9,3964,83,4047
"2122",20200421,"VA",9630,48724,477,1331,1581,403,NA,251,NA,1418,"A","4/21/2020 00:00","629b4c12b59cd6e74a0debd0c638395bceb7eb6d","2020-04-21T20:00:00Z",324,1581,58831,58354,58354,51,24,81,979,640,1619
"2123",20200421,"VI",54,574,35,NA,NA,NA,NA,NA,NA,48,"","4/21/2020 20:30","24084710924e935bf399a73dce9d7f101e8778e1","2020-04-21T20:00:00Z",3,NA,663,628,628,78,0,0,20,1,21
"2124",20200421,"VT",828,11767,NA,41,NA,NA,NA,NA,NA,NA,"A","4/21/2020 00:00","91030492f3134d070aa56a2e4e0fed13ba57d213","2020-04-21T20:00:00Z",40,NA,12595,12595,12595,50,2,0,96,8,104
"2125",20200421,"WA",13051,152469,NA,503,NA,161,NA,NA,NA,NA,"C","4/21/2020 00:00","96006e333a254778c36e5971065d783d0c17c9bc","2020-04-21T20:00:00Z",640,NA,165520,165520,165520,53,11,0,4806,264,5070
"2126",20200421,"WI",4620,47841,219,358,1252,137,324,NA,NA,NA,"A","4/21/2020 16:00","6cdefbfacc351b907e1ea1de684f852fdcecd4c7","2020-04-21T20:00:00Z",242,1252,52680,52461,52461,55,12,41,1238,121,1359
"2127",20200421,"WV",914,21849,NA,85,NA,42,NA,24,NA,330,"B","4/21/2020 17:00","cb4c762bc70c394145d464a43173eb2615a00b50","2020-04-21T20:00:00Z",26,NA,22763,22763,22763,54,2,0,596,12,608
"2128",20200421,"WY",320,7301,NA,19,52,NA,NA,NA,NA,237,"A","4/21/2020 16:20","1532019457f17b0c5b237147ba070dcde7a13747","2020-04-21T20:00:00Z",6,52,7621,7621,7621,56,4,1,228,7,235
"2129",20200420,"AK",321,9803,NA,46,36,NA,NA,NA,NA,161,"A","4/20/2020 14:00","30dd3c48023b92f7b1983b7341941c5f7a3a0c70","2020-04-20T20:00:00Z",9,36,10124,10124,10124,2,0,0,227,2,229
"2130",20200420,"AL",5025,40875,NA,NA,641,NA,260,NA,157,NA,"B","4/20/2020 00:00","f4f5f8be98d9e019afc9c29f5b47e5b2403c3f82","2020-04-20T20:00:00Z",167,641,45900,45900,45900,1,13,0,0,188,188
"2131",20200420,"AR",1923,24630,NA,93,291,NA,NA,24,57,749,"A","4/20/2020 14:30","bb81f8dd15433a86866d3f7cf262a144eca45e58","2020-04-20T20:00:00Z",42,291,26553,26553,26553,5,2,0,2202,142,2344
"2132",20200420,"AS",0,3,17,NA,NA,NA,NA,NA,NA,NA,"","4/6/2020 00:00","abbc5d7ad6f311a7bd3e4de2c62e46ff95264f53","2020-04-20T20:00:00Z",NA,NA,20,3,3,60,0,0,0,0,0
"2133",20200420,"AZ",5064,49436,NA,637,NA,285,NA,181,NA,1155,"B","4/20/2020 00:00","b5216bfdde34cf4504c3fb8c2ec20f16e07e1f0b","2020-04-20T20:00:00Z",187,NA,54500,54500,54500,4,3,0,1375,135,1510
"2134",20200420,"CA",30978,259522,NA,4674,NA,1480,NA,NA,NA,NA,"B","4/19/2020 00:00","4d62a16f73d79a9551aea64d1b545e3f9ce29591","2020-04-20T20:00:00Z",1208,NA,290500,290500,290500,6,42,0,8955,645,9600
"2135",20200420,"CO",9730,36465,NA,874,1813,NA,NA,NA,NA,NA,"A","4/18/2020 00:00","e41edc525a7e25a698a226366f8dd0941de1ec4e","2020-04-20T20:00:00Z",422,1813,46195,46195,46195,8,11,16,1292,297,1589
"2136",20200420,"CT",19815,42991,NA,1919,NA,NA,NA,NA,NA,NA,"A","4/20/2020 16:00","53c20b0beed446b253dc15b63b43dca1dae2a7c6","2020-04-20T20:00:00Z",1331,NA,62806,62806,62806,9,245,0,2328,2265,4593
"2137",20200420,"DC",2927,11186,NA,402,NA,120,NA,69,NA,630,"A","4/19/2020 00:00","f5546fb0e438da62819d4c873da24defd055520b","2020-04-20T20:00:00Z",105,NA,14113,14113,14113,11,9,0,280,134,414
"2138",20200420,"DE",2745,12508,NA,256,NA,NA,NA,NA,NA,495,"A","4/20/2020 12:00","5937e7abf75895b4bec3baaba183e2c3ced62d68","2020-04-20T20:00:00Z",72,NA,15253,15253,15253,10,5,0,252,207,459
"2139",20200420,"FL",26660,239565,1104,NA,4010,NA,NA,NA,NA,NA,"A","4/20/2020 09:28","3656ac1db77419592df09ec362794e1f056c3c8f","2020-04-20T20:00:00Z",806,4010,267329,266225,266225,12,25,80,9482,664,10146
"2140",20200420,"GA",18947,65381,NA,NA,3550,NA,NA,NA,NA,NA,"A","4/20/2020 11:27","0a13a48157b3cbad387a806aac1aebfd61079a4e","2020-04-20T20:00:00Z",733,3550,84328,84328,84328,13,46,86,3749,646,4395
"2141",20200420,"GU",133,991,NA,3,NA,2,NA,NA,NA,112,"","4/20/2020 06:50","8db5d1e4f0ea3f4552cb79aad8d273dba76b7002","2020-04-20T20:00:00Z",5,NA,1124,1124,1124,66,0,0,48,0,48
"2142",20200420,"HI",580,23595,NA,NA,52,NA,NA,NA,NA,414,"A","4/19/2020 18:00","ed2c32504d71ba76bfa7d68d68aae0c95c0f50a4","2020-04-20T20:00:00Z",10,52,24175,24175,24175,15,1,1,699,6,705
"2143",20200420,"IA",3159,22661,NA,214,NA,91,NA,58,NA,1235,"A","4/19/2020 12:00","efe158e52f181c09d278ba997c195e1c8495932a","2020-04-20T20:00:00Z",79,NA,25820,25820,25820,19,4,0,1013,257,1270
"2144",20200420,"ID",1672,15773,NA,NA,151,NA,53,NA,NA,585,"A","4/19/2020 19:00","f8fe7e4f1a3a0b5ee1d0e1b2adb45c850c59f24f","2020-04-20T20:00:00Z",45,151,17445,17445,17445,16,1,0,0,4,4
"2145",20200420,"IL",31508,116850,NA,4599,NA,1239,NA,757,NA,NA,"A","4/20/2020 00:00","583888fe4cde2d86f0ccd133a3f338a70ca2b7fe","2020-04-20T20:00:00Z",1349,NA,148358,148358,148358,17,59,0,3889,1151,5040
"2146",20200420,"IN",11686,52953,NA,NA,NA,669,NA,353,NA,NA,"B","4/19/2020 23:59","a7044248ca8965900a72d61c0b451eadaee3e04c","2020-04-20T20:00:00Z",569,NA,64639,64639,64639,18,7,0,3021,476,3497
"2147",20200420,"KS",1986,16775,NA,NA,405,NA,NA,NA,NA,NA,"B","4/20/2020 12:00","8a7676f0eb1b9233e0f2b1538dc2cd7d904414bb","2020-04-20T20:00:00Z",100,405,18761,18761,18761,20,8,15,494,137,631
"2148",20200420,"KY",2960,29612,NA,274,1059,155,534,NA,NA,1174,"A","4/19/2020 17:00","3b8f16f73872913ae958b42672a3bedc64d0b540","2020-04-20T20:00:00Z",148,1059,32572,32572,32572,21,4,0,94,253,347
"2149",20200420,"LA",24523,111588,NA,1794,NA,NA,NA,332,NA,NA,"A","4/20/2020 13:00","38abf630dad92ebdb931c40d3c1716294e651e24","2020-04-20T20:00:00Z",1328,NA,136111,136111,136111,22,32,0,168,595,763
"2150",20200420,"MA",41416,136046,NA,3872,3872,987,NA,NA,NA,NA,"B","4/19/2020 16:00","b0b76a2bc89eab3190b9fdeaf955c35c1a52c82e","2020-04-20T20:00:00Z",2303,3872,177462,177462,177462,25,157,83,6751,1596,8347
"2151",20200420,"MD",13684,57713,NA,NA,3014,NA,NA,NA,NA,917,"A","4/20/2020 10:00","eba3c9c49d453b7c1f6842ecee003e64cbeebd8e","2020-04-20T20:00:00Z",582,3014,71397,71397,71397,24,34,128,2652,854,3506
"2152",20200420,"ME",875,14076,NA,39,138,16,NA,9,NA,414,"A","4/20/2020 11:15","beb8d967cbc0ff9345f35494afe2651d2c990a3d","2020-04-20T20:00:00Z",35,138,14951,14951,14951,23,1,2,0,8,8
"2153",20200420,"MI",32000,81798,NA,3374,NA,1346,NA,1102,NA,3237,"B","4/20/2020 11:00","ac04a67cda8fbbc4db201cc16cc9e18cde447fcf","2020-04-20T20:00:00Z",2468,NA,113798,113798,113798,26,77,0,3561,576,4137
"2154",20200420,"MN",2470,44380,NA,237,602,126,241,NA,NA,1059,"A","4/20/2020 12:00","b77a8f706f27e40e4b48ed70b2078a811a288c03","2020-04-20T20:00:00Z",143,602,46850,46850,46850,27,9,28,1020,114,1134
"2155",20200420,"MO",5807,50206,NA,873,NA,NA,NA,NA,NA,NA,"A","4/20/2020 15:00","540cce0f343724ac39beacb4724768faa22863a5","2020-04-20T20:00:00Z",177,NA,56013,56013,56013,29,1,0,1964,140,2104
"2156",20200420,"MP",14,51,NA,NA,NA,NA,NA,NA,NA,11,"","4/20/2020 00:00","143a2d6edbe1f7695036432c74441ee6f2b96e8f","2020-04-20T20:00:00Z",2,NA,65,65,65,69,0,0,9,0,9
"2157",20200420,"MS",4512,46922,NA,548,819,146,NA,89,NA,NA,"A","4/19/2020 19:00","b734c4f702a37b03450b6d3d99b6bf29dbd21377","2020-04-20T20:00:00Z",169,819,51434,51434,51434,28,10,11,12131,238,12369
"2158",20200420,"MT",433,10618,NA,19,57,NA,NA,NA,NA,243,"A","4/20/2020 11:00","f54d522c346625fb599af8de28975eac874c9f0a","2020-04-20T20:00:00Z",10,57,11051,11051,11051,30,0,2,153,0,153
"2159",20200420,"NC",6764,72720,NA,373,NA,NA,NA,NA,NA,NA,"A","4/20/2020 10:35","cba31b0de262f1285f0e5e73075bc925d94d897c","2020-04-20T20:00:00Z",179,NA,79484,79484,79484,37,7,0,441,271,712
"2160",20200420,"ND",627,14120,NA,17,53,NA,NA,NA,NA,189,"B","4/20/2020 13:00","908db4b086c4b63d6b9a9c88ab4bb4b3618073af","2020-04-20T20:00:00Z",13,53,14747,14747,14747,38,3,2,1075,42,1117
"2161",20200420,"NE",1474,14206,NA,NA,NA,NA,NA,NA,NA,NA,"A","4/19/2020 19:45","c8a484879646349082118b52e561ca1c1d75c03c","2020-04-20T20:00:00Z",28,NA,15680,15680,15680,31,0,0,918,187,1105
"2162",20200420,"NH",1392,12726,298,79,198,NA,NA,NA,NA,521,"B","4/19/2020 09:00","ad86cc0d4840ae00f043e959fd024d6e370fb666","2020-04-20T20:00:00Z",41,198,14416,14118,14118,33,3,6,644,50,694
"2163",20200420,"NJ",88806,89251,NA,6986,NA,2018,NA,1594,NA,NA,"A","4/20/2020 13:00","ec5aa56b0d559cbb26683575718e12c6802c8d60","2020-04-20T20:00:00Z",4377,NA,178057,178057,178057,34,175,0,3864,3505,7369
"2164",20200420,"NM",1845,35197,NA,103,274,NA,NA,NA,NA,487,"A","4/19/2020 18:46","3b8e585db8418dce8dfc9c53b4adb6408a199c4b","2020-04-20T20:00:00Z",55,274,37042,37042,37042,35,2,16,363,47,410
"2165",20200420,"NV",3830,28517,NA,NA,NA,NA,NA,NA,NA,NA,"A","4/20/2020 10:00","f83e1119b54c8cb600d1538ea8709592bc664db7","2020-04-20T20:00:00Z",158,NA,32347,32347,32347,32,3,0,647,102,749
"2166",20200420,"NY",247512,386349,NA,16103,55188,5016,NA,NA,NA,39085,"A","4/20/2020 00:00","e5769a5285400a82169840a149ddbb3f54394b58","2020-04-20T20:00:00Z",14347,55188,633861,633861,633861,36,478,1379,11580,4726,16306
"2167",20200420,"OH",12919,77920,NA,NA,2653,NA,798,NA,NA,NA,"B","4/20/2020 14:00","c0768162cc123ef583fa656ba982394b0b837e80","2020-04-20T20:00:00Z",509,2653,90839,90839,90839,39,38,88,2223,1317,3540
"2168",20200420,"OK",2680,32966,NA,307,541,136,NA,NA,NA,1614,"B","4/20/2020 00:00","d5c2f362df76480860a6ea7c9fae6ebb1c799b0f","2020-04-20T20:00:00Z",143,541,35646,35646,35646,40,3,0,0,81,81
"2169",20200420,"OR",1956,38089,NA,303,465,74,NA,35,NA,NA,"A","4/20/2020 11:00","b04e183344652e70a88da9d35894b469dfe60993","2020-04-20T20:00:00Z",75,465,40045,40045,40045,41,1,9,961,46,1007
"2170",20200420,"PA",33232,129720,NA,2701,NA,NA,NA,659,NA,NA,"A","4/20/2020 12:00","0fbe6948410331db5f1677132c2dd2e1b02e612f","2020-04-20T20:00:00Z",1204,NA,162952,162952,162952,42,92,0,3150,948,4098
"2171",20200420,"PR",1252,8486,1895,NA,NA,NA,NA,NA,NA,NA,"A","4/20/2020 06:30","36eecf590ddf959b3d5bed3a9d59d77a180fe60c","2020-04-20T20:00:00Z",63,NA,11633,9738,9738,72,1,0,206,39,245
"2172",20200420,"RI",5098,31990,NA,297,629,62,NA,45,NA,267,"B","4/20/2020 00:00","cca8525098c08ad59a3f580e9c5c0f49f834d197","2020-04-20T20:00:00Z",175,629,37088,37088,37088,44,11,24,1997,343,2340
"2173",20200420,"SC",4377,36103,NA,NA,776,NA,NA,NA,NA,2063,"B","4/19/2020 15:30","4800dca459607cac7fc4378eb8a43661cb3f3e0c","2020-04-20T20:00:00Z",120,776,40480,40480,40480,45,0,0,0,0,0
"2174",20200420,"SD",1685,10641,0,NA,87,NA,NA,NA,NA,709,"A","4/19/2020 18:00","3e8aec97e078213afdd902ff843d4e12b4076972","2020-04-20T20:00:00Z",7,87,12326,12326,12326,46,0,13,214,50,264
"2175",20200420,"TN",7238,93451,NA,NA,730,NA,NA,NA,NA,3575,"A","4/20/2020 15:00","a4ee2552d990e0f9d543a9e015f399466e751f7d","2020-04-20T20:00:00Z",152,730,100689,100689,100689,47,4,6,3423,168,3591
"2176",20200420,"TX",19458,170936,NA,1411,NA,NA,NA,NA,NA,5706,"A","4/20/2020 12:45","1832d8a3e16628cebf0685e1d7a88d96be6ad83a","2020-04-20T20:00:00Z",495,NA,190394,190394,190394,48,18,0,7149,535,7684
"2177",20200420,"UT",3213,65098,NA,NA,268,NA,NA,NA,NA,776,"A","4/20/2020 15:00","dc22e4988a5fddebe2ebfe33ea6d37fe51d22d88","2020-04-20T20:00:00Z",28,268,68311,68311,68311,49,1,9,4612,144,4756
"2178",20200420,"VA",8990,47745,468,1296,1500,396,NA,237,NA,1324,"A","4/20/2020 00:00","6d6994f7dd160ccfd3ff00ca1dcadfc51ab87c1a","2020-04-20T20:00:00Z",300,1500,57203,56735,56735,51,23,78,1549,453,2002
"2179",20200420,"VI",53,554,18,NA,NA,NA,NA,NA,NA,48,"","4/19/2020 20:30","4f1c4886474a3975fd88ca3976b6a5e4acd0d712","2020-04-20T20:00:00Z",3,NA,625,607,607,78,0,0,6,0,6
"2180",20200420,"VT",820,11671,NA,49,NA,NA,NA,NA,NA,15,"A","4/20/2020 00:00","10869f316f7d66a682b2d88f5d1dd78059400c05","2020-04-20T20:00:00Z",38,NA,12491,12491,12491,50,0,0,221,3,224
"2181",20200420,"WA",12787,147663,NA,403,NA,122,NA,NA,NA,NA,"C","4/20/2020 00:00","77f5bf1928661523a070bafaae611bce9024f0bd","2020-04-20T20:00:00Z",629,NA,160450,160450,160450,53,14,0,4350,326,4676
"2182",20200420,"WI",4499,46603,237,406,1211,168,307,NA,NA,NA,"A","4/20/2020 16:00","8062dc2a846905a0d02f8cc7df651c0abdce4b88","2020-04-20T20:00:00Z",230,1211,51339,51102,51102,55,10,21,1280,153,1433
"2183",20200420,"WV",902,21253,NA,77,NA,37,NA,23,NA,290,"B","4/20/2020 10:00","1357215516a198143770e3746905b8e1167d1d95","2020-04-20T20:00:00Z",24,NA,22155,22155,22155,54,6,0,2085,39,2124
"2184",20200420,"WY",313,7073,NA,19,51,NA,NA,NA,NA,233,"A","4/19/2020 00:00","cac3bf9e707fcc0a1212f5a098b58025505bbaf0","2020-04-20T20:00:00Z",2,51,7386,7386,7386,56,0,1,101,4,105
"2185",20200419,"AK",319,9576,NA,37,36,NA,NA,NA,NA,153,"A","4/18/2020 17:45","569fd3a647b33e4e1a5f9cbeaacd3c1775fac110","2020-04-19T20:00:00Z",9,36,9895,9895,9895,2,0,0,235,5,240
"2186",20200419,"AL",4837,40875,NA,NA,641,NA,260,NA,157,NA,"B","4/19/2020 00:00","0edbbe83d5ad6d22588b9e1a606322130f9d92ed","2020-04-19T20:00:00Z",154,641,45712,45712,45712,1,8,21,2992,182,3174
"2187",20200419,"AR",1781,22428,NA,88,291,NA,NA,25,57,721,"A","4/19/2020 18:47","ae84614fc686051815d722eb411e893386d868ed","2020-04-19T20:00:00Z",40,291,24209,24209,24209,5,2,0,26,42,68
"2188",20200419,"AS",0,3,17,NA,NA,NA,NA,NA,NA,NA,"","4/6/2020 00:00","293d9cc32587d91ec0d9be031db70699327b0c1b","2020-04-19T20:00:00Z",NA,NA,20,3,3,60,0,0,0,0,0
"2189",20200419,"AZ",4929,48061,NA,631,NA,283,NA,187,NA,994,"B","4/19/2020 00:00","980ec0db678e80d55372a542aa6c35027830cea1","2020-04-19T20:00:00Z",184,NA,52990,52990,52990,4,7,0,1735,210,1945
"2190",20200419,"CA",30333,250567,7200,4731,NA,1457,NA,NA,NA,NA,"B","4/18/2020 00:00","56222d3bdcb2144d6086d1c3c2e7954fa8b94032","2020-04-19T20:00:00Z",1166,NA,288100,280900,280900,6,94,0,19864,1370,21234
"2191",20200419,"CO",9433,35173,NA,874,1797,NA,NA,NA,NA,NA,"A","4/17/2020 00:00","7c76ac80a592dde039368039d32bf379d5e7c2ca","2020-04-19T20:00:00Z",411,1797,44606,44606,44606,8,20,42,913,386,1299
"2192",20200419,"CT",17550,40663,NA,1938,NA,NA,NA,NA,NA,NA,"A","4/19/2020 17:00","74655c4ea8570c760f68d19303254c80a46986d8","2020-04-19T20:00:00Z",1086,NA,58213,58213,58213,9,50,0,2010,741,2751
"2193",20200419,"DC",2793,10906,NA,313,NA,105,NA,79,NA,622,"A","4/18/2020 00:00","81e579a0aa9313dd9b1935e17d10ca1339b9438b","2020-04-19T20:00:00Z",96,NA,13699,13699,13699,11,5,0,304,127,431
"2194",20200419,"DE",2538,12256,NA,249,NA,NA,NA,NA,NA,466,"A","4/18/2020 17:00","9087c4ec73a2ac89e38b02af7bbae9ae12ff1e09","2020-04-19T20:00:00Z",67,NA,14794,14794,14794,10,6,0,562,215,777
"2195",20200419,"FL",25996,230083,1179,NA,3930,NA,NA,NA,NA,NA,"A","4/19/2020 16:12","3b2b9bc60a3ffd34783ba751b973d6a4e31149c7","2020-04-19T20:00:00Z",781,3930,257258,256079,256079,12,27,88,8825,727,9552
"2196",20200419,"GA",18301,61632,NA,NA,3464,NA,NA,NA,NA,NA,"A","4/19/2020 21:34","c96acdbcb9627262fd925795a493aec842a8d01b","2020-04-19T20:00:00Z",687,3464,79933,79933,79933,13,14,44,5093,632,5725
"2197",20200419,"GU",133,943,NA,6,NA,2,NA,NA,NA,112,"","4/19/2020 05:00","fa3ab863f1ebcc0d4f2aad919cb44ff15975acd6","2020-04-19T20:00:00Z",5,NA,1076,1076,1076,66,0,0,0,0,0
"2198",20200419,"HI",574,22896,NA,NA,51,NA,NA,NA,NA,410,"A","4/19/2020 18:00","f5d5297282dadec007427f163e1837b6a764a20b","2020-04-19T20:00:00Z",9,51,23470,23470,23470,15,0,3,1106,21,1127
"2199",20200419,"IA",2902,21648,NA,198,NA,86,NA,54,NA,1171,"A","4/18/2020 12:00","b91fd70519ab5c1bb7dc10929fa3a500d373d355","2020-04-19T20:00:00Z",75,NA,24550,24550,24550,19,1,0,1214,389,1603
"2200",20200419,"ID",1668,15773,NA,NA,151,NA,53,NA,NA,520,"A","4/19/2020 19:00","c8da0239c0eab6dd97f4a773ae688bda33cf230e","2020-04-19T20:00:00Z",44,151,17441,17441,17441,16,1,0,481,13,494
"2201",20200419,"IL",30357,112961,NA,4314,NA,1196,NA,749,NA,NA,"A","4/19/2020 00:00","0fb2cae0ff5350cbfbf4d0891c4a1cbb2ef14bcd","2020-04-19T20:00:00Z",1290,NA,143318,143318,143318,17,31,0,4717,1197,5914
"2202",20200419,"IN",11210,49932,NA,NA,NA,649,NA,342,NA,NA,"B","4/18/2020 23:59","1c8eeb40c1b34cf76c155504ffb737c1d65348b6","2020-04-19T20:00:00Z",562,NA,61142,61142,61142,18,17,0,3700,569,4269
"2203",20200419,"KS",1849,16281,NA,NA,390,NA,NA,NA,NA,NA,"B","4/19/2020 12:00","80a42449030ccb8ef418f40c3bcd50cf06128690","2020-04-19T20:00:00Z",92,390,18130,18130,18130,20,6,7,395,59,454
"2204",20200419,"KY",2707,29518,NA,274,1059,155,534,NA,NA,1174,"A","4/19/2020 17:00","cbbc8c4eb54b8bed3c367848ada9004f9ba3cb15","2020-04-19T20:00:00Z",144,1059,32225,32225,32225,21,7,51,1444,185,1629
"2205",20200419,"LA",23928,111420,NA,1748,NA,NA,NA,349,NA,NA,"A","4/19/2020 13:00","96e4ade27ef5b0a8bb7174ec21847d75de056d37","2020-04-19T20:00:00Z",1296,NA,135348,135348,135348,22,29,0,-2999,348,-2651
"2206",20200419,"MA",39820,129295,NA,3789,3789,987,NA,NA,NA,NA,"B","4/19/2020 16:00","f9be253a4b7da67584fddf961235fd5a86322eb7","2020-04-19T20:00:00Z",2146,3789,169115,169115,169115,25,163,61,4691,2293,6984
"2207",20200419,"MD",12830,55061,NA,NA,2886,NA,NA,NA,NA,914,"A","4/19/2020 10:00","a6c152d3e1948a3a284659500e93ee5326944581","2020-04-19T20:00:00Z",548,2886,67891,67891,67891,24,14,129,1999,522,2521
"2208",20200419,"ME",867,14076,NA,46,136,18,NA,9,NA,393,"A","4/19/2020 11:15","ea3c8c6aefd4f7f46a18825ea19ee0c7516f836c","2020-04-19T20:00:00Z",34,136,14943,14943,14943,23,2,0,0,20,20
"2209",20200419,"MI",31424,78237,NA,3403,NA,1344,NA,1115,NA,3237,"B","4/19/2020 11:00","6c66546727d250f45fc000b77be67c14ef3eb506","2020-04-19T20:00:00Z",2391,NA,109661,109661,109661,26,83,0,9301,633,9934
"2210",20200419,"MN",2356,43360,NA,228,574,116,226,NA,NA,1026,"A","4/19/2020 12:00","ac98dcd53d478cc1c63633657246476594bdb9ec","2020-04-19T20:00:00Z",134,574,45716,45716,45716,27,13,13,1305,143,1448
"2211",20200419,"MO",5667,48242,NA,875,NA,NA,NA,NA,NA,NA,"A","4/19/2020 15:00","44ebbe4ce36927e83468750f4784b100689ab315","2020-04-19T20:00:00Z",176,NA,53909,53909,53909,29,1,0,0,150,150
"2212",20200419,"MP",14,42,4,NA,NA,NA,NA,NA,NA,9,"","4/19/2020 00:00","e12786d33112c0e47c27d0260fc7e44b1dd56717","2020-04-19T20:00:00Z",2,NA,60,56,56,69,0,0,0,0,0
"2213",20200419,"MS",4274,34791,NA,NA,808,138,NA,79,NA,NA,"A","4/18/2020 19:00","01a63fe694b592c138ba4d52a94516e781e6c369","2020-04-19T20:00:00Z",159,808,39065,39065,39065,28,7,26,0,300,300
"2214",20200419,"MT",433,10465,NA,18,55,NA,NA,NA,NA,243,"A","4/19/2020 11:40","62cfb766c33dfcdaaa482f39585e261c63f9e730","2020-04-19T20:00:00Z",10,55,10898,10898,10898,30,0,0,322,7,329
"2215",20200419,"NC",6493,72279,NA,465,NA,NA,NA,NA,NA,NA,"A","4/19/2020 11:00","d3fca6428ed30931e642397804cf0a59e9b0ba76","2020-04-19T20:00:00Z",172,NA,78772,78772,78772,37,8,0,2208,353,2561
"2216",20200419,"ND",585,13045,NA,15,51,NA,NA,NA,NA,189,"B","4/19/2020 13:00","030542b9e991bc5778f546d0408d280dad1ef1f5","2020-04-19T20:00:00Z",10,51,13630,13630,13630,38,1,4,610,57,667
"2217",20200419,"NE",1287,13288,NA,NA,NA,NA,NA,NA,NA,NA,"A","4/19/2020 19:45","acc3eb557a9bcd0dc7e3c7b2a4a8db77d9de2a31","2020-04-19T20:00:00Z",28,NA,14575,14575,14575,31,4,0,749,149,898
"2218",20200419,"NH",1342,12082,316,85,192,NA,NA,NA,NA,513,"B","4/19/2020 09:00","5a18c571738b1c56001c22ba7cbb29227a32bc94","2020-04-19T20:00:00Z",38,192,13740,13424,13424,33,1,2,517,55,572
"2219",20200419,"NJ",85301,85387,NA,7494,NA,1940,NA,1628,NA,NA,"A","4/19/2020 13:00","8dc8cc4c3780834d9ecf0fef1795c4c343867daf","2020-04-19T20:00:00Z",4202,NA,170688,170688,170688,34,132,0,4271,3881,8152
"2220",20200419,"NM",1798,34834,NA,92,258,NA,NA,NA,NA,465,"A","4/19/2020 19:46","30fe168033cce666159e8eaec31501b79b388c94","2020-04-19T20:00:00Z",53,258,36632,36632,36632,35,2,16,932,87,1019
"2221",20200419,"NV",3728,27870,NA,NA,NA,NA,NA,NA,NA,NA,"A","4/19/2020 11:00","558d86313668a0014e841fff7759dcc0086998a8","2020-04-19T20:00:00Z",155,NA,31598,31598,31598,32,4,0,745,102,847
"2222",20200419,"NY",242786,374769,NA,16213,53809,5016,NA,NA,NA,37596,"A","4/19/2020 00:00","c07d777fa2eb54c916a185604eea75744ac21d75","2020-04-19T20:00:00Z",13869,53809,617555,617555,617555,36,507,1384,14969,6054,21023
"2223",20200419,"OH",11602,75697,NA,NA,2565,NA,765,NA,NA,NA,"B","4/19/2020 14:00","b2ffdfd36daec3b653ae537cfbd65384265fa651","2020-04-19T20:00:00Z",471,2565,87299,87299,87299,39,20,46,6878,1380,8258
"2224",20200419,"OK",2599,32966,NA,307,541,136,NA,NA,NA,1575,"B","4/19/2020 00:00","e8cc99a80920f7764b89be62b51f4235cff97fea","2020-04-19T20:00:00Z",140,541,35565,35565,35565,40,1,0,0,29,29
"2225",20200419,"OR",1910,37128,NA,290,456,74,NA,37,NA,NA,"A","4/19/2020 11:00","e67ba0a19b06b5c11ded8ee3c9de44f1ef407fa5","2020-04-19T20:00:00Z",74,456,39038,39038,39038,41,2,7,1389,66,1455
"2226",20200419,"PA",32284,126570,NA,2634,NA,NA,NA,657,NA,NA,"A","4/19/2020 13:00","24719e130c3e8e24579a61df4c14e6a427f4b3c2","2020-04-19T20:00:00Z",1112,NA,158854,158854,158854,42,276,0,3674,1215,4889
"2227",20200419,"PR",1213,8280,1839,NA,NA,NA,NA,NA,NA,NA,"A","4/19/2020 07:00","37f5a90bb6cafaa45f9a09c65db7a195479865e1","2020-04-19T20:00:00Z",62,NA,11332,9493,9493,72,2,0,225,95,320
"2228",20200419,"RI",4755,29993,NA,298,605,66,NA,37,NA,244,"B","4/19/2020 00:00","bbcf2cbdf1e8c5b0ddf75e34852f8c97e949dfb0","2020-04-19T20:00:00Z",164,605,34748,34748,34748,44,14,27,1658,276,1934
"2229",20200419,"SC",4377,36103,NA,NA,776,NA,NA,NA,NA,2633,"B","4/19/2020 15:30","29eb3a2ca7ecc4f977f091d02b1df24904a179a1","2020-04-19T20:00:00Z",120,776,40480,40480,40480,45,1,0,1516,131,1647
"2230",20200419,"SD",1635,10427,0,NA,74,NA,NA,NA,NA,646,"A","4/19/2020 12:30","9124e5cae7642160658d01a62a52bd10eed076da","2020-04-19T20:00:00Z",7,74,12062,12062,12062,46,0,6,309,93,402
"2231",20200419,"TN",7070,90028,NA,NA,724,NA,NA,NA,NA,3344,"A","4/19/2020 15:00","19d9b34c662abd6402b05fd05b914667b6722d0f","2020-04-19T20:00:00Z",148,724,97098,97098,97098,47,3,5,6204,308,6512
"2232",20200419,"TX",18923,163787,NA,1471,NA,NA,NA,NA,NA,5334,"A","4/19/2020 13:00","30c45b94d19beabfcb1ed7e182b48fe7ea3d782e","2020-04-19T20:00:00Z",477,NA,182710,182710,182710,48,24,0,5808,663,6471
"2233",20200419,"UT",3069,60486,NA,NA,259,NA,NA,NA,NA,679,"A","4/19/2020 15:00","9cd5bba336203ce021f5b08eca3f2a9099381efe","2020-04-19T20:00:00Z",27,259,63555,63555,63555,49,2,8,3473,138,3611
"2234",20200419,"VA",8537,46196,499,1319,1422,388,NA,231,NA,1267,"A","4/19/2020 00:00","28c5a7800b440e3fb5029cdcbdcb375b435ddcae","2020-04-19T20:00:00Z",277,1422,55232,54733,54733,51,19,126,2318,484,2802
"2235",20200419,"VI",53,548,22,NA,NA,NA,NA,NA,NA,48,"","4/19/2020 20:30","7e79b0e1bb08a64cfd5ed34be2e987c36e67a43b","2020-04-19T20:00:00Z",3,NA,623,601,601,78,0,0,158,0,158
"2236",20200419,"VT",817,11450,NA,53,NA,NA,NA,NA,NA,15,"A","4/19/2020 00:00","0f90854cb5622a131197af11f3f0c2cf22feb241","2020-04-19T20:00:00Z",38,NA,12267,12267,12267,50,0,0,238,4,242
"2237",20200419,"WA",12461,143313,NA,586,NA,193,NA,NA,NA,NA,"C","4/19/2020 00:00","33a891f94f226e0e004cb311a122db9d62f45746","2020-04-19T20:00:00Z",615,NA,155774,155774,155774,53,17,0,1432,89,1521
"2238",20200419,"WI",4346,45323,248,397,1190,162,307,NA,NA,NA,"A","4/19/2020 12:57","ffac3fc7fa9a931bbcc45021b0bea59b70162aee","2020-04-19T20:00:00Z",220,1190,49917,49669,49669,55,9,14,1361,147,1508
"2239",20200419,"WV",863,19168,NA,72,NA,37,NA,25,NA,265,"B","4/19/2020 17:00","efa1761aa288fd532175b06e5f54b8ee2cd9147e","2020-04-19T20:00:00Z",18,NA,20031,20031,20031,54,2,0,513,78,591
"2240",20200419,"WY",309,6972,NA,19,50,NA,NA,NA,NA,227,"A","4/19/2020 00:00","0c6344538df4134f81456c15f1c0a684e071ab64","2020-04-19T20:00:00Z",2,50,7281,7281,7281,56,0,0,755,4,759
"2241",20200418,"AK",314,9341,NA,39,36,NA,NA,NA,NA,147,"A","4/18/2020 14:15","4a258b3ac6ee52fadca070fecba2d54592793c39","2020-04-18T20:00:00Z",9,36,9655,9655,9655,2,0,0,200,5,205
"2242",20200418,"AL",4655,37883,NA,NA,620,NA,247,NA,148,NA,"B","4/18/2020 00:00","74a97a90c6ecfd5abbc7915ca9c56de166464e15","2020-04-18T20:00:00Z",146,620,42538,42538,42538,1,2,26,4565,125,4690
"2243",20200418,"AR",1739,22402,NA,86,291,NA,NA,22,57,703,"A","4/17/2020 19:00","8e816f3b3980de132cc494d4028d97e61e695fba","2020-04-18T20:00:00Z",38,291,24141,24141,24141,5,1,291,603,44,647
"2244",20200418,"AS",0,3,17,NA,NA,NA,NA,NA,NA,NA,"","4/6/2020 00:00","a7da2407a6739e29661337636a116c54d611d596","2020-04-18T20:00:00Z",NA,NA,20,3,3,60,0,0,0,0,0
"2245",20200418,"AZ",4719,46326,NA,566,NA,285,NA,178,NA,539,"B","4/18/2020 00:00","dbee78db9921dbf07871bdb40e3fde5d067f0dc4","2020-04-18T20:00:00Z",177,NA,51045,51045,51045,4,8,0,1603,212,1815
"2246",20200418,"CA",28963,230703,7200,4936,NA,1490,NA,NA,NA,NA,"B","4/17/2020 00:00","179b1f24abbfd97bac31c73ba2a3faefb3769984","2020-04-18T20:00:00Z",1072,NA,266866,259666,259666,6,87,0,6617,1435,8052
"2247",20200418,"CO",9047,34260,NA,843,1755,NA,NA,NA,NA,NA,"A","4/16/2020 00:00","315f03b158c3e851698c1445ef222ad94dca62c4","2020-04-18T20:00:00Z",391,1755,43307,43307,43307,8,17,62,1105,372,1477
"2248",20200418,"CT",16809,38653,NA,1946,NA,NA,NA,NA,NA,NA,"A","4/17/2020 16:00","54c69bc8538e5e064c3fba576ab1acc385ad1890","2020-04-18T20:00:00Z",1036,NA,55462,55462,55462,9,0,0,0,0,0
"2249",20200418,"DC",2666,10602,NA,313,NA,105,NA,79,NA,608,"A","4/17/2020 00:00","580f8c6bfa4d15c7ff5392c8ea46ecb89ff44be4","2020-04-18T20:00:00Z",91,NA,13268,13268,13268,11,5,0,435,190,625
"2250",20200418,"DE",2323,11694,NA,224,NA,NA,NA,NA,NA,423,"A","4/17/2020 17:00","5275ad4c8ae9357ea8a1c01ea6ac5bc2c3957cce","2020-04-18T20:00:00Z",61,NA,14017,14017,14017,10,0,0,0,0,0
"2251",20200418,"FL",25269,221258,0,NA,3842,NA,NA,NA,NA,NA,"A","4/18/2020 09:24","43767dfb9b986392a21de38aecb07811d38d5f9e","2020-04-18T20:00:00Z",754,3842,246527,246527,246527,12,55,177,10540,1150,11690
"2252",20200418,"GA",17669,56539,NA,NA,3420,NA,NA,NA,NA,NA,"A","4/18/2020 11:28","ee2a3d6771be92cd6f1d1c991096183b559cc7fa","2020-04-18T20:00:00Z",673,3420,74208,74208,74208,13,23,96,2049,475,2524
"2253",20200418,"GU",133,943,NA,6,NA,2,NA,NA,NA,110,"","4/18/2020 06:50","798b60a8253693867313519228b3aed6141abf67","2020-04-18T20:00:00Z",5,NA,1076,1076,1076,66,0,0,3,0,3
"2254",20200418,"HI",553,21790,NA,NA,48,NA,NA,NA,NA,390,"A","4/17/2020 18:30","c85a27054126dab091333473c5df5761eeb47cb9","2020-04-18T20:00:00Z",9,48,22343,22343,22343,15,0,3,474,12,486
"2255",20200418,"IA",2513,20434,NA,193,NA,84,NA,51,NA,1095,"A","4/17/2020 12:00","8585b7dd7907b7cf9b11817358170c6b7589fcaa","2020-04-18T20:00:00Z",74,NA,22947,22947,22947,19,10,0,974,181,1155
"2256",20200418,"ID",1655,15292,NA,NA,151,NA,53,NA,NA,453,"A","4/17/2020 19:00","b1077725211ea2ee95dacffd066fefad7cb0fdf3","2020-04-18T20:00:00Z",43,151,16947,16947,16947,16,2,3,249,46,295
"2257",20200418,"IL",29160,108244,NA,4340,NA,1192,NA,740,NA,NA,"A","4/18/2020 00:00","7c4a6ebb3606dd6cdd2b6f6aed1f5249ee36e6f1","2020-04-18T20:00:00Z",1259,NA,137404,137404,137404,17,125,0,5656,1585,7241
"2258",20200418,"IN",10641,46232,NA,NA,NA,663,NA,360,NA,NA,"B","4/17/2020 23:59","8f1f95dfb5ff34234faa39b370bca643bb61bb53","2020-04-18T20:00:00Z",545,NA,56873,56873,56873,18,26,0,1601,487,2088
"2259",20200418,"KS",1790,15886,NA,NA,383,NA,NA,NA,NA,NA,"B","4/18/2020 12:00","b1f3b48a6d2a1a16a039933018943f497794aa03","2020-04-18T20:00:00Z",86,383,17676,17676,17676,20,2,8,690,85,775
"2260",20200418,"KY",2522,28074,NA,360,1008,227,514,NA,NA,979,"A","4/17/2020 17:00","0999653bdf2eafbb13f74bfb2b9ebfde15057d6b","2020-04-18T20:00:00Z",137,1008,30596,30596,30596,21,8,37,756,93,849
"2261",20200418,"LA",23580,114419,NA,1761,NA,NA,NA,347,NA,NA,"A","4/18/2020 13:00","f2cd00ecb108ee909dfccd014025dbfa1744f89f","2020-04-18T20:00:00Z",1267,NA,137999,137999,137999,22,54,0,5550,462,6012
"2262",20200418,"MA",37527,124604,NA,3728,3728,987,NA,NA,NA,NA,"B","4/17/2020 16:00","01ab64cbbbeb5c55f9be6438aa6ed1efc4f97036","2020-04-18T20:00:00Z",1983,3728,162131,162131,162131,25,161,-28,7409,2402,9811
"2263",20200418,"MD",12308,53062,NA,NA,2757,NA,NA,NA,NA,771,"A","4/18/2020 10:00","0794942510e72aeb5d4622be52e41d16d26dda60","2020-04-18T20:00:00Z",534,2757,65370,65370,65370,24,40,145,2625,736,3361
"2264",20200418,"ME",847,14076,NA,49,136,20,NA,12,NA,382,"A","4/18/2020 15:00","e07a30dc6c6a44436345c8efc238e8d01d612e6c","2020-04-18T20:00:00Z",32,136,14923,14923,14923,23,3,3,0,20,20
"2265",20200418,"MI",30791,68936,NA,3634,NA,1423,NA,1203,NA,3237,"B","4/18/2020 11:00","2d5b47d442e01c4a53cfcc76e5587f88ba2226bb","2020-04-18T20:00:00Z",2308,NA,99727,99727,99727,26,81,0,0,768,768
"2266",20200418,"MN",2213,42055,NA,239,561,111,215,NA,NA,997,"A","4/17/2020 17:00","69ebe9dfd6ee629a2283357c5f11dc0a51ead316","2020-04-18T20:00:00Z",121,561,44268,44268,44268,27,10,43,1073,142,1215
"2267",20200418,"MO",5517,48242,NA,875,NA,NA,NA,NA,NA,NA,"A","4/18/2020 15:00","d592b0c82c965fb0d7298d490d1d62f06a780074","2020-04-18T20:00:00Z",175,NA,53759,53759,53759,29,10,0,1808,234,2042
"2268",20200418,"MP",14,42,4,NA,NA,NA,NA,NA,NA,9,"","4/17/2020 19:15","3bccd2f5aaeae2f7b657340e39577aa5ab0eebe8","2020-04-18T20:00:00Z",2,NA,60,56,56,69,0,0,0,1,1
"2269",20200418,"MS",3974,34791,NA,NA,782,154,NA,99,NA,NA,"A","4/17/2020 19:00","7319b32e2ea30bdf4a39778ef6bebd4f3eeb5675","2020-04-18T20:00:00Z",152,782,38765,38765,38765,28,12,46,0,181,181
"2270",20200418,"MT",426,10143,NA,17,55,NA,NA,NA,NA,234,"A","4/18/2020 10:18","2b2e75cdfaef2abfdcd2138da803f3b5e5b13638","2020-04-18T20:00:00Z",10,55,10569,10569,10569,30,2,1,321,4,325
"2271",20200418,"NC",6140,70071,NA,388,NA,NA,NA,NA,NA,NA,"A","4/18/2020 11:00","58614346a958be19ebcbf51e6c389c1e869ac60a","2020-04-18T20:00:00Z",164,NA,76211,76211,76211,37,12,0,2949,281,3230
"2272",20200418,"ND",528,12435,NA,13,47,NA,NA,NA,NA,183,"B","4/18/2020 13:08","82c0a51bf82259a8797027be36b950fb80a9d8fd","2020-04-18T20:00:00Z",9,47,12963,12963,12963,38,0,0,532,89,621
"2273",20200418,"NE",1138,12539,NA,NA,NA,NA,NA,NA,NA,NA,"A","4/17/2020 19:42","ee26d743bc12af182a6cc73cdcc0bc8142e5ade6","2020-04-18T20:00:00Z",24,NA,13677,13677,13677,31,0,0,501,72,573
"2274",20200418,"NH",1287,11565,174,86,190,NA,NA,NA,NA,468,"B","4/17/2020 09:00","66a513a6897b5f3915fd227379524d1d92e56393","2020-04-18T20:00:00Z",37,190,13026,12852,12852,33,0,0,144,0,144
"2275",20200418,"NJ",81420,81116,NA,7718,NA,2024,NA,1641,NA,NA,"A","4/18/2020 12:49","ecbb6fd911b3c8ca8f96b11a85e6a202ca86e72c","2020-04-18T20:00:00Z",4070,NA,162536,162536,162536,34,230,0,2134,2953,5087
"2276",20200418,"NM",1711,33902,NA,96,242,NA,NA,NA,NA,382,"A","4/17/2020 21:53","7a56c533581cffcb4bf5986d832643a4f7c2a21d","2020-04-18T20:00:00Z",51,242,35613,35613,35613,35,7,12,1011,114,1125
"2277",20200418,"NV",3626,27125,NA,NA,NA,NA,NA,NA,NA,NA,"A","4/18/2020 10:00","e8c7fb57e96c878693bbcebbfadfe88b681e5941","2020-04-18T20:00:00Z",151,NA,30751,30751,30751,32,9,0,887,102,989
"2278",20200418,"NY",236732,359800,NA,16967,52425,5016,NA,NA,NA,35458,"A","4/18/2020 00:00","4ad2fd5b599fc6179d536ede7719d0f24aaf5f56","2020-04-18T20:00:00Z",13362,52425,596532,596532,596532,36,540,1917,16219,7090,23309
"2279",20200418,"OH",10222,68819,NA,NA,2519,NA,760,NA,NA,NA,"B","4/18/2020 14:00","05767ed7353d0c349beca07f91d124a9c37ef063","2020-04-18T20:00:00Z",451,2519,79041,79041,79041,39,33,95,0,1115,1115
"2280",20200418,"OK",2570,32966,NA,307,541,136,NA,NA,NA,1515,"B","4/18/2020 00:00","2d655271f86a414ab0ebcadb03e12f74084970c0","2020-04-18T20:00:00Z",139,541,35536,35536,35536,40,3,13,1811,105,1916
"2281",20200418,"OR",1844,35739,NA,290,449,74,NA,37,NA,NA,"A","4/18/2020 11:00","d4c89788320088f305600fccb94f38f619605e5c","2020-04-18T20:00:00Z",72,449,37583,37583,37583,41,2,22,1203,59,1262
"2282",20200418,"PA",31069,122896,NA,2613,NA,NA,NA,660,NA,NA,"A","4/18/2020 12:00","beb544a82e8cab5b9b31022204795823d7fc68bd","2020-04-18T20:00:00Z",836,NA,153965,153965,153965,42,80,0,4964,1628,6592
"2283",20200418,"PR",1118,8055,1760,NA,NA,NA,NA,NA,NA,NA,"A","4/18/2020 07:00","c1780e0c8e41c604bfcdf751ebd534291c02f7ed","2020-04-18T20:00:00Z",60,NA,10933,9173,9173,72,2,0,191,50,241
"2284",20200418,"RI",4479,28335,NA,293,578,67,NA,43,NA,217,"B","4/18/2020 00:00","0f0643f55b03f4acd31357c9f54791da4079a700","2020-04-18T20:00:00Z",150,578,32814,32814,32814,44,32,247,1751,302,2053
"2285",20200418,"SC",4246,34587,NA,NA,776,NA,NA,NA,NA,2633,"B","4/18/2020 15:25","41d3450cc79dd12485e8c195a044dae6f40c6296","2020-04-18T20:00:00Z",119,776,38833,38833,38833,45,10,101,2234,315,2549
"2286",20200418,"SD",1542,10118,1,NA,68,NA,NA,NA,NA,552,"A","4/17/2020 18:00","52c9d623a9102bd8e28350d2e0cc18d6241f0b30","2020-04-18T20:00:00Z",7,68,11661,11660,11660,46,0,5,467,131,598
"2287",20200418,"TN",6762,83824,NA,NA,719,NA,NA,NA,NA,3234,"A","4/18/2020 15:00","16a0444be654f213a3302b6325f6e4fb691176a8","2020-04-18T20:00:00Z",145,719,90586,90586,90586,47,3,8,3140,173,3313
"2288",20200418,"TX",18260,157979,NA,1321,NA,NA,NA,NA,NA,4806,"A","4/18/2020 13:45","febc81e94b5eada27b04c4abaf0c2f76a2567afa","2020-04-18T20:00:00Z",453,NA,176239,176239,176239,48,25,0,5814,889,6703
"2289",20200418,"UT",2931,57013,NA,NA,251,NA,NA,NA,NA,565,"A","4/18/2020 15:00","cb3b8c869adb1bf673a51068139034db38dba9ba","2020-04-18T20:00:00Z",25,251,59944,59944,59944,49,2,7,4047,126,4173
"2290",20200418,"VA",8053,43878,486,1307,1296,398,NA,230,NA,1228,"A","4/17/2020 17:00","0f0d5ce8a839fee102533e679068cf0bb110d957","2020-04-18T20:00:00Z",258,1296,52417,51931,51931,51,27,75,2372,562,2934
"2291",20200418,"VI",53,390,35,NA,NA,NA,NA,NA,NA,46,"","4/18/2020 08:30","42d43be945df2ca9a123ac3572cd1f3aca0abf18","2020-04-18T20:00:00Z",3,NA,478,443,443,78,1,0,17,2,19
"2292",20200418,"VT",813,11212,NA,56,NA,NA,NA,NA,NA,15,"A","4/18/2020 00:00","e3ee71aee47035855a847063e5544a09810bba04","2020-04-18T20:00:00Z",38,NA,12025,12025,12025,50,3,0,399,11,410
"2293",20200418,"WA",12372,141881,NA,518,NA,155,NA,NA,NA,NA,"C","4/18/2020 00:00","83bf6c6f8c83fecb29f19eb75dd375faf9abea52","2020-04-18T20:00:00Z",598,NA,154253,154253,154253,53,13,0,2056,169,2225
"2294",20200418,"WI",4199,43962,229,361,1176,135,307,NA,NA,NA,"A","4/18/2020 12:45","d268170059db5bde5191aef9e784f5d0cc7b0bae","2020-04-18T20:00:00Z",211,1176,48390,48161,48161,55,6,23,1597,154,1751
"2295",20200418,"WV",785,18655,NA,83,NA,40,NA,27,NA,255,"B","4/17/2020 17:00","52159d44548b3002a205ebb7ebfd6c44953ada85","2020-04-18T20:00:00Z",16,NA,19440,19440,19440,54,3,0,728,31,759
"2296",20200418,"WY",305,6217,NA,19,50,NA,NA,NA,NA,206,"A","4/17/2020 16:02","f466b9fa5e8ecfa2cc5c3bbc7b12f214bcc15d97","2020-04-18T20:00:00Z",2,50,6522,6522,6522,56,0,7,86,9,95
"2297",20200417,"AK",309,9141,NA,NA,36,NA,NA,NA,NA,128,"A","4/16/2020 00:00","5c059c1028bee5b5521901fb98c5f54790e003ae","2020-04-17T20:00:00Z",9,36,9450,9450,9450,2,0,1,706,9,715
"2298",20200417,"AL",4530,33318,NA,NA,594,NA,247,NA,148,NA,"B","4/17/2020 00:00","45c04bd7016dc2f888d0ce9f60b42c70828dc5c5","2020-04-17T20:00:00Z",144,594,37848,37848,37848,1,11,41,1272,185,1457
"2299",20200417,"AR",1695,21799,NA,83,NA,NA,NA,21,NA,593,"A","4/17/2020 19:00","a8da8ed523d7c6aa818ab7f8eb7bd3a8931e2a13","2020-04-17T20:00:00Z",37,NA,23494,23494,23494,5,0,0,744,75,819
"2300",20200417,"AS",0,3,17,NA,NA,NA,NA,NA,NA,NA,"","4/6/2020 00:00","e1c20ffc53fef1c7f4c2be953785ddaf10b83586","2020-04-17T20:00:00Z",NA,NA,20,3,3,60,0,0,0,0,0
"2301",20200417,"AZ",4507,44723,NA,566,NA,285,NA,178,NA,539,"B","4/17/2020 00:00","ee032adef0019ff280abf8cfe4d11f47dd17a793","2020-04-17T20:00:00Z",169,NA,49230,49230,49230,4,19,0,1559,273,1832
"2302",20200417,"CA",27528,224086,7200,4892,NA,1484,NA,NA,NA,NA,"B","4/17/2020 00:00","b0bbd7cb33e2be7c025375e18d150eae8dff1847","2020-04-17T20:00:00Z",985,NA,258814,251614,251614,6,95,0,3868,1346,5214
"2303",20200417,"CO",8675,33155,NA,858,1693,NA,NA,NA,NA,NA,"A","4/15/2020 00:00","29cb95959242986093a60219002c2be5313b1253","2020-04-17T20:00:00Z",374,1693,41830,41830,41830,8,17,57,902,395,1297
"2304",20200417,"CT",16809,38653,NA,1946,NA,NA,NA,NA,NA,NA,"A","4/17/2020 16:00","0a8bd7e1017be83ff7f939d4a3ba71850015069e","2020-04-17T20:00:00Z",1036,NA,55462,55462,55462,9,65,0,1415,925,2340
"2305",20200417,"DC",2476,10167,NA,313,NA,105,NA,79,NA,573,"A","4/16/2020 00:00","2582dc7527c0b34ac18d5a1e286d4e462c301c49","2020-04-17T20:00:00Z",86,NA,12643,12643,12643,11,5,0,367,126,493
"2306",20200417,"DE",2323,11694,NA,224,NA,NA,NA,NA,NA,423,"A","4/17/2020 17:00","42b83bef35dded8d74d77f1654f6827f050e99ea","2020-04-17T20:00:00Z",61,NA,14017,14017,14017,10,9,0,419,248,667
"2307",20200417,"FL",24119,210718,1285,NA,3665,NA,NA,NA,NA,NA,"A","4/17/2020 16:21","0eb8ae3e1bfbbb17f3879322747d12c5de777f0f","2020-04-17T20:00:00Z",699,3665,236122,234837,234837,12,53,205,14367,1222,15589
"2308",20200417,"GA",17194,54490,NA,NA,3324,NA,NA,NA,NA,NA,"A","4/17/2020 18:28","0c0407c82beaa7db92355b6e6fc84e8d37efd42a","2020-04-17T20:00:00Z",650,3324,71684,71684,71684,13,63,216,2220,1525,3745
"2309",20200417,"GU",133,940,NA,6,NA,2,NA,NA,NA,97,"","4/17/2020 07:00","ecc0e957c3c9ae8d8bd1cade00f7e70dce3a4580","2020-04-17T20:00:00Z",5,NA,1073,1073,1073,66,0,0,70,0,70
"2310",20200417,"HI",541,21316,NA,NA,45,NA,NA,NA,NA,374,"A","4/17/2020 18:30","4c179d96c337c05804b8861f21d720880be521e8","2020-04-17T20:00:00Z",9,45,21857,21857,21857,15,0,0,1146,11,1157
"2311",20200417,"IA",2332,19460,NA,183,NA,88,NA,52,NA,1007,"A","4/16/2020 12:00","70ba334dd64ad5f32a3da35e4f8e2d0df7645a03","2020-04-17T20:00:00Z",64,NA,21792,21792,21792,19,4,0,926,191,1117
"2312",20200417,"ID",1609,15043,NA,NA,148,NA,51,NA,NA,390,"A","4/17/2020 19:00","1952d91932e08d9329869a8884088f41c9731b57","2020-04-17T20:00:00Z",41,148,16652,16652,16652,16,0,5,388,22,410
"2313",20200417,"IL",27575,102588,NA,4454,NA,1196,NA,777,NA,NA,"A","4/17/2020 00:00","d7e5479c4095b229b5c212d48baa225e62fbacb0","2020-04-17T20:00:00Z",1134,NA,130163,130163,130163,17,62,0,5732,1842,7574
"2314",20200417,"IN",10154,44631,NA,NA,NA,638,NA,417,NA,NA,"B","4/16/2020 23:59","dabfe7c81b447677373a32bc0a8bd435aa953321","2020-04-17T20:00:00Z",519,NA,54785,54785,54785,18,42,0,3058,612,3670
"2315",20200417,"KS",1705,15196,NA,NA,375,NA,NA,NA,NA,NA,"B","4/17/2020 12:00","9d932369c01ab2d77ba8402f7e3308568e767fbf","2020-04-17T20:00:00Z",84,375,16901,16901,16901,20,4,16,662,117,779
"2316",20200417,"KY",2429,27318,NA,477,971,333,506,NA,NA,956,"A","4/17/2020 17:00","8ccd72890c0517078d0e044a5c4063c2de061f28","2020-04-17T20:00:00Z",129,971,29747,29747,29747,21,7,164,1285,138,1423
"2317",20200417,"LA",23118,108869,NA,1868,NA,NA,NA,363,NA,NA,"A","4/17/2020 13:00","5cad43048c0ddf14b339eafeda3ff60a7ef3b80a","2020-04-17T20:00:00Z",1213,NA,131987,131987,131987,22,57,0,4815,586,5401
"2318",20200417,"MA",35125,117195,NA,3756,3756,987,NA,NA,NA,NA,"B","4/16/2020 10:00","564dd41f10ca94fcf08cfc60ff43f8bc97741e63","2020-04-17T20:00:00Z",1822,3756,152320,152320,152320,25,155,30,7097,2633,9730
"2319",20200417,"MD",11572,50437,NA,NA,2612,NA,NA,NA,NA,736,"A","4/17/2020 10:00","90e8f9f77bc769fc634e2ed4239e4e34835b85a5","2020-04-17T20:00:00Z",494,2612,62009,62009,62009,24,35,161,2378,788,3166
"2320",20200417,"ME",827,14076,NA,55,133,28,NA,8,NA,352,"A","4/17/2020 11:45","3ec0b7a50af80a0eee4d4d2c7eafd639300891f2","2020-04-17T20:00:00Z",29,133,14903,14903,14903,23,2,3,0,31,31
"2321",20200417,"MI",30023,68936,NA,3674,NA,1428,NA,1167,NA,629,"B","4/17/2020 11:00","4200c1c182e477d6a0d4fd5da182094be5024bf3","2020-04-17T20:00:00Z",2227,NA,98959,98959,98959,26,134,0,3913,760,4673
"2322",20200417,"MN",2071,40982,NA,223,518,106,202,NA,NA,955,"A","4/16/2020 17:00","e38c56f26ae25e8fdb839745b57db732a51a85d7","2020-04-17T20:00:00Z",111,518,43053,43053,43053,27,17,43,1219,159,1378
"2323",20200417,"MO",5283,46434,NA,1043,NA,NA,NA,NA,NA,NA,"A","4/17/2020 15:00","5ad1941f7522a506b668711ef44d1f6881ee8c12","2020-04-17T20:00:00Z",165,NA,51717,51717,51717,29,13,0,897,172,1069
"2324",20200417,"MP",13,42,4,NA,NA,NA,NA,NA,NA,NA,"","4/17/2020 19:15","64bbbae9779f17663c65a143ae1f015230ebf17a","2020-04-17T20:00:00Z",2,NA,59,55,55,69,0,0,15,0,15
"2325",20200417,"MS",3793,34791,NA,NA,736,154,NA,99,NA,NA,"A","4/16/2020 19:00","e1156807e44cefa80cb641bc3bc33515577428db","2020-04-17T20:00:00Z",140,736,38584,38584,38584,28,11,54,0,169,169
"2326",20200417,"MT",422,9822,NA,21,54,NA,NA,NA,NA,233,"A","4/17/2020 10:44","b6a8fbb8b8c81156279f7ecf1ff7d3f02b357e37","2020-04-17T20:00:00Z",8,54,10244,10244,10244,30,1,2,301,7,308
"2327",20200417,"NC",5859,67122,NA,429,NA,NA,NA,NA,NA,NA,"A","4/17/2020 11:00","58f85b57bf4eb57217d82c015703d3da6c5ff98d","2020-04-17T20:00:00Z",152,NA,72981,72981,72981,37,21,0,1670,394,2064
"2328",20200417,"ND",439,11903,NA,16,47,NA,NA,NA,NA,172,"B","4/17/2020 13:00","85f8dd4556f552641a60eae0086a5dedb740ec93","2020-04-17T20:00:00Z",9,47,12342,12342,12342,38,0,2,592,46,638
"2329",20200417,"NE",1066,12038,NA,NA,NA,NA,NA,NA,NA,NA,"A","4/17/2020 19:42","8e0911fefd129a6050b599528237defa0ea002f7","2020-04-17T20:00:00Z",24,NA,13104,13104,13104,31,3,0,696,114,810
"2330",20200417,"NH",1287,11421,174,74,190,NA,NA,NA,NA,455,"B","4/17/2020 09:00","a3c21f8a273cdddc10db8976b98eb9b47c4274f5","2020-04-17T20:00:00Z",37,190,12882,12708,12708,33,5,12,394,148,542
"2331",20200417,"NJ",78467,78982,NA,8011,NA,1961,NA,1594,NA,NA,"A","4/17/2020 13:00","6018784bd37a06f5221980b7d6e83811ad5bf999","2020-04-17T20:00:00Z",3840,NA,157449,157449,157449,34,322,0,2469,3150,5619
"2332",20200417,"NM",1597,32891,NA,90,230,NA,NA,NA,NA,353,"A","4/17/2020 20:53","957fa97175d9e10dff82d3517d322b68c5535da3","2020-04-17T20:00:00Z",44,230,34488,34488,34488,35,8,15,981,113,1094
"2333",20200417,"NV",3524,26238,NA,NA,NA,NA,NA,NA,NA,NA,"A","4/17/2020 10:00","28939cd4a2d03fc9f2921bedd7c5c353b1855ba1","2020-04-17T20:00:00Z",142,NA,29762,29762,29762,32,5,0,1108,203,1311
"2334",20200417,"NY",229642,343581,NA,17116,50508,5059,NA,NA,NA,33392,"A","4/17/2020 14:00","44021a2894f3a0659b419269ff6cad05ea63c571","2020-04-17T20:00:00Z",12822,50508,573223,573223,573223,36,630,1973,15286,7358,22644
"2335",20200417,"OH",9107,68819,NA,NA,2424,NA,740,NA,NA,NA,"B","4/17/2020 14:00","c1ee174cb597ef6f608faa92578b5408dd41664b","2020-04-17T20:00:00Z",418,2424,77926,77926,77926,39,29,93,2393,693,3086
"2336",20200417,"OK",2465,31155,NA,325,528,155,NA,NA,NA,1331,"B","4/17/2020 11:35","0e33368e3433311b79a910eb1dcdbe7dc274e917","2020-04-17T20:00:00Z",136,528,33620,33620,33620,40,5,0,2613,108,2721
"2337",20200417,"OR",1785,34536,NA,301,427,69,NA,41,NA,NA,"A","4/17/2020 11:00","bf9c123cbf30f148f7ab9b55f720802f1ce846fa","2020-04-17T20:00:00Z",70,427,36321,36321,36321,41,6,13,1334,49,1383
"2338",20200417,"PA",29441,117932,NA,2603,NA,NA,NA,661,NA,NA,"A","4/17/2020 12:00","f706c9b93cfe41e2bb27b018c4b5a67ad16f436e","2020-04-17T20:00:00Z",756,NA,147373,147373,147373,42,49,0,4197,1706,5903
"2339",20200417,"PR",1068,7864,1478,NA,NA,NA,NA,NA,NA,NA,"A","4/17/2020 06:00","89c321ea3d08d0ffe58678716567e30501f86bc5","2020-04-17T20:00:00Z",58,NA,10410,8932,8932,72,2,0,549,25,574
"2340",20200417,"RI",4177,26584,NA,252,331,62,NA,43,NA,196,"B","4/17/2020 00:00","18cfe4f9143aa284803f9a8b582daa4572d93886","2020-04-17T20:00:00Z",118,331,30761,30761,30761,44,13,0,2358,339,2697
"2341",20200417,"SC",3931,32353,NA,NA,675,NA,NA,NA,NA,NA,"B","4/17/2020 16:48","2c6a86630766d9a4651730ee429c6d4ad96eff57","2020-04-17T20:00:00Z",109,675,36284,36284,36284,45,2,0,1276,275,1551
"2342",20200417,"SD",1411,9651,0,NA,63,NA,NA,NA,NA,457,"A","4/16/2020 18:00","3d82af4fd025a2ad33346a3abe9846a7792f3ee0","2020-04-17T20:00:00Z",7,63,11062,11062,11062,46,0,8,412,100,512
"2343",20200417,"TN",6589,80684,NA,NA,711,NA,NA,NA,NA,3017,"A","4/17/2020 15:00","bccf49e9dcab00ac0d8e92ee16d07f1655b2231b","2020-04-17T20:00:00Z",142,711,87273,87273,87273,47,1,20,1897,327,2224
"2344",20200417,"TX",17371,152165,NA,1522,NA,NA,NA,NA,NA,4190,"A","4/17/2020 12:45","dd463910e3e39bf2d37ab96706da54f081cd616c","2020-04-17T20:00:00Z",428,NA,169536,169536,169536,48,35,0,10073,916,10989
"2345",20200417,"UT",2805,52966,NA,NA,244,NA,NA,NA,NA,443,"A","4/17/2020 15:00","17486f07521566ebd9679c19269c50b5c5c5a9c2","2020-04-17T20:00:00Z",23,244,55771,55771,55771,49,2,6,5971,122,6093
"2346",20200417,"VA",7491,41506,499,1308,1221,400,NA,224,NA,1110,"A","4/16/2020 17:00","5d22e9f0eaed45ba102e45dad64b873d5c3cf125","2020-04-17T20:00:00Z",231,1221,49496,48997,48997,51,23,107,1951,602,2553
"2347",20200417,"VI",51,373,34,NA,NA,NA,NA,NA,NA,46,"","4/17/2020 08:30","0454d9e368ccb41152a3fce3d06b74212be8b005","2020-04-17T20:00:00Z",2,NA,458,424,424,78,1,0,16,0,16
"2348",20200417,"VT",802,10813,NA,32,NA,NA,NA,NA,NA,15,"A","4/17/2020 00:00","55187ac795d2877f07deeb9811a186939d3d1ae2","2020-04-17T20:00:00Z",35,NA,11615,11615,11615,50,0,0,554,10,564
"2349",20200417,"WA",12203,139825,NA,622,NA,195,NA,NA,NA,NA,"C","4/17/2020 00:00","6a9d94fa386ed30a96f2ec7bad05c047b58ea121","2020-04-17T20:00:00Z",585,NA,152028,152028,152028,53,14,0,4028,341,4369
"2350",20200417,"WI",4045,42365,198,361,1153,141,306,348,NA,NA,"A","4/17/2020 14:24","2eba9251f7c3d704668b764220d3d4766d4d5935","2020-04-17T20:00:00Z",205,1153,46608,46410,46410,55,8,32,1391,170,1561
"2351",20200417,"WV",754,17927,NA,85,NA,34,NA,24,NA,223,"B","4/17/2020 17:00","5486af49d5df3b2a3c1d7c9ec93798c22565e335","2020-04-17T20:00:00Z",13,NA,18681,18681,18681,54,0,0,360,15,375
"2352",20200417,"WY",296,6131,NA,19,43,NA,NA,NA,NA,148,"A","4/17/2020 16:02","07bb5bba797252ef876736890a63cf4d239b7574","2020-04-17T20:00:00Z",2,43,6427,6427,6427,56,0,0,0,0,0
"2353",20200416,"AK",300,8435,NA,NA,35,NA,NA,NA,NA,110,"A","4/16/2020 15:30","e0a0eae66518d1a943b4bb64c684d2fcd807218d","2020-04-16T20:00:00Z",9,35,8735,8735,8735,2,0,1,64,7,71
"2354",20200416,"AL",4345,32046,NA,NA,553,NA,227,NA,137,NA,"B","4/16/2020 00:00","0630e48d201ab4e443a6bcbbf4a730766f437798","2020-04-16T20:00:00Z",133,553,36391,36391,36391,1,12,28,2082,232,2314
"2355",20200416,"AR",1620,21055,NA,85,NA,NA,NA,21,NA,548,"A","4/16/2020 14:45","99d6e08e360e065638394f36bda39965d9d16354","2020-04-16T20:00:00Z",37,NA,22675,22675,22675,5,4,0,790,51,841
"2356",20200416,"AS",0,3,17,NA,NA,NA,NA,NA,NA,NA,"","4/6/2020 00:00","69c6b25e7ed4004ce13d7bcbd28181128663649a","2020-04-16T20:00:00Z",NA,NA,20,3,3,60,0,0,0,0,0
"2357",20200416,"AZ",4234,43164,NA,578,NA,278,NA,188,NA,460,"B","4/16/2020 00:00","638121c892b8737475097f1054eddd1d91fc657f","2020-04-16T20:00:00Z",150,NA,47398,47398,47398,4,8,0,1816,272,2088
"2358",20200416,"CA",26182,220218,13200,5031,NA,1568,NA,NA,NA,NA,"B","4/15/2020 00:00","435af3ea5874a7d99fcebe9de7f9b9d4333b248d","2020-04-16T20:00:00Z",890,NA,259600,246400,246400,6,69,0,28156,1758,29914
"2359",20200416,"CO",8280,32253,NA,859,1636,NA,NA,NA,NA,NA,"A","4/14/2020 00:00","e90a90d048ed735e3fcfad269e2fe60fe243dd35","2020-04-16T20:00:00Z",357,1636,40533,40533,40533,8,28,80,614,339,953
"2360",20200416,"CT",15884,37238,NA,1926,NA,NA,NA,NA,NA,NA,"A","4/16/2020 16:30","e06765f22dc04179a048e9f6ac37e8f2ce046a33","2020-04-16T20:00:00Z",971,NA,53122,53122,53122,9,103,0,1850,1129,2979
"2361",20200416,"DC",2350,9800,NA,313,NA,105,NA,79,NA,552,"A","4/15/2020 00:00","50d73ee8f031757bab6e659ad5af8f736cf6baaa","2020-04-16T20:00:00Z",81,NA,12150,12150,12150,11,9,0,472,153,625
"2362",20200416,"DE",2075,11275,NA,209,NA,NA,NA,NA,NA,378,"A","4/16/2020 16:00","c3040e28f3edab8b93f38cb090a29b15315df0a7","2020-04-16T20:00:00Z",52,NA,13350,13350,13350,10,6,0,187,61,248
"2363",20200416,"FL",22897,196351,1325,NA,3460,NA,NA,NA,NA,NA,"A","4/16/2020 16:39","52dce653bb14bf17a56dbb4be2798415ac69f6c8","2020-04-16T20:00:00Z",646,3460,220573,219248,219248,12,37,116,5353,386,5739
"2364",20200416,"GA",15669,52270,NA,NA,3108,NA,NA,NA,NA,NA,"A","4/16/2020 18:28","df32d8aa6ec4ecca2a98798341a06860dbe510fc","2020-04-16T20:00:00Z",587,3108,67939,67939,67939,13,35,186,3167,682,3849
"2365",20200416,"GU",133,870,NA,9,NA,NA,NA,NA,NA,86,"","4/16/2020 07:45","c694c2747f7c76f1ab8ba1a5c3c1d3d7c39178bb","2020-04-16T20:00:00Z",5,NA,1003,1003,1003,66,0,0,27,0,27
"2366",20200416,"HI",530,20170,NA,NA,45,NA,NA,NA,NA,359,"A","4/16/2020 18:00","e6825df39202f5a14f7a123ba4b86a4cb29c779d","2020-04-16T20:00:00Z",9,45,20700,20700,20700,15,0,0,884,13,897
"2367",20200416,"IA",2141,18534,NA,175,NA,84,NA,48,NA,987,"A","4/15/2020 12:00","d5ef7ebe3f42ccef8c4a08c7bae4a1426ce398b5","2020-04-16T20:00:00Z",60,NA,20675,20675,20675,19,7,0,660,146,806
"2368",20200416,"ID",1587,14655,NA,NA,143,NA,46,NA,NA,NA,"A","4/16/2020 19:00","482c093270807e232f9d7de79364fa67396d4183","2020-04-16T20:00:00Z",41,143,16242,16242,16242,16,2,2,721,123,844
"2369",20200416,"IL",25733,96856,NA,4423,NA,1248,NA,797,NA,NA,"A","4/16/2020 00:00","60f41318f1c04c9cc64dcae3bb9737bb552b5bea","2020-04-16T20:00:00Z",1072,NA,122589,122589,122589,17,124,0,4520,1140,5660
"2370",20200416,"IN",9542,41573,NA,NA,NA,696,NA,426,NA,NA,"B","4/15/2020 23:59","d2471004d7d97596a155ea7f5fd0cdea68bc0bd4","2020-04-16T20:00:00Z",477,NA,51115,51115,51115,18,41,0,2132,587,2719
"2371",20200416,"KS",1588,14534,NA,NA,359,NA,NA,NA,NA,NA,"B","4/16/2020 12:00","62e469d40faeddc49e983ae69a68c15daa8072f8","2020-04-16T20:00:00Z",80,359,16122,16122,16122,20,4,17,1360,94,1454
"2372",20200416,"KY",2291,26033,NA,412,807,252,367,NA,NA,862,"A","4/16/2020 17:00","330e05db97eac816ee6fd6f4c7c0c45a3659ca96","2020-04-16T20:00:00Z",122,807,28324,28324,28324,21,7,120,546,81,627
"2373",20200416,"LA",22532,104054,NA,1914,NA,NA,NA,396,NA,NA,"A","4/16/2020 13:00","beba250d2fdc508dcc173fc36e0b5a04438d4ac2","2020-04-16T20:00:00Z",1156,NA,126586,126586,126586,22,53,0,4077,581,4658
"2374",20200416,"MA",32492,110098,NA,3726,3726,973,NA,NA,NA,NA,"B","4/16/2020 10:00","1a5f7948be62c5cbdc6f84266a94e8fd0362848d","2020-04-16T20:00:00Z",1667,3726,142590,142590,142590,25,165,89,7308,2522,9830
"2375",20200416,"MD",10784,48059,NA,NA,2451,NA,NA,NA,NA,736,"A","4/16/2020 10:00","8818e1bb2d6cc6619f9c4f24bc810585c139e0ac","2020-04-16T20:00:00Z",459,2451,58843,58843,58843,24,46,220,2328,752,3080
"2376",20200416,"ME",796,14076,NA,47,130,20,NA,7,NA,333,"A","4/16/2020 11:45","672014ade8b845ebd19f6d0257ae15f0e234b3bc","2020-04-16T20:00:00Z",27,130,14872,14872,14872,23,3,4,0,26,26
"2377",20200416,"MI",29263,65023,NA,3809,NA,1447,NA,1211,NA,617,"B","4/16/2020 11:00","d38e75f7b08c8f53abceb81cea0d397d5d541575","2020-04-16T20:00:00Z",2093,NA,94286,94286,94286,26,172,0,3385,1204,4589
"2378",20200416,"MN",1912,39763,NA,213,475,103,188,NA,NA,926,"A","4/15/2020 17:00","a10c536f26d28bd19125e6a23bbccc6f8ddae053","2020-04-16T20:00:00Z",94,475,41675,41675,41675,27,7,30,1330,103,1433
"2379",20200416,"MO",5111,45537,NA,1043,NA,NA,NA,NA,NA,NA,"A","4/16/2020 15:00","3729b5a4d5698ee86f42eee794f15a30049a191d","2020-04-16T20:00:00Z",152,NA,50648,50648,50648,29,5,0,1420,216,1636
"2380",20200416,"MP",13,27,7,NA,NA,NA,NA,NA,NA,NA,"","4/15/2020 00:00","9854af700703f8a69749addb2e776cbadd5b0271","2020-04-16T20:00:00Z",2,NA,47,40,40,69,0,0,0,0,0
"2381",20200416,"MS",3624,34791,NA,NA,682,154,NA,99,NA,NA,"A","4/15/2020 19:00","ef04138350fc1944bb66b55b5fa0e2bac893d797","2020-04-16T20:00:00Z",129,682,38415,38415,38415,28,7,37,0,264,264
"2382",20200416,"MT",415,9521,NA,21,52,NA,NA,NA,NA,218,"A","4/16/2020 11:44","f62755b7f1a1a019c9cf81fd443afb5d7e53ac1d","2020-04-16T20:00:00Z",7,52,9936,9936,9936,30,0,1,342,11,353
"2383",20200416,"NC",5465,65452,NA,452,NA,NA,NA,NA,NA,NA,"A","4/16/2020 10:45","7537b6a77581df10ff2cffc79558a4b1ae037561","2020-04-16T20:00:00Z",131,NA,70917,70917,70917,37,14,0,2748,342,3090
"2384",20200416,"ND",393,11311,NA,14,45,NA,NA,NA,NA,163,"B","4/16/2020 13:00","48bb505538f89b6aa47644f43bb429770379a665","2020-04-16T20:00:00Z",9,45,11704,11704,11704,38,0,1,359,28,387
"2385",20200416,"NE",952,11342,NA,NA,NA,NA,NA,NA,NA,NA,"A","4/16/2020 19:40","b72b537c011498e86822d738edd57788348c117b","2020-04-16T20:00:00Z",21,NA,12294,12294,12294,31,1,0,514,51,565
"2386",20200416,"NH",1139,11027,121,70,178,NA,NA,NA,NA,365,"B","4/15/2020 09:00","6ddffcf8f5174afcc136c0cc9ccdc836f5bf123c","2020-04-16T20:00:00Z",32,178,12287,12166,12166,33,0,0,0,0,0
"2387",20200416,"NJ",75317,76513,NA,8224,NA,2014,NA,1645,NA,NA,"A","4/16/2020 13:00","6f53830104152ffe83ea25f4f168e8080bd746fe","2020-04-16T20:00:00Z",3518,NA,151830,151830,151830,34,362,0,3522,4287,7809
"2388",20200416,"NM",1484,31910,NA,90,215,NA,NA,NA,NA,353,"A","4/16/2020 19:09","d4551867258f4d856d1c3d3d52a03ea113a958a6","2020-04-16T20:00:00Z",36,215,33394,33394,33394,35,0,34,467,77,544
"2389",20200416,"NV",3321,25130,NA,NA,NA,NA,NA,NA,NA,NA,"A","4/16/2020 19:00","a442df05598061dcba97c2c4a0effc91b871c46b","2020-04-16T20:00:00Z",137,NA,28451,28451,28451,32,6,0,686,110,796
"2390",20200416,"NY",222284,328295,NA,17735,48535,5091,NA,NA,NA,30800,"A","4/16/2020 00:00","53fb51ea5f3fc0f462195e4b14847ceaa73517e6","2020-04-16T20:00:00Z",12192,48535,550579,550579,550579,36,606,1996,16062,8505,24567
"2391",20200416,"OH",8414,66426,NA,NA,2331,NA,707,NA,NA,NA,"B","4/16/2020 14:00","6cbedc499e56e27314a4dc6c584877882d67772f","2020-04-16T20:00:00Z",389,2331,74840,74840,74840,39,28,94,2665,623,3288
"2392",20200416,"OK",2357,28542,NA,236,528,163,NA,NA,NA,1240,"B","4/16/2020 08:00","87a4db1695e61bc57eb7de7ede856fca57468514","2020-04-16T20:00:00Z",131,528,30899,30899,30899,40,8,18,1586,94,1680
"2393",20200416,"OR",1736,33202,NA,307,414,89,NA,43,NA,NA,"A","4/16/2020 11:00","e882a6df1a656b506650721eca501e24e1be5c40","2020-04-16T20:00:00Z",64,414,34938,34938,34938,41,6,13,1514,73,1587
"2394",20200416,"PA",27735,113735,NA,2512,NA,NA,NA,675,NA,NA,"A","4/16/2020 12:00","10ad0c0c14394c6412669fa823f4369667dd0935","2020-04-16T20:00:00Z",707,NA,141470,141470,141470,42,60,0,2641,1245,3886
"2395",20200416,"PR",1043,7315,1465,NA,NA,NA,NA,NA,NA,NA,"A","4/16/2020 07:00","d474563651be74c12631c26f7acc00707291c2fa","2020-04-16T20:00:00Z",56,NA,9823,8358,8358,72,5,0,490,69,559
"2396",20200416,"RI",3838,24226,NA,245,331,61,NA,43,NA,182,"B","4/16/2020 00:00","f3a182252d930eef7df4760dd2ed4de8a11bc162","2020-04-16T20:00:00Z",105,331,28064,28064,28064,44,18,0,1858,309,2167
"2397",20200416,"SC",3656,31077,NA,NA,675,NA,NA,NA,NA,NA,"B","4/16/2020 17:06","65d688580c90a3f582d0f44fcc4ea330142e57dc","2020-04-16T20:00:00Z",107,675,34733,34733,34733,45,0,0,0,0,0
"2398",20200416,"SD",1311,9239,2,NA,55,NA,NA,NA,NA,373,"A","4/15/2020 18:00","c26f685f785f5688e64749a0f31de6df312809c6","2020-04-16T20:00:00Z",7,55,10552,10550,10550,46,1,4,548,143,691
"2399",20200416,"TN",6262,78787,NA,NA,691,NA,NA,NA,NA,2786,"A","4/16/2020 15:00","6f5092ef000b277c8714670552a53ee588567553","2020-04-16T20:00:00Z",141,691,85049,85049,85049,47,6,28,3970,183,4153
"2400",20200416,"TX",16455,142092,NA,1459,NA,NA,NA,NA,NA,3677,"A","4/16/2020 13:00","3c396ea54e975a5a87e9c160fa2cd0b2f6f56b54","2020-04-16T20:00:00Z",393,NA,158547,158547,158547,48,29,0,5774,963,6737
"2401",20200416,"UT",2683,46995,NA,NA,238,NA,NA,NA,NA,357,"A","4/16/2020 15:00","ef4f3b2cf145f56715cd7dc952e645953860a1b7","2020-04-16T20:00:00Z",21,238,49678,49678,49678,49,1,17,1923,141,2064
"2402",20200416,"VA",6889,39555,537,1337,1114,427,NA,238,NA,951,"A","4/16/2020 00:00","a8717ecbb12d77d090353871da2750ff4d428ffa","2020-04-16T20:00:00Z",208,1114,46981,46444,46444,51,13,66,1886,389,2275
"2403",20200416,"VI",51,357,35,NA,NA,NA,NA,NA,NA,46,"","4/16/2020 08:30","36bf6014e9eed16bdf7fa844aec47ddc380dd3ec","2020-04-16T20:00:00Z",1,NA,443,408,408,78,0,0,26,0,26
"2404",20200416,"VT",792,10259,NA,58,NA,NA,NA,NA,NA,15,"A","4/16/2020 00:00","8c9b127cb47e2fb13502f350e73bc2d753688730","2020-04-16T20:00:00Z",35,NA,11051,11051,11051,50,5,0,346,13,359
"2405",20200416,"WA",11862,135797,NA,595,NA,196,NA,NA,NA,NA,"C","4/16/2020 00:00","fe249ac67711dee2554fb3bc784a940612767fed","2020-04-16T20:00:00Z",571,NA,147659,147659,147659,53,20,0,3968,304,4272
"2406",20200416,"WI",3875,40974,218,394,1121,147,299,NA,NA,NA,"A","4/16/2020 00:00","5728ce4252791f7d3855c60b7a5d0a51e5bf201c","2020-04-16T20:00:00Z",197,1121,45067,44849,44849,55,15,30,1648,154,1802
"2407",20200416,"WV",739,17567,NA,85,NA,34,NA,24,NA,223,"B","4/16/2020 16:30","c35dbaff7125d13909dfe9907fffd7e5c6917384","2020-04-16T20:00:00Z",13,NA,18306,18306,18306,54,3,0,613,37,650
"2408",20200416,"WY",296,6131,NA,19,43,NA,NA,NA,NA,148,"A","4/16/2020 20:15","cf9b128cef08a4d7fd42b8fb432560c179593bb5","2020-04-16T20:00:00Z",2,43,6427,6427,6427,56,0,0,89,9,98
"2409",20200415,"AK",293,8371,NA,NA,34,NA,NA,NA,NA,106,"A","4/15/2020 15:15","5b0ccaf9afb8281edb8c356d24115b91228c0d63","2020-04-15T20:00:00Z",9,34,8664,8664,8664,2,0,2,308,8,316
"2410",20200415,"AL",4113,29964,NA,NA,525,NA,219,NA,134,NA,"B","4/15/2020 00:00","3da9ba6d59bb59a18fb991d43fec5b3a5737aa94","2020-04-15T20:00:00Z",121,525,34077,34077,34077,1,11,32,723,237,960
"2411",20200415,"AR",1569,20265,NA,83,130,NA,43,26,39,489,"A","4/15/2020 14:45","ffd3075c5cbd02b405fc88cb5814760001ba224c","2020-04-15T20:00:00Z",33,130,21834,21834,21834,5,3,0,614,89,703
"2412",20200415,"AS",0,3,17,NA,NA,NA,NA,NA,NA,NA,"","4/6/2020 00:00","187f5210e67ce3b937ef94672584ca870f9b758c","2020-04-15T20:00:00Z",NA,NA,20,3,3,60,0,0,0,0,0
"2413",20200415,"AZ",3962,41348,NA,590,NA,286,NA,202,NA,385,"B","4/15/2020 00:00","9f325e12aceafea9d0d825fb397bea3390e43e65","2020-04-15T20:00:00Z",142,NA,45310,45310,45310,4,11,0,1058,156,1214
"2414",20200415,"CA",24424,192062,13200,5163,NA,1175,NA,NA,NA,NA,"B","4/14/2020 00:00","f441997a6a1b89ec0dd21ae8ef29cf4fc7b5859e","2020-04-15T20:00:00Z",821,NA,229686,216486,216486,6,63,0,13192,1086,14278
"2415",20200415,"CO",7941,31639,NA,878,1556,NA,NA,NA,NA,NA,"A","4/13/2020 00:00","48ec1dc7454dd4222e8617a9b7e540c16d2c5f4e","2020-04-15T20:00:00Z",329,1556,39580,39580,39580,8,21,63,588,250,838
"2416",20200415,"CT",14755,35388,NA,1908,NA,NA,NA,NA,NA,NA,"A","4/15/2020 16:00","e47a17a04866a3f402e28d189d1229885d631c1f","2020-04-15T20:00:00Z",868,NA,50143,50143,50143,9,197,0,3536,766,4302
"2417",20200415,"DC",2197,9328,NA,313,NA,105,NA,79,NA,530,"A","4/15/2020 00:00","e028f8b1fe39d6b8d3da713314db44171c54c1ec","2020-04-15T20:00:00Z",72,NA,11525,11525,11525,11,5,0,102,139,241
"2418",20200415,"DE",2014,11088,NA,208,NA,NA,NA,NA,NA,354,"A","4/15/2020 16:15","452f7da2d94af552570e09a07ae20a4beffd2ab9","2020-04-15T20:00:00Z",46,NA,13102,13102,13102,10,5,0,545,253,798
"2419",20200415,"FL",22511,190998,1335,NA,3344,NA,NA,NA,NA,NA,"A","4/15/2020 13:50","b02bb2e8a3f3e13210ec294acd8f0413c1ad6a34","2020-04-15T20:00:00Z",609,3344,214844,213509,213509,12,72,284,9185,1144,10329
"2420",20200415,"GA",14987,49103,NA,NA,2922,NA,NA,NA,NA,NA,"A","4/15/2020 11:28","74f62ec0c6da0120e017fa0542f79f05c8323eb5","2020-04-15T20:00:00Z",552,2922,64090,64090,64090,13,51,153,1531,764,2295
"2421",20200415,"GU",133,843,NA,9,NA,2,NA,2,NA,73,"","4/15/2020 07:45","bcf0dc74e4551562423e9fab48a994a6a33c644d","2020-04-15T20:00:00Z",5,NA,976,976,976,66,0,0,32,0,32
"2422",20200415,"HI",517,19286,NA,NA,45,NA,NA,NA,NA,333,"A","4/14/2020 18:00","40e5c246af2bcde9bde077ecc580e139fe22c4a6","2020-04-15T20:00:00Z",9,45,19803,19803,19803,15,0,1,370,13,383
"2423",20200415,"IA",1995,17874,NA,171,NA,78,NA,43,NA,908,"A","4/14/2020 12:00","16e35f2aeddfb57adc764a65a4ea7fd686e2f3d5","2020-04-15T20:00:00Z",53,NA,19869,19869,19869,19,4,0,888,96,984
"2424",20200415,"ID",1464,13934,NA,NA,141,NA,43,NA,NA,NA,"A","4/14/2020 19:00","96d4b8b8e9c570b72c61cdd77ff59a8cf4f34dee","2020-04-15T20:00:00Z",39,141,15398,15398,15398,16,6,6,273,11,284
"2425",20200415,"IL",24593,92336,NA,4283,NA,1189,NA,796,NA,NA,"A","4/15/2020 00:00","108160afe82ca8104337dee854e03836a9589e1a","2020-04-15T20:00:00Z",948,NA,116929,116929,116929,17,80,0,4967,1346,6313
"2426",20200415,"IN",8955,39441,NA,NA,NA,737,NA,422,NA,NA,"B","4/14/2020 11:59","47826170c9e1317ac5812c4b169b91ee00f7c930","2020-04-15T20:00:00Z",436,NA,48396,48396,48396,18,48,0,1951,428,2379
"2427",20200415,"KS",1494,13174,NA,NA,342,NA,NA,NA,NA,NA,"B","4/15/2020 11:30","90d94c9ee65e4770432be801ea530b24195053e5","2020-04-15T20:00:00Z",76,342,14668,14668,14668,20,7,15,453,68,521
"2428",20200415,"KY",2210,25487,NA,305,687,137,263,NA,NA,653,"A","4/14/2020 17:00","3b70f2bb6555d32a196205076fe07a4ff6e9a02b","2020-04-15T20:00:00Z",115,687,27697,27697,27697,21,11,14,852,162,1014
"2429",20200415,"LA",21951,99977,NA,1943,NA,NA,NA,425,NA,NA,"A","4/15/2020 13:00","5a70bafcf19e57aa18291a421fe30ed1181820ff","2020-04-15T20:00:00Z",1103,NA,121928,121928,121928,22,90,0,3073,433,3506
"2430",20200415,"MA",29970,102790,NA,3637,3637,973,NA,NA,NA,NA,"B","4/15/2020 10:00","208059e879c379e73e7dcd5ba1f9551f63afde30","2020-04-15T20:00:00Z",1502,3637,132760,132760,132760,25,173,21,3970,1861,5831
"2431",20200415,"MD",10032,45731,NA,NA,2231,NA,NA,NA,NA,607,"A","4/15/2020 10:00","805353d49487c9e05ae2e402270cae3aafd63a7b","2020-04-15T20:00:00Z",413,2231,55763,55763,55763,24,111,109,1470,560,2030
"2432",20200415,"ME",770,14076,NA,48,126,22,NA,9,NA,305,"A","4/15/2020 12:00","7e3b34217593df99e8d53eb4baebea95cca163f8","2020-04-15T20:00:00Z",24,126,14846,14846,14846,23,4,2,2468,36,2504
"2433",20200415,"MI",28059,61638,NA,3918,NA,1468,NA,1212,NA,452,"B","4/15/2020 11:00","8c0de37f5acdde21f5c71a12d3bf52313eebc874","2020-04-15T20:00:00Z",1921,NA,89697,89697,89697,26,153,0,2413,1058,3471
"2434",20200415,"MN",1809,38433,NA,197,445,93,175,NA,NA,853,"A","4/14/2020 17:00","03875148433633e47e159f05d85cee22b2d78ffc","2020-04-15T20:00:00Z",87,445,40242,40242,40242,27,8,40,887,114,1001
"2435",20200415,"MO",4895,44117,NA,1024,NA,NA,NA,NA,NA,NA,"A","4/15/2020 15:00","3d3fe8e5fde130c829812e63dae4b55436490e6d","2020-04-15T20:00:00Z",147,NA,49012,49012,49012,29,14,0,825,209,1034
"2436",20200415,"MP",13,27,7,NA,NA,NA,NA,NA,NA,NA,"","4/14/2020 00:00","4c47fde986cba4247beb12c1e39ba668a4a568fe","2020-04-15T20:00:00Z",2,NA,47,40,40,69,0,0,0,0,0
"2437",20200415,"MS",3360,34791,NA,NA,645,154,NA,99,NA,NA,"A","4/14/2020 19:00","2b33b6715fdea3749dcd0c0d10c5a05fa883f054","2020-04-15T20:00:00Z",122,645,38151,38151,38151,28,11,49,0,273,273
"2438",20200415,"MT",404,9179,NA,21,51,NA,NA,NA,NA,209,"A","4/15/2020 11:59","99b2e8ee53c98a1da05db3317bca007ed89aad70","2020-04-15T20:00:00Z",7,51,9583,9583,9583,30,0,1,344,5,349
"2439",20200415,"NC",5123,62704,NA,431,NA,NA,NA,NA,NA,NA,"A","4/15/2020 11:00","4b7902742c325ef8fe0ec1484a287748ab608ccb","2020-04-15T20:00:00Z",117,NA,67827,67827,67827,37,9,0,2689,99,2788
"2440",20200415,"ND",365,10952,NA,13,44,NA,NA,NA,NA,142,"B","4/15/2020 13:00","5865fb194cf31634edf34ab287e0f0c87d7cea33","2020-04-15T20:00:00Z",9,44,11317,11317,11317,38,0,2,377,24,401
"2441",20200415,"NE",901,10828,NA,NA,NA,NA,NA,NA,NA,NA,"A","4/14/2020 19:45","4f46c760b0dc8cd795ea8d34159a99bd3c5c2782","2020-04-15T20:00:00Z",20,NA,11729,11729,11729,31,2,0,342,30,372
"2442",20200415,"NH",1139,11027,121,70,178,NA,NA,NA,NA,365,"B","4/15/2020 09:00","7437d703e80c5edffe00df1167c089bcdc86c71a","2020-04-15T20:00:00Z",32,178,12287,12166,12166,33,9,26,437,119,556
"2443",20200415,"NJ",71030,72991,NA,8270,NA,1980,NA,1705,NA,NA,"A","4/15/2020 13:00","70411d7fb80ea3ae056455e78f96ef4289ff34c1","2020-04-15T20:00:00Z",3156,NA,144021,144021,144021,34,351,0,2041,2206,4247
"2444",20200415,"NM",1407,31443,NA,87,181,NA,NA,NA,NA,340,"A","4/14/2020 18:56","a0a9b2145cccacca9419c4aa32a324038aaf2550","2020-04-15T20:00:00Z",36,181,32850,32850,32850,35,5,0,818,62,880
"2445",20200415,"NV",3211,24444,NA,NA,NA,NA,NA,NA,NA,NA,"A","4/15/2020 12:00","7347cb28ada84203925d01f42dd483f0819c3227","2020-04-15T20:00:00Z",131,NA,27655,27655,27655,32,11,0,871,123,994
"2446",20200415,"NY",213779,312233,NA,18535,46539,5225,NA,NA,NA,28004,"A","4/15/2020 00:00","c11436638749dffe28483d7d3a23aa087a677a40","2020-04-15T20:00:00Z",11586,46539,526012,526012,526012,36,752,2253,15298,11571,26869
"2447",20200415,"OH",7791,63761,NA,NA,2237,NA,677,NA,NA,NA,"B","4/15/2020 14:00","276fd42f12be4f8c087bad1145c542d2d07e639f","2020-04-15T20:00:00Z",361,2237,71552,71552,71552,39,37,81,3040,511,3551
"2448",20200415,"OK",2263,26956,NA,194,510,107,NA,NA,NA,1115,"B","4/15/2020 08:00","f9ef781b7b909ddda2ea7d99af163bbc73eff30b","2020-04-15T20:00:00Z",123,510,29219,29219,29219,40,15,22,871,79,950
"2449",20200415,"OR",1663,31688,NA,305,401,95,NA,43,NA,NA,"A","4/15/2020 11:00","402a9c7a9a57307fc62501f90a1b97dab3a4e16e","2020-04-15T20:00:00Z",58,401,33351,33351,33351,41,3,20,958,30,988
"2450",20200415,"PA",26490,111094,NA,2395,NA,NA,NA,668,NA,NA,"A","4/15/2020 12:00","877ac63b219dab9825d1b6a8c0864dcaa67d0ddd","2020-04-15T20:00:00Z",647,NA,137584,137584,137584,42,63,0,2808,1145,3953
"2451",20200415,"PR",974,6825,1410,NA,NA,NA,NA,NA,NA,NA,"A","4/15/2020 07:00","8fcb3788b8b6a42ccdc9f0cd1882d331dd569459","2020-04-15T20:00:00Z",51,NA,9209,7799,7799,72,6,0,541,51,592
"2452",20200415,"RI",3529,22368,NA,229,331,54,NA,44,NA,168,"B","4/15/2020 00:00","12ace966ac142b3d294e0add3aeffb6d1a39cb45","2020-04-15T20:00:00Z",87,331,25897,25897,25897,44,7,0,2719,278,2997
"2453",20200415,"SC",3656,31077,NA,NA,675,NA,NA,NA,NA,NA,"B","4/15/2020 14:55","4e144f084cb2b72a4ffb0deb48835c3e6ccc3191","2020-04-15T20:00:00Z",107,675,34733,34733,34733,45,10,0,758,103,861
"2454",20200415,"SD",1168,8691,0,NA,51,NA,NA,NA,NA,329,"A","4/15/2020 12:30","6981d1e10be66d769e8230f0a6578d3f32668735","2020-04-15T20:00:00Z",6,51,9859,9859,9859,46,0,6,383,180,563
"2455",20200415,"TN",6079,74817,NA,NA,663,NA,NA,NA,NA,2196,"A","4/15/2020 15:00","23ab01f1a2de558482887246033bd9001765eaa5","2020-04-15T20:00:00Z",135,663,80896,80896,80896,47,11,30,1809,256,2065
"2456",20200415,"TX",15492,136318,NA,1538,NA,NA,NA,NA,NA,3150,"A","4/15/2020 13:00","ac78ad2ed71386f6a4c6d9802bf7702fa480e58f","2020-04-15T20:00:00Z",364,NA,151810,151810,151810,48,46,0,4475,868,5343
"2457",20200415,"UT",2542,45072,NA,NA,221,NA,NA,NA,NA,218,"A","4/15/2020 15:00","2f33a2ee4ee0afb319f38d914298db90b63dac87","2020-04-15T20:00:00Z",20,221,47614,47614,47614,49,1,8,1008,130,1138
"2458",20200415,"VA",6500,37669,496,1298,1048,394,NA,234,NA,752,"A","4/15/2020 00:00","3e98655e9418e16da8bb9b34ea25b1f3cbbcacdb","2020-04-15T20:00:00Z",195,1048,44665,44169,44169,51,41,1048,1077,329,1406
"2459",20200415,"VI",51,331,35,NA,NA,NA,NA,NA,NA,44,"","4/14/2020 17:30","5fa8adb4317e4068fdbec95a01b05682395ad39a","2020-04-15T20:00:00Z",1,NA,417,382,382,78,0,0,5,0,5
"2460",20200415,"VT",779,9913,NA,63,NA,NA,NA,NA,NA,15,"A","4/15/2020 00:00","ffc811b2330c9f82e95503e9aa6b9d7784b0df41","2020-04-15T20:00:00Z",30,NA,10692,10692,10692,50,1,0,422,9,431
"2461",20200415,"WA",11558,131829,NA,645,NA,194,NA,NA,NA,NA,"C","4/15/2020 00:00","909ea25164c4d589575f67ef2cfc17ece0a46f9a","2020-04-15T20:00:00Z",551,NA,143387,143387,143387,53,9,0,3792,324,4116
"2462",20200415,"WI",3721,39326,280,406,1091,163,290,NA,NA,NA,"A","4/15/2020 11:01","8960c30a15a77fb487104c1e6b423334089dd5d1","2020-04-15T20:00:00Z",182,1091,43327,43047,43047,55,12,42,1329,166,1495
"2463",20200415,"WV",702,16954,NA,82,164,36,73,23,50,211,"B","4/15/2020 10:00","129b34bd18316d9ea3d06f9e2a34272b089972a6","2020-04-15T20:00:00Z",10,164,17656,17656,17656,54,1,0,556,62,618
"2464",20200415,"WY",287,6042,NA,NA,43,NA,NA,NA,NA,129,"A","4/15/2020 12:30","daa535241b51a80b35408632ca2e34a946a0360b","2020-04-15T20:00:00Z",2,43,6329,6329,6329,56,1,0,353,12,365
"2465",20200414,"AK",285,8063,NA,NA,32,NA,NA,NA,NA,98,"A","4/14/2020 14:15","668f4f7cbe6d0ddeff48380d9ec2aca1e74a1dfe","2020-04-14T20:00:00Z",9,32,8348,8348,8348,2,1,0,510,8,518
"2466",20200414,"AL",3876,29241,NA,NA,493,NA,210,NA,132,NA,"B","4/14/2020 00:00","28b19ad8074d4f98646c2840d88064c2ca20e8b8","2020-04-14T20:00:00Z",110,493,33117,33117,33117,1,11,36,3793,142,3935
"2467",20200414,"AR",1480,19651,NA,81,130,NA,43,29,39,427,"A","4/14/2020 14:46","81720db8376cf97c3fdc996ac912f8f0d151d570","2020-04-14T20:00:00Z",30,130,21131,21131,21131,5,0,0,257,70,327
"2468",20200414,"AS",0,3,17,NA,NA,NA,NA,NA,NA,NA,"","4/6/2020 00:00","d8f6fa82ecef7a1983c932df4b8bbc08d61e06cb","2020-04-14T20:00:00Z",NA,NA,20,3,3,60,0,0,0,0,0
"2469",20200414,"AZ",3806,40290,NA,580,NA,286,NA,216,NA,249,"B","4/14/2020 00:00","9e0f56d3e2d596de993fb58d38479e788d97426f","2020-04-14T20:00:00Z",131,NA,44096,44096,44096,4,9,0,645,104,749
"2470",20200414,"CA",23338,178870,13200,5163,NA,1552,NA,NA,NA,NA,"B","4/13/2020 00:00","db1bac7c9f44520fcf9dced18a12846e1af9614c","2020-04-14T20:00:00Z",758,NA,215408,202208,202208,6,71,0,10336,990,11326
"2471",20200414,"CO",7691,31051,NA,888,1493,NA,NA,NA,NA,NA,"A","4/12/2020 00:00","fa6f4c96226cf99dcf2dd1b2ef32f931af1fbfaa","2020-04-14T20:00:00Z",308,1493,38742,38742,38742,8,4,21,1201,7,1208
"2472",20200414,"CT",13989,31852,NA,1779,NA,NA,NA,NA,NA,NA,"A","4/14/2020 16:00","861cbc2fd1da415f14c00e9fae10bd01728638d2","2020-04-14T20:00:00Z",671,NA,45841,45841,45841,9,69,0,924,608,1532
"2473",20200414,"DC",2058,9226,NA,295,NA,95,NA,31,NA,518,"A","4/14/2020 00:00","db757a4c1f24c6d666a0390d1fca7f8e78726da8","2020-04-14T20:00:00Z",67,NA,11284,11284,11284,11,14,0,247,103,350
"2474",20200414,"DE",1761,10543,NA,204,NA,NA,NA,NA,NA,277,"A","4/14/2020 17:45","a67d18c3ef44d1d97f36e821add9cda29081b6ee","2020-04-14T20:00:00Z",41,NA,12304,12304,12304,10,6,0,348,136,484
"2475",20200414,"FL",21367,181813,1275,NA,3060,NA,NA,NA,NA,NA,"A","4/14/2020 16:59","286a31db2e5116a55d4aeb1a81b49ef593bf8c79","2020-04-14T20:00:00Z",537,3060,204455,203180,203180,12,54,227,6207,766,6973
"2476",20200414,"GA",14223,47572,NA,NA,2769,NA,NA,NA,NA,NA,"A","4/14/2020 18:28","ec1390ecdeb9e07513c2446db7cd110b26361527","2020-04-14T20:00:00Z",501,2769,61795,61795,61795,13,37,180,3866,908,4774
"2477",20200414,"GU",133,811,NA,13,NA,2,NA,2,NA,66,"","4/14/2020 08:15","7031856f0dd9de8f7d9c1f4c5ef0f3f99b5e176d","2020-04-14T20:00:00Z",5,NA,944,944,944,66,0,0,41,0,41
"2478",20200414,"HI",504,18916,NA,NA,44,NA,NA,NA,NA,315,"A","4/14/2020 18:00","112e7ae3d4473058f5f7056b5fac2de14c52050e","2020-04-14T20:00:00Z",9,44,19420,19420,19420,15,0,0,571,5,576
"2479",20200414,"IA",1899,16986,NA,163,NA,73,NA,41,NA,741,"A","4/14/2020 00:00","31d4d25f60a74e293e6d29894bd3fa743b18c1c9","2020-04-14T20:00:00Z",49,NA,18885,18885,18885,19,6,0,0,189,189
"2480",20200414,"ID",1453,13661,NA,NA,135,NA,38,NA,NA,NA,"A","4/14/2020 19:00","4cc3807ec6c0d4b35ff060cd72fdd26d67db6652","2020-04-14T20:00:00Z",33,135,15114,15114,15114,16,6,3,206,27,233
"2481",20200414,"IL",23247,87369,NA,4283,NA,1189,NA,796,NA,NA,"A","4/14/2020 00:00","86e30997bc7e1aea835bf8c917e0103bbbd6f11a","2020-04-14T20:00:00Z",868,NA,110616,110616,110616,17,74,0,3626,1222,4848
"2482",20200414,"IN",8527,37490,NA,NA,NA,721,NA,435,NA,NA,"B","4/14/2020 13:00","494a985ff9e75e358bd2cb017f003e52843bffe4","2020-04-14T20:00:00Z",388,NA,46017,46017,46017,18,38,0,1187,291,1478
"2483",20200414,"KS",1426,12721,NA,NA,327,NA,NA,NA,NA,NA,"B","4/14/2020 12:00","b656123e532bff95913ad2a2f25b9ac0d0ee7c7c","2020-04-14T20:00:00Z",69,327,14147,14147,14147,20,7,18,233,50,283
"2484",20200414,"KY",2048,24635,NA,299,673,136,259,NA,NA,629,"A","4/14/2020 17:00","4d0988bf89788f5a4b9c90b9bb04ff99cfb7d06f","2020-04-14T20:00:00Z",104,673,26683,26683,26683,21,7,6,732,85,817
"2485",20200414,"LA",21518,96904,NA,1977,NA,NA,NA,436,NA,NA,"A","4/13/2020 13:00","66fe07f75d823430436470743438bfd150c83cc3","2020-04-14T20:00:00Z",1013,NA,118422,118422,118422,22,129,0,9829,502,10331
"2486",20200414,"MA",28109,98820,NA,3616,3616,NA,NA,NA,NA,NA,"B","4/14/2020 10:00","14208e5fcf43fc55d10b65384ce29d2e6c650a66","2020-04-14T20:00:00Z",1329,3616,126929,126929,126929,25,118,131,3320,1315,4635
"2487",20200414,"MD",9472,44261,NA,NA,2122,NA,NA,NA,NA,607,"A","4/14/2020 10:00","7791ef97ecb5dc2a461c316abff41cf8b0948f60","2020-04-14T20:00:00Z",302,2122,53733,53733,53733,24,40,147,1446,536,1982
"2488",20200414,"ME",734,11608,NA,58,124,21,NA,9,NA,292,"A","4/14/2020 11:45","c9021f736d76d5db3e6c7b24efd332a55bfcb475","2020-04-14T20:00:00Z",20,124,12342,12342,12342,23,1,0,0,36,36
"2489",20200414,"MI",27001,59225,NA,3910,NA,1497,NA,1235,NA,452,"B","4/14/2020 11:00","c89f9fc1f6a3439789444ef7388c5f2dcb52d70a","2020-04-14T20:00:00Z",1768,NA,86226,86226,86226,26,166,0,2216,1366,3582
"2490",20200414,"MN",1695,37546,NA,177,405,75,155,NA,NA,830,"A","4/13/2020 17:00","e66b2e9fffafcbe7534a7541f905fa294d5fa2f9","2020-04-14T20:00:00Z",79,405,39241,39241,39241,27,9,44,769,45,814
"2491",20200414,"MO",4686,43292,NA,1041,NA,NA,NA,NA,NA,NA,"A","4/14/2020 15:00","86fc94a42cdc64c7fcadd162b6bec8cd03e247b7","2020-04-14T20:00:00Z",133,NA,47978,47978,47978,29,19,0,2252,298,2550
"2492",20200414,"MP",13,27,7,NA,NA,NA,NA,NA,NA,NA,"","4/14/2020 00:00","d005c2e743292090da0e3ac3bfbc6b3bdea2d89e","2020-04-14T20:00:00Z",2,NA,47,40,40,69,0,0,0,2,2
"2493",20200414,"MS",3087,34791,NA,NA,596,154,NA,99,NA,NA,"A","4/13/2020 19:00","c66d189100ed089a1303e11cffd8846f8ec58218","2020-04-14T20:00:00Z",111,596,37878,37878,37878,28,13,47,6749,145,6894
"2494",20200414,"MT",399,8835,NA,24,50,NA,NA,NA,NA,197,"A","4/14/2020 11:56","4a64cfcd9b352b05b6162d78c0149f3fde3b92a5","2020-04-14T20:00:00Z",7,50,9234,9234,9234,30,0,3,131,5,136
"2495",20200414,"NC",5024,60015,NA,418,NA,NA,NA,NA,NA,NA,"A","4/14/2020 11:00","61a7bec12a49e0cdc8826687cca3dc18fc6290b8","2020-04-14T20:00:00Z",108,NA,65039,65039,65039,37,22,0,1443,208,1651
"2496",20200414,"ND",341,10575,NA,13,42,NA,NA,NA,NA,138,"B","4/14/2020 13:00","9f4a7303b31f7ec41b2b47f9061f8c5ab7fab25c","2020-04-14T20:00:00Z",9,42,10916,10916,10916,38,1,2,125,10,135
"2497",20200414,"NE",871,10486,NA,NA,NA,NA,NA,NA,NA,NA,"A","4/14/2020 19:45","6237171a5c0aa381aa824756fba407b38e03b06f","2020-04-14T20:00:00Z",18,NA,11357,11357,11357,31,1,0,328,57,385
"2498",20200414,"NH",1020,10590,25,72,152,NA,NA,NA,NA,249,"B","4/14/2020 09:00","7166d075f54ff6264b550d39730f99fbb7e186ca","2020-04-14T20:00:00Z",23,152,11635,11610,11610,33,0,0,368,35,403
"2499",20200414,"NJ",68824,70950,NA,8185,NA,2051,NA,1626,NA,NA,"A","4/14/2020 13:00","6291d521db3bf9068b1bf316a34cff8c8278d878","2020-04-14T20:00:00Z",2805,NA,139774,139774,139774,34,362,0,6065,4240,10305
"2500",20200414,"NM",1345,30625,NA,87,181,NA,NA,NA,NA,304,"A","4/14/2020 20:56","d3f0e898cebe23e3858736e74b6b40a69e58499b","2020-04-14T20:00:00Z",31,181,31970,31970,31970,35,5,181,1355,100,1455
"2501",20200414,"NV",3088,23573,NA,NA,NA,NA,NA,NA,NA,NA,"A","4/14/2020 18:00","3d0428534f605044d76c5d2b91144a7b12597f5d","2020-04-14T20:00:00Z",120,NA,26661,26661,26661,32,6,0,1080,117,1197
"2502",20200414,"NY",202208,296935,NA,18697,44286,5225,NA,NA,NA,25589,"A","4/14/2020 00:00","966bb86f839e9ca2804162af3d3538046e7de66d","2020-04-14T20:00:00Z",10834,44286,499143,499143,499143,36,778,1649,13609,7177,20786
"2503",20200414,"OH",7280,60721,NA,NA,2156,NA,654,NA,NA,NA,"B","4/14/2020 14:00","6acbcf6aae1d50412b6850393ab5bfa2b9c79bd9","2020-04-14T20:00:00Z",324,2156,68001,68001,68001,39,50,123,2584,305,2889
"2504",20200414,"OK",2184,26085,NA,194,488,107,NA,NA,NA,1060,"B","4/14/2020 08:00","6b65096dcfae879dcbfb1c6aaf1f50c98da79d27","2020-04-14T20:00:00Z",108,488,28269,28269,28269,40,9,31,5295,115,5410
"2505",20200414,"OR",1633,30730,NA,311,381,88,NA,44,NA,NA,"A","4/14/2020 11:00","403e478bcb9e9d829ef7c3d22e5c53bcdd5268a2","2020-04-14T20:00:00Z",55,381,32363,32363,32363,41,2,12,1193,49,1242
"2506",20200414,"PA",25345,108286,NA,2317,NA,NA,NA,675,NA,NA,"A","4/14/2020 12:00","d869d16d5c0430f17d1166ec87d645a8d9a2d3eb","2020-04-14T20:00:00Z",584,NA,133631,133631,133631,42,60,0,2693,1146,3839
"2507",20200414,"PR",923,6284,1322,NA,NA,NA,NA,NA,NA,NA,"A","4/14/2020 07:00","80e3b0ada7ec50f18baa857ed8fe273a3067aa22","2020-04-14T20:00:00Z",45,NA,8529,7207,7207,72,0,0,324,20,344
"2508",20200414,"RI",3251,19649,NA,213,331,48,NA,NA,NA,135,"B","4/14/2020 00:00","f475d980e978dc8eb66c5fefa032855805f59c71","2020-04-14T20:00:00Z",80,331,22900,22900,22900,44,7,0,1964,275,2239
"2509",20200414,"SC",3553,30319,NA,NA,675,NA,NA,NA,NA,NA,"B","4/14/2020 15:55","a6257ee3dbc79737f2877bca12bfaa059c6bb369","2020-04-14T20:00:00Z",97,675,33872,33872,33872,45,15,179,2213,234,2447
"2510",20200414,"SD",988,8308,0,NA,45,NA,NA,NA,NA,261,"A","4/13/2020 18:00","64efb5ac7f07d99e11485bd8abad0b3d42452103","2020-04-14T20:00:00Z",6,45,9296,9296,9296,46,0,1,174,120,294
"2511",20200414,"TN",5823,73008,NA,NA,633,NA,NA,NA,NA,1969,"A","4/14/2020 15:00","c521f280500ed9c32453f266b6340aeb0ab71132","2020-04-14T20:00:00Z",124,633,78831,78831,78831,47,15,54,2423,213,2636
"2512",20200414,"TX",14624,131843,NA,1409,NA,NA,NA,NA,NA,2580,"A","4/14/2020 12:45","5d7fd0648e40e997d8a4f720b622a463ff658865","2020-04-14T20:00:00Z",318,NA,146467,146467,146467,48,31,0,12523,718,13241
"2513",20200414,"UT",2412,44064,NA,NA,213,NA,NA,NA,NA,218,"A","4/14/2020 15:00","5ced4e703a9d247592f4a734d701708320e9ea4e","2020-04-14T20:00:00Z",19,213,46476,46476,46476,49,1,12,640,49,689
"2514",20200414,"VA",6171,36592,469,1282,NA,422,NA,276,NA,721,"A","4/13/2020 17:00","006a3ed203e56a525b2ad6e9fd7d5d57ce58cc7c","2020-04-14T20:00:00Z",154,NA,43232,42763,42763,51,5,0,938,424,1362
"2515",20200414,"VI",51,326,23,NA,NA,NA,NA,NA,NA,44,"","4/14/2020 17:30","fa083dfcefe010db0fc0048819b22bdc0255fc56","2020-04-14T20:00:00Z",1,NA,400,377,377,78,0,0,4,0,4
"2516",20200414,"VT",770,9491,NA,64,NA,NA,NA,NA,NA,15,"A","4/14/2020 00:00","c834fe858279c85e43c43d625a17031d0c2dd8fc","2020-04-14T20:00:00Z",29,NA,10261,10261,10261,50,1,0,216,9,225
"2517",20200414,"WA",11234,128037,NA,387,NA,98,NA,NA,NA,NA,"C","4/14/2020 00:00","876c990cb50afa7bfd9064f069b6beacf8b65d13","2020-04-14T20:00:00Z",542,NA,139271,139271,139271,53,16,0,3932,291,4223
"2518",20200414,"WI",3555,37997,277,432,1049,161,283,NA,NA,NA,"A","4/14/2020 16:00","7990a900a1ffecfaa260470bf317d09e487d2b4a","2020-04-14T20:00:00Z",170,1049,41829,41552,41552,55,16,56,1228,127,1355
"2519",20200414,"WV",640,16398,NA,87,164,38,73,25,50,147,"B","4/14/2020 17:00","0bf20997ca6c137acb3a46da320685eeae3a07d0","2020-04-14T20:00:00Z",9,164,17038,17038,17038,54,0,0,369,14,383
"2520",20200414,"WY",275,5689,NA,NA,43,NA,NA,NA,NA,140,"A","4/14/2020 16:05","fc17f818d120c168e187d5fc553b88920e4c4369","2020-04-14T20:00:00Z",1,43,5964,5964,5964,56,0,2,0,0,0
"2521",20200413,"AK",277,7553,NA,NA,32,NA,NA,NA,NA,85,"A","4/13/2020 00:00","f3ede07cb6924edbe99587eb49eb7ae55c2d980f","2020-04-13T20:00:00Z",8,32,7830,7830,7830,2,0,1,-213,5,-208
"2522",20200413,"AL",3734,25448,NA,NA,457,NA,189,NA,119,NA,"B","4/13/2020 00:00","e7d2baf93f8f760025f108068edcf6ed52d168de","2020-04-13T20:00:00Z",99,457,29182,29182,29182,1,6,20,7390,209,7599
"2523",20200413,"AR",1410,19394,NA,74,130,NA,43,28,39,391,"A","4/13/2020 13:33","94365324201e7d36e6b5d48fbd84438708abc94f","2020-04-13T20:00:00Z",30,130,20804,20804,20804,5,3,0,952,130,1082
"2524",20200413,"AS",0,3,NA,NA,NA,NA,NA,NA,NA,NA,"","4/6/2020 00:00","2a664cf0301a7a94e22348e4eca9978088f25f42","2020-04-13T20:00:00Z",NA,NA,3,3,3,60,0,0,0,0,0
"2525",20200413,"AZ",3702,39645,NA,525,NA,286,NA,195,NA,NA,"B","4/13/2020 00:00","ca71158795af1dffd9357fff243cc199fc4c060a","2020-04-13T20:00:00Z",122,NA,43347,43347,43347,4,7,0,1075,163,1238
"2526",20200413,"CA",22348,168534,13200,3015,NA,1178,NA,NA,NA,NA,"B","4/12/2020 00:00","91fce869b68e9d77dbbce09ad93f9a110ef03f38","2020-04-13T20:00:00Z",687,NA,204082,190882,190882,6,36,0,0,554,554
"2527",20200413,"CO",7684,29850,NA,842,1472,NA,NA,NA,NA,NA,"A","4/11/2020 00:00","ad1f5571076a0b8b9f211f7b17117499607516f8","2020-04-13T20:00:00Z",304,1472,37534,37534,37534,8,30,96,1870,791,2661
"2528",20200413,"CT",13381,30928,NA,1760,NA,NA,NA,NA,NA,NA,"A","4/13/2020 16:00","7de199fc6c92a5bb9672026695b91fbd95a57449","2020-04-13T20:00:00Z",602,NA,44309,44309,44309,9,48,0,1743,1346,3089
"2529",20200413,"DC",1955,8979,NA,295,NA,95,NA,31,NA,507,"A","4/13/2020 00:00","6e7b30db355bf929f771c76b9d26122f545da5c9","2020-04-13T20:00:00Z",53,NA,10934,10934,10934,11,3,0,214,80,294
"2530",20200413,"DE",1625,10195,NA,201,NA,NA,NA,NA,NA,213,"A","4/13/2020 17:00","3a2fbaec228cf4c64343a7aa6d99a55692d6783f","2020-04-13T20:00:00Z",35,NA,11820,11820,11820,10,2,0,571,146,717
"2531",20200413,"FL",20601,175606,1789,NA,2833,NA,NA,NA,NA,NA,"A","4/13/2020 17:27","b5c5782615e03ba6805f81c4b5a9e6cb5b0681ed","2020-04-13T20:00:00Z",483,2833,197996,196207,196207,12,18,61,12208,1246,13454
"2532",20200413,"GA",13315,43706,NA,NA,2589,NA,NA,NA,NA,NA,"A","4/13/2020 18:27","e7a2b2f6a556d5f8c005891d59427443fed7597c","2020-04-13T20:00:00Z",464,2589,57021,57021,57021,13,31,84,1705,863,2568
"2533",20200413,"GU",133,770,NA,12,NA,2,NA,2,NA,58,"","4/13/2020 08:00","4debeaa1af142f25c331b325d6086243cc559698","2020-04-13T20:00:00Z",5,NA,903,903,903,66,0,0,77,0,77
"2534",20200413,"HI",499,18345,NA,NA,44,NA,6,NA,2,310,"A","4/13/2020 18:00","7651ab17db2abc5af88e1bbefc35355e4cc7a401","2020-04-13T20:00:00Z",9,44,18844,18844,18844,15,1,0,863,13,876
"2535",20200413,"IA",1710,16986,NA,142,NA,70,NA,41,NA,741,"A","4/12/2020 00:00","b09ac82132d8bbb8d2b452b3b926248a3b600170","2020-04-13T20:00:00Z",43,NA,18696,18696,18696,19,2,0,981,123,1104
"2536",20200413,"ID",1426,13455,NA,NA,132,NA,38,NA,NA,NA,"A","4/13/2020 19:00","15186f4caff96d599e998a8c631b8444fe8a360e","2020-04-13T20:00:00Z",27,132,14881,14881,14881,16,0,1,554,19,573
"2537",20200413,"IL",22025,83743,NA,3680,NA,1166,NA,821,NA,NA,"A","4/13/2020 00:00","717d100479891245fb7835dbe5ccb37c7f62c775","2020-04-13T20:00:00Z",794,NA,105768,105768,105768,17,74,0,3860,1173,5033
"2538",20200413,"IN",8236,36303,NA,NA,NA,740,NA,459,NA,NA,"B","4/12/2020 23:59","489cbbd51dc1d531e34ebb4c7036816ea61bbbac","2020-04-13T20:00:00Z",350,NA,44539,44539,44539,18,7,0,1742,308,2050
"2539",20200413,"KS",1376,12488,NA,NA,309,NA,NA,NA,NA,NA,"B","4/13/2020 11:30","6796780235f8f3923e7f0f20d67f4e372e1835d1","2020-04-13T20:00:00Z",62,309,13864,13864,13864,20,6,11,572,39,611
"2540",20200413,"KY",1963,23903,NA,289,667,136,256,NA,NA,607,"A","4/13/2020 17:00","2fef44bdc2f93da3044edf1efc786b9b04e3d9db","2020-04-13T20:00:00Z",97,667,25866,25866,25866,21,3,208,1176,123,1299
"2541",20200413,"LA",21016,87075,NA,2134,NA,NA,NA,461,NA,NA,"A","4/13/2020 13:00","1ceb37f89780979e34956615420134376e543ef6","2020-04-13T20:00:00Z",884,NA,108091,108091,108091,22,44,0,3625,421,4046
"2542",20200413,"MA",26794,95500,NA,3485,3485,NA,NA,NA,NA,NA,"B","4/13/2020 10:00","a10aab3987971a677afef8f6ddaad918ad1036d6","2020-04-13T20:00:00Z",1211,3485,122294,122294,122294,25,155,971,4037,1413,5450
"2543",20200413,"MD",8936,42815,NA,NA,1975,NA,NA,NA,NA,603,"A","4/13/2020 10:00","13aa01da2013a38100c411620dc4be2ac1b7b54f","2020-04-13T20:00:00Z",262,1975,51751,51751,51751,24,27,115,1276,711,1987
"2544",20200413,"ME",698,11608,NA,22,124,NA,NA,NA,NA,273,"A","4/13/2020 11:45","45c86faaf51473415956b43db2e5469e59fbefd0","2020-04-13T20:00:00Z",19,124,12306,12306,12306,23,0,4,5520,65,5585
"2545",20200413,"MI",25635,57009,NA,3986,NA,1570,NA,1365,NA,447,"B","4/13/2020 11:00","4399404e8c90772e2804bd8b7a318d6ebf398d71","2020-04-13T20:00:00Z",1602,NA,82644,82644,82644,26,115,0,2210,997,3207
"2546",20200413,"MN",1650,36777,NA,157,361,74,146,NA,NA,772,"A","4/12/2020 17:00","1d3d152d5e05a9a8f24c626c4c096d6c0d627dd1","2020-04-13T20:00:00Z",70,361,38427,38427,38427,27,0,0,977,29,1006
"2547",20200413,"MO",4388,41040,NA,988,NA,NA,NA,NA,NA,NA,"A","4/13/2020 15:00","4767c1210c29df38f8cc89481392728204cbc88c","2020-04-13T20:00:00Z",114,NA,45428,45428,45428,29,4,0,0,228,228
"2548",20200413,"MP",11,27,9,NA,NA,NA,NA,NA,NA,NA,"","4/12/2020 00:00","0035b1ccdb8b9309cc1cb55a11dd611564f9cbeb","2020-04-13T20:00:00Z",2,NA,47,38,38,69,0,0,0,0,0
"2549",20200413,"MS",2942,28042,NA,NA,549,124,NA,84,NA,NA,"A","4/13/2020 00:00","198b7f3b03024ef001e523907574ae1e950da676","2020-04-13T20:00:00Z",98,549,30984,30984,30984,28,2,1,9410,161,9571
"2550",20200413,"MT",394,8704,NA,21,47,NA,NA,NA,NA,171,"A","4/13/2020 13:11","34039c422d2dc1eb358fe57e1864873168ca78cd","2020-04-13T20:00:00Z",7,47,9098,9098,9098,30,1,0,178,7,185
"2551",20200413,"NC",4816,58572,NA,313,NA,NA,NA,NA,NA,NA,"A","4/13/2020 11:00","6e1bec7ffa1a3c0fd9ec3c0995f90306806e3ff5","2020-04-13T20:00:00Z",86,NA,63388,63388,63388,37,5,0,953,296,1249
"2552",20200413,"ND",331,10450,NA,13,40,NA,NA,NA,NA,127,"B","4/13/2020 13:00","4d5bac586aa26d219fcb811172e2b2b4df51f0e4","2020-04-13T20:00:00Z",8,40,10781,10781,10781,38,0,1,408,23,431
"2553",20200413,"NE",814,10158,NA,NA,NA,NA,NA,NA,NA,NA,"A","4/13/2020 20:03","e4ea927f3942914cebacd8c0034e884d1f461846","2020-04-13T20:00:00Z",17,NA,10972,10972,10972,31,0,0,258,23,281
"2554",20200413,"NH",985,10222,125,NA,152,NA,NA,NA,NA,239,"B","4/13/2020 09:00","f18aa74aa0bce817914f8c6a25ff642cce7d9656","2020-04-13T20:00:00Z",23,152,11332,11207,11207,33,0,6,226,56,282
"2555",20200413,"NJ",64584,64885,NA,7781,NA,1886,NA,1611,NA,NA,"A","4/13/2020 14:00","f0f04b01d831f47a3f5ecf388761e7066160033e","2020-04-13T20:00:00Z",2443,NA,129469,129469,129469,34,93,0,0,2734,2734
"2556",20200413,"NM",1245,29270,NA,80,NA,NA,NA,NA,NA,295,"A","4/13/2020 00:00","986a8951bd6c6fe9cdc004530bf2237b5c74f0f9","2020-04-13T20:00:00Z",26,NA,30515,30515,30515,35,6,0,1752,71,1823
"2557",20200413,"NV",2971,22493,NA,NA,NA,NA,NA,NA,NA,NA,"A","4/13/2020 10:00","c01e244c960857f95dbf1cd3f41466fcfd66b80c","2020-04-13T20:00:00Z",114,NA,25464,25464,25464,32,2,0,718,135,853
"2558",20200413,"NY",195031,283326,NA,18825,42637,5156,NA,NA,NA,23887,"A","4/13/2020 00:00","e49a38dc1ee6da48e71579b2fd0b060074e034fd","2020-04-13T20:00:00Z",10056,42637,478357,478357,478357,36,671,43,10419,6337,16756
"2559",20200413,"OH",6975,58137,NA,NA,2033,NA,613,NA,NA,NA,"B","4/13/2020 14:00","2e6ef212d62dee85d26529b2ec7ed275e1ae0088","2020-04-13T20:00:00Z",274,2033,65112,65112,65112,39,21,85,1498,371,1869
"2560",20200413,"OK",2069,20790,NA,383,457,191,NA,NA,NA,865,"B","4/13/2020 08:00","34454035c51a3415bb912b897d0a410f9376fd7d","2020-04-13T20:00:00Z",99,457,22859,22859,22859,40,3,11,0,99,99
"2561",20200413,"OR",1584,29537,NA,321,369,96,NA,50,NA,NA,"A","4/13/2020 11:00","c262541454a8a8086a4efb0063057cba00b817f1","2020-04-13T20:00:00Z",53,369,31121,31121,31121,41,1,10,1306,57,1363
"2562",20200413,"PA",24199,105593,NA,2243,NA,NA,NA,669,NA,NA,"A","4/13/2020 12:00","f1c5c427c4927456308686fc1a61558c3651bbd5","2020-04-13T20:00:00Z",524,NA,129792,129792,129792,42,17,0,3536,1366,4902
"2563",20200413,"PR",903,5960,1288,NA,NA,NA,NA,NA,NA,NA,"A","4/13/2020 06:00","f9deec2bb1ea1ff3f5efba8d82f345c2cde28c51","2020-04-13T20:00:00Z",45,NA,8151,6863,6863,72,1,0,141,6,147
"2564",20200413,"RI",2976,17685,NA,197,331,50,NA,26,NA,135,"B","4/13/2020 00:00","78258a2b36f044684574000c03ad0b3690a03c6a","2020-04-13T20:00:00Z",73,331,20661,20661,20661,44,10,331,0,311,311
"2565",20200413,"SC",3319,28106,NA,NA,496,NA,NA,NA,NA,NA,"B","4/13/2020 17:26","5d08b3bbaaa4dca19b3da3fbb734b22e94a8557a","2020-04-13T20:00:00Z",82,496,31425,31425,31425,45,0,0,0,0,0
"2566",20200413,"SD",868,8134,0,NA,44,NA,NA,NA,NA,207,"A","4/12/2020 18:00","1e4181483b5120661d72acc868a7fb51b5858238","2020-04-13T20:00:00Z",6,44,9002,9002,9002,46,0,1,311,138,449
"2567",20200413,"TN",5610,70585,NA,NA,579,NA,NA,NA,NA,1671,"A","4/13/2020 15:00","6a2492b15d9d9a72a63895b695a147730d6d2bd2","2020-04-13T20:00:00Z",109,579,76195,76195,76195,47,8,12,5216,302,5518
"2568",20200413,"TX",13906,119320,NA,1176,NA,NA,NA,NA,NA,2269,"A","4/13/2020 12:45","dcb2598c2ad0880575ef06ebdcd1f2b97bfcdac0","2020-04-13T20:00:00Z",287,NA,133226,133226,133226,48,16,0,8271,422,8693
"2569",20200413,"UT",2363,43424,NA,NA,201,NA,NA,NA,NA,218,"A","4/13/2020 15:00","5eb0aa0d0343ec2c95f140fde0ab40e34cb9498a","2020-04-13T20:00:00Z",18,201,45787,45787,45787,49,0,6,1493,60,1553
"2570",20200413,"VA",5747,35654,473,1238,NA,428,NA,302,NA,NA,"A","4/13/2020 09:00","81c18eb60662a412bc5a33dfb1dea1688242595b","2020-04-13T20:00:00Z",149,NA,41874,41401,41401,51,8,0,943,473,1416
"2571",20200413,"VI",51,322,2,NA,NA,NA,NA,NA,NA,43,"","4/13/2020 18:30","fb021e4d408261d55a25442b2aa45232a8c814d0","2020-04-13T20:00:00Z",1,NA,375,373,373,78,0,0,23,0,23
"2572",20200413,"VT",761,9275,NA,33,NA,NA,NA,NA,NA,15,"A","4/13/2020 00:00","c768034fde55f6d0780ebc7384aae653c50a2f5d","2020-04-13T20:00:00Z",28,NA,10036,10036,10036,50,1,0,551,7,558
"2573",20200413,"WA",10943,124105,NA,527,NA,166,NA,NA,NA,NA,"C","4/13/2020 00:00","9fec508afaca2f5221f87bf65f6adcb7621ec4f5","2020-04-13T20:00:00Z",526,NA,135048,135048,135048,53,17,0,3777,355,4132
"2574",20200413,"WI",3428,36769,273,442,993,175,264,NA,NA,NA,"A","4/13/2020 00:00","470410a083e58e16782bbde4858a57d92b28102f","2020-04-13T20:00:00Z",154,993,40470,40197,40197,55,10,19,853,87,940
"2575",20200413,"WV",626,16029,NA,95,164,43,73,23,50,85,"B","4/13/2020 17:00","f846c933597a9b29b0eb46729b33a3649dc73bd5","2020-04-13T20:00:00Z",9,164,16655,16655,16655,54,1,164,383,15,398
"2576",20200413,"WY",275,5689,NA,NA,41,NA,NA,NA,NA,138,"A","4/13/2020 15:19","01c85988f9c2c42c9b6a49ab1296f354b6ebfdea","2020-04-13T20:00:00Z",1,41,5964,5964,5964,56,1,1,491,14,505
"2577",20200412,"AK",272,7766,NA,NA,31,NA,NA,NA,NA,66,"A","4/12/2020 14:50","ab315126039fdd19bd3cb0ad6fd3881c07202d6a","2020-04-12T20:00:00Z",8,31,8038,8038,8038,2,0,0,291,15,306
"2578",20200412,"AL",3525,18058,NA,NA,437,NA,189,NA,119,NA,"B","4/12/2020 00:00","a7f394585c1f6a6b3443e7ef2c7240908b5808ef","2020-04-12T20:00:00Z",93,437,21583,21583,21583,1,2,35,0,334,334
"2579",20200412,"AR",1280,18442,NA,74,130,NA,43,30,39,367,"A","4/12/2020 11:33","d3646c6a7fa8fb8a8a8e5e0b3821ee700ca8f6d6","2020-04-12T20:00:00Z",27,130,19722,19722,19722,5,3,0,1090,54,1144
"2580",20200412,"AS",0,3,2,NA,NA,NA,NA,NA,NA,NA,"","3/31/2020 19:16","cce5331e33e183bead26ebea1549209752ae62a3","2020-04-12T20:00:00Z",NA,NA,5,3,3,60,0,0,0,0,0
"2581",20200412,"AZ",3539,38570,NA,NA,NA,NA,NA,NA,NA,NA,"B","4/12/2020 00:00","04d465db4a8768ba1f3ae776f14f49e139cb2c00","2020-04-12T20:00:00Z",115,NA,42109,42109,42109,4,7,0,1433,146,1579
"2582",20200412,"CA",21794,168534,13200,5234,NA,1539,NA,NA,NA,NA,"B","4/11/2020 00:00","0c5a7322066feb546eff5b90b64b2e4a4265b9ac","2020-04-12T20:00:00Z",651,NA,203528,190328,190328,6,42,0,15930,1179,17109
"2583",20200412,"CO",6893,27980,NA,822,1376,NA,NA,NA,NA,NA,"A","4/10/2020 00:00","6017f755917b126ae079a84f9cb55f2e9da937df","2020-04-12T20:00:00Z",274,1376,34873,34873,34873,8,24,64,1837,383,2220
"2584",20200412,"CT",12035,29185,NA,1654,NA,NA,NA,NA,NA,NA,"A","4/12/2020 16:00","6d74e6f44cee58968912784c872c4c393f329807","2020-04-12T20:00:00Z",554,NA,41220,41220,41220,9,60,0,864,525,1389
"2585",20200412,"DC",1875,8765,NA,NA,NA,NA,NA,NA,NA,493,"A","4/11/2020 00:00","115822bff3d0400672d20c59c4a70e2e2c372201","2020-04-12T20:00:00Z",50,NA,10640,10640,10640,11,3,0,504,97,601
"2586",20200412,"DE",1479,9624,NA,190,NA,NA,NA,NA,NA,191,"A","4/11/2020 13:30","f2c7dd2649c707e8c13c3df4c1a73fd25b6a8e7b","2020-04-12T20:00:00Z",33,NA,11103,11103,11103,10,0,0,0,0,0
"2587",20200412,"FL",19355,163398,1297,NA,2772,NA,NA,NA,NA,NA,"A","4/12/2020 11:23","35c7df0354d5ab739ab8502ef5c886c3d58bc21d","2020-04-12T20:00:00Z",465,2772,184050,182753,182753,12,27,111,8959,861,9820
"2588",20200412,"GA",12452,42001,NA,NA,2505,NA,NA,NA,NA,NA,"A","4/12/2020 11:27","e7b2606b00086dbdcce227434d9b9b8e09051573","2020-04-12T20:00:00Z",433,2505,54453,54453,54453,13,5,26,2445,293,2738
"2589",20200412,"GU",133,693,NA,13,NA,2,NA,2,NA,58,"","4/11/2020 07:40","ad8e1b871f9464df7e253e3158f71ce8c9f96f81","2020-04-12T20:00:00Z",5,NA,826,826,826,66,0,0,0,0,0
"2590",20200412,"HI",486,17482,NA,NA,44,NA,6,NA,2,300,"A","4/11/2020 18:00","5f18f4cd6fc5ae0d7faa4d1b947aa46416e45c64","2020-04-12T20:00:00Z",8,44,17968,17968,17968,15,0,1,416,21,437
"2591",20200412,"IA",1587,16005,NA,129,NA,55,NA,30,NA,674,"A","4/12/2020 00:00","66cfd2f08f6fec24f3eaac212631bb63d0e2cb48","2020-04-12T20:00:00Z",41,NA,17592,17592,17592,19,7,0,383,77,460
"2592",20200412,"ID",1407,12901,NA,NA,131,NA,38,NA,NA,NA,"A","4/11/2020 19:00","20d340a75145c1d863ead3de6dd5a3e1b38ede6e","2020-04-12T20:00:00Z",27,131,14308,14308,14308,16,2,3,533,11,544
"2593",20200412,"IL",20852,79883,NA,3680,NA,1166,NA,821,NA,NA,"A","4/12/2020 00:00","25c61ff3bf5cce038afdd3964fe48a40bfc48155","2020-04-12T20:00:00Z",720,NA,100735,100735,100735,17,43,0,6914,1672,8586
"2594",20200412,"IN",7928,34561,NA,NA,NA,820,NA,497,NA,NA,"B","4/11/2020 11:59","8914f6941ff2d922ff3aede644cb2d629cd9d0c3","2020-04-12T20:00:00Z",343,NA,42489,42489,42489,18,13,0,2781,493,3274
"2595",20200412,"KS",1337,11916,NA,NA,298,NA,NA,NA,NA,NA,"B","4/12/2020 12:00","0c871b42264b82a78e4dd2c78ccf7bf387498085","2020-04-12T20:00:00Z",56,298,13253,13253,13253,20,1,5,841,69,910
"2596",20200412,"KY",1840,22727,NA,271,459,105,177,NA,NA,464,"A","4/11/2020 17:00","5f19c6cdd17970d7ace7702b2d3f4093d8ade0a0","2020-04-12T20:00:00Z",94,459,24567,24567,24567,21,4,0,132,147,279
"2597",20200412,"LA",20595,83450,NA,2084,NA,NA,NA,458,NA,NA,"A","4/12/2020 13:00","92180c96dd14d0d5bc1e3ebf8b9d5c8fb83c80aa","2020-04-12T20:00:00Z",840,NA,104045,104045,104045,22,34,0,6549,581,7130
"2598",20200412,"MA",25381,91463,NA,2514,2514,NA,NA,NA,NA,NA,"B","4/12/2020 16:00","9d151b754a3c8fff7e950e6dfb015a67f8879821","2020-04-12T20:00:00Z",1056,2514,116844,116844,116844,25,110,7,5348,2615,7963
"2599",20200412,"MD",8225,41539,NA,NA,1860,NA,NA,NA,NA,456,"A","4/12/2020 10:00","8ba0b53279f8efd87986afb76267a02ebd5637bd","2020-04-12T20:00:00Z",235,1860,49764,49764,49764,24,29,151,1995,531,2526
"2600",20200412,"ME",633,6088,NA,NA,120,NA,NA,NA,NA,266,"A","4/12/2020 10:30","c2cc4907c9866e00fede3ab0ad2d106e946af695","2020-04-12T20:00:00Z",19,120,6721,6721,6721,23,0,6,0,17,17
"2601",20200412,"MI",24638,54799,NA,3636,NA,1582,NA,1441,NA,433,"B","4/12/2020 11:00","e3bde5edaaa5c9e7316d174ff839c4a075eb2a71","2020-04-12T20:00:00Z",1487,NA,79437,79437,79437,26,95,0,2778,645,3423
"2602",20200412,"MN",1621,35800,NA,157,361,74,146,NA,NA,772,"A","4/11/2020 21:00","9c3d1347432fa2755d921ef7f42d168520fca1b7","2020-04-12T20:00:00Z",70,361,37421,37421,37421,27,6,21,1823,194,2017
"2603",20200412,"MO",4160,41040,NA,988,NA,NA,NA,NA,NA,NA,"A","4/12/2020 15:00","a66517033d0b97e85b25957fa90a82dc03d00a07","2020-04-12T20:00:00Z",110,NA,45200,45200,45200,29,1,0,1892,136,2028
"2604",20200412,"MP",11,27,9,NA,NA,NA,NA,NA,NA,NA,"","4/11/2020 00:00","2650510b7591047a789d878d6b957f7a66cb0f15","2020-04-12T20:00:00Z",2,NA,47,38,38,69,0,0,0,0,0
"2605",20200412,"MS",2781,18632,NA,NA,548,NA,NA,NA,NA,NA,"A","4/11/2020 19:00","d8730b62b9e1eac4d4e041aa4bd5c5ba08b4161d","2020-04-12T20:00:00Z",96,548,21413,21413,21413,28,3,20,0,139,139
"2606",20200412,"MT",387,8526,NA,22,47,NA,NA,NA,NA,169,"A","4/12/2020 10:21","616ed98fe70349a54287bde379fc0998a50746eb","2020-04-12T20:00:00Z",6,47,8913,8913,8913,30,0,1,322,10,332
"2607",20200412,"NC",4520,57619,NA,331,NA,NA,NA,NA,NA,NA,"A","4/12/2020 10:45","bf0c40d554df30d66fe1bd2b8a2a6937eb4501b0","2020-04-12T20:00:00Z",81,NA,62139,62139,62139,37,1,0,1538,208,1746
"2608",20200412,"ND",308,10042,NA,12,39,NA,NA,NA,NA,121,"B","4/12/2020 12:58","054779b15d36f6768985230ab0d0df0f482bd441","2020-04-12T20:00:00Z",8,39,10350,10350,10350,38,1,3,255,15,270
"2609",20200412,"NE",791,9900,NA,NA,NA,NA,NA,NA,NA,NA,"A","4/12/2020 13:40","d65d87d047488e8d7b15e86a177a03b1aeee61b9","2020-04-12T20:00:00Z",17,NA,10691,10691,10691,31,0,0,615,91,706
"2610",20200412,"NH",929,9996,119,NA,146,NA,NA,NA,NA,236,"B","4/11/2020 09:00","5969d5b38173559f2461673db51b7c18a13e1468","2020-04-12T20:00:00Z",23,146,11044,10925,10925,33,1,12,388,44,432
"2611",20200412,"NJ",61850,64885,NA,7604,NA,1914,NA,1644,NA,NA,"A","4/12/2020 13:00","3d2b97144348615d644a2d7685ff3e3b9b07eb23","2020-04-12T20:00:00Z",2350,NA,126735,126735,126735,34,167,0,2843,3699,6542
"2612",20200412,"NM",1174,27518,NA,78,NA,NA,NA,18,NA,235,"A","4/11/2020 00:00","73258fe4cab1bd6378aeca36639820f1987343d1","2020-04-12T20:00:00Z",20,NA,28692,28692,28692,35,1,0,1511,83,1594
"2613",20200412,"NV",2836,21775,NA,282,NA,NA,NA,NA,NA,NA,"A","4/12/2020 10:30","55f6de4c2992ec54f6f81f15b1fba189a04f69af","2020-04-12T20:00:00Z",112,NA,24611,24611,24611,32,10,0,888,136,1024
"2614",20200412,"NY",188694,272907,NA,18707,42594,5198,NA,NA,NA,23887,"A","4/12/2020 00:00","a2b5e5ca1d9eab043b5a07364a9690228d53943c","2020-04-12T20:00:00Z",9385,42594,461601,461601,461601,36,758,1915,12385,8236,20621
"2615",20200412,"OH",6604,56639,NA,NA,1948,NA,595,NA,NA,NA,"B","4/12/2020 14:00","13e6e1e84e14fc036aa2e18adf57cccbf38d53c7","2020-04-12T20:00:00Z",253,1948,63243,63243,63243,39,6,89,2418,354,2772
"2616",20200412,"OK",1970,20790,NA,383,446,191,NA,NA,NA,865,"B","4/12/2020 08:00","43e878313dada7a58b593f0cad4173d9946e88f0","2020-04-12T20:00:00Z",96,446,22760,22760,22760,40,2,0,0,102,102
"2617",20200412,"OR",1527,28231,NA,295,359,81,NA,52,NA,NA,"A","4/12/2020 11:00","52519aa8dc557098bb10b6fb3c530341de786060","2020-04-12T20:00:00Z",52,359,29758,29758,29758,41,4,21,2378,156,2534
"2618",20200412,"PA",22833,102057,NA,2097,NA,NA,NA,649,NA,NA,"A","4/12/2020 12:00","0927d15cf2e902cfc875e2f38949f85ea999224d","2020-04-12T20:00:00Z",507,NA,124890,124890,124890,42,13,0,3559,1178,4737
"2619",20200412,"PR",897,5819,1251,NA,NA,NA,NA,NA,NA,NA,"A","4/12/2020 07:00","def2a5993cffb3701333607d9c0afec1927961e3","2020-04-12T20:00:00Z",44,NA,7967,6716,6716,72,2,0,236,109,345
"2620",20200412,"RI",2665,17685,NA,201,NA,50,NA,26,NA,35,"B","4/12/2020 00:00","bc5c2698c90c85e5fdcb1e7accff23c6ed390f2c","2020-04-12T20:00:00Z",63,NA,20350,20350,20350,44,7,0,1827,316,2143
"2621",20200412,"SC",3319,28106,NA,NA,496,NA,NA,NA,NA,NA,"B","4/12/2020 15:30","704fd7409cd6dca97a9208ca9c1a28bef984410e","2020-04-12T20:00:00Z",82,496,31425,31425,31425,45,2,0,1220,112,1332
"2622",20200412,"SD",730,7823,0,NA,43,NA,NA,NA,NA,197,"A","4/11/2020 18:00","ddb8d2d8f83f7e8399a0b5549eebbc602655b2d3","2020-04-12T20:00:00Z",6,43,8553,8553,8553,46,0,10,445,104,549
"2623",20200412,"TN",5308,65369,NA,NA,567,NA,NA,NA,NA,1504,"A","4/11/2020 15:00","8efac0db766cfab1489374a4fae96df946068a81","2020-04-12T20:00:00Z",101,567,70677,70677,70677,47,0,11,3655,194,3849
"2624",20200412,"TX",13484,111049,NA,1338,NA,NA,NA,NA,NA,2014,"A","4/11/2020 21:00","03b826e537c619d0b4fa61cf3c61aa7543fa6dff","2020-04-12T20:00:00Z",271,NA,124533,124533,124533,48,17,0,3077,923,4000
"2625",20200412,"UT",2303,41931,NA,NA,195,NA,NA,NA,NA,NA,"A","4/12/2020 15:00","da85271ce87ed0427aaec64dccd41060551047cb","2020-04-12T20:00:00Z",18,195,44234,44234,44234,49,0,5,1591,97,1688
"2626",20200412,"VA",5274,34711,521,751,NA,440,NA,294,NA,NA,"A","4/11/2020 17:00","935d20ce71c6f902807fe3ca1d2c972c013e20b7","2020-04-12T20:00:00Z",141,NA,40506,39985,39985,51,11,0,1789,197,1986
"2627",20200412,"VI",51,299,20,3,NA,NA,NA,NA,NA,43,"","4/10/2020 00:00","b746c3b24f77380774fa0dbfcba75a853d9b5570","2020-04-12T20:00:00Z",1,NA,370,350,350,78,0,0,0,0,0
"2628",20200412,"VT",754,8724,NA,34,NA,NA,NA,NA,NA,15,"A","4/12/2020 00:00","9337ebe35b4a15726ebeceac7f20432b06c5aa80","2020-04-12T20:00:00Z",27,NA,9478,9478,9478,50,2,0,661,21,682
"2629",20200412,"WA",10588,120328,NA,642,NA,191,NA,NA,NA,NA,"C","4/12/2020 00:00","e72f5eeb7262b8f9292b596063bf9d9ead7aa30d","2020-04-12T20:00:00Z",509,NA,130916,130916,130916,53,15,0,1341,84,1425
"2630",20200412,"WI",3341,35916,NA,442,974,179,261,NA,NA,NA,"A","4/12/2020 09:46","9fdec64068d8b8153b7f14af19ba05e85cb58ca7","2020-04-12T20:00:00Z",144,974,39257,39257,39257,55,7,24,1236,128,1364
"2631",20200412,"WV",611,15646,NA,81,NA,36,NA,24,NA,83,"B","4/12/2020 17:00","3992bf14df48889edb3d05cbd971deb8f4306571","2020-04-12T20:00:00Z",8,NA,16257,16257,16257,54,3,0,771,34,805
"2632",20200412,"WY",261,5198,NA,NA,40,NA,NA,NA,NA,137,"A","4/11/2020 18:00","baeee884ee322d3b0249ad2bed77a302a604e1ec","2020-04-12T20:00:00Z",0,40,5459,5459,5459,56,0,3,0,0,0
"2633",20200411,"AK",257,7475,NA,NA,31,NA,NA,NA,NA,63,"A","4/11/2020 14:45","27d36d2d903e4b0763dc60d11778d85abadb887e","2020-04-11T20:00:00Z",8,31,7732,7732,7732,2,1,3,289,11,300
"2634",20200411,"AL",3191,18058,NA,NA,402,NA,177,NA,113,NA,"B","4/11/2020 00:00","240469b6cba18fdb8a5bcca4fa330d25de051596","2020-04-11T20:00:00Z",91,402,21249,21249,21249,1,11,34,0,223,223
"2635",20200411,"AR",1226,17352,NA,86,130,NA,43,33,39,340,"A","4/11/2020 13:20","c728fbde8f2f065b039241e81887faafbfa0338b","2020-04-11T20:00:00Z",24,130,18578,18578,18578,5,1,0,1403,55,1458
"2636",20200411,"AS",0,3,2,NA,NA,NA,NA,NA,NA,NA,"","3/31/2020 19:16","1724fb337329f960ec47640e1efecf07800c6b64","2020-04-11T20:00:00Z",NA,NA,5,3,3,60,0,0,0,0,0
"2637",20200411,"AZ",3393,37137,NA,NA,NA,NA,NA,NA,NA,NA,"B","4/11/2020 00:00","ca6b7cd7f97336895c66fb9036ab14b0578c7e10","2020-04-11T20:00:00Z",108,NA,40530,40530,40530,4,11,0,2515,281,2796
"2638",20200411,"CA",20615,152604,13200,5236,NA,1591,NA,NA,NA,NA,"B","4/9/2020 00:00","5d00dc8e18132f84aa79ae37cb52599cdc1c7a3d","2020-04-11T20:00:00Z",609,NA,186419,173219,173219,6,68,0,7213,1143,8356
"2639",20200411,"CO",6510,26143,NA,841,1312,NA,NA,NA,NA,NA,"A","4/9/2020 00:00","747c3403e838a7f003fb98f25aa080b1cd549f89","2020-04-11T20:00:00Z",250,1312,32653,32653,32653,8,0,0,0,0,0
"2640",20200411,"CT",11510,28321,NA,1593,NA,NA,NA,NA,NA,NA,"A","4/11/2020 15:30","58f8f2eae503628702831e6bff79b1139a6efa8a","2020-04-11T20:00:00Z",494,NA,39831,39831,39831,9,46,0,2571,972,3543
"2641",20200411,"DC",1778,8261,NA,NA,NA,NA,NA,NA,NA,447,"A","4/10/2020 10:00","d77c4c7fc0400e7f4fc777f4c7d2241d9116ad42","2020-04-11T20:00:00Z",47,NA,10039,10039,10039,11,9,0,566,118,684
"2642",20200411,"DE",1479,9624,NA,190,NA,NA,NA,NA,NA,191,"A","4/11/2020 13:30","8af6db12fb508b713b13e9afefa03e41220c17f2","2020-04-11T20:00:00Z",33,NA,11103,11103,11103,10,10,0,-791,153,-638
"2643",20200411,"FL",18494,154439,1418,NA,2661,NA,NA,NA,NA,NA,"A","4/11/2020 11:30","703584c18ed5ac5c3c843afed44d77db9cf6bbbc","2020-04-11T20:00:00Z",438,2661,174351,172933,172933,12,48,174,9140,963,10103
"2644",20200411,"GA",12159,39556,NA,NA,2479,NA,NA,NA,NA,NA,"A","4/11/2020 11:28","dadf51463882d73949361915201824aefd8ec8fb","2020-04-11T20:00:00Z",428,2479,51715,51715,51715,13,12,128,4892,676,5568
"2645",20200411,"GU",133,693,NA,14,NA,2,NA,2,NA,58,"","4/11/2020 07:40","a0267f35e988676a92ce47ca31ccf830cbe3340a","2020-04-11T20:00:00Z",5,NA,826,826,826,66,1,0,31,3,34
"2646",20200411,"HI",465,17066,NA,NA,43,NA,6,NA,2,284,"A","4/10/2020 18:00","9c1fd3082daa4bcc407babba93cf516450828220","2020-04-11T20:00:00Z",8,43,17531,17531,17531,15,2,1,1359,23,1382
"2647",20200411,"IA",1510,15622,NA,118,NA,55,NA,30,NA,585,"A","4/11/2020 00:00","4b7b50c89e973cdbe3def7ae08062a3a2af51114","2020-04-11T20:00:00Z",34,NA,17132,17132,17132,19,3,0,1057,122,1179
"2648",20200411,"ID",1396,12368,NA,NA,128,NA,35,NA,NA,NA,"A","4/10/2020 19:00","c76eb776d570f221f568c294f282b9ac2e5dc107","2020-04-11T20:00:00Z",25,128,13764,13764,13764,16,1,1,627,43,670
"2649",20200411,"IL",19180,72969,NA,3680,NA,1166,NA,821,NA,NA,"A","4/11/2020 00:00","100b230e907a0d7de1a63d0a2d572543b5783be8","2020-04-11T20:00:00Z",677,NA,92149,92149,92149,17,81,0,3329,1293,4622
"2650",20200411,"IN",7435,31780,NA,NA,NA,820,NA,497,NA,NA,"B","4/10/2020 23:59","d6583da0f546e2c120e27a1a7310ad8ece4a4117","2020-04-11T20:00:00Z",330,NA,39215,39215,39215,18,30,0,3647,528,4175
"2651",20200411,"KS",1268,11075,NA,NA,293,NA,NA,NA,NA,NA,"B","4/11/2020 11:00","15258ea4c78b65e4d7af5a105c2b056f301d5ec2","2020-04-11T20:00:00Z",55,293,12343,12343,12343,20,5,19,827,102,929
"2652",20200411,"KY",1693,22595,NA,271,459,105,177,NA,NA,464,"A","4/10/2020 17:00","026914690bbb9576b2ec1184671143fe68d4bd8f","2020-04-11T20:00:00Z",90,459,24288,24288,24288,21,0,0,0,0,0
"2653",20200411,"LA",20014,76901,NA,2067,NA,NA,NA,470,NA,NA,"A","4/11/2020 13:00","4c3e29c850283fcf033a4d65958845db934f6ab3","2020-04-11T20:00:00Z",806,NA,96915,96915,96915,22,51,0,3874,761,4635
"2654",20200411,"MA",22766,86115,NA,2507,2507,NA,NA,NA,NA,NA,"B","4/11/2020 12:30","390a710a9a9334a794b56f6625560b11668064d7","2020-04-11T20:00:00Z",946,2507,108881,108881,108881,25,114,72,4551,1888,6439
"2655",20200411,"MD",7694,39544,NA,NA,1709,NA,NA,NA,NA,431,"A","4/11/2020 10:00","2ddb13a518e5cbb668c5d1e76eebe48e52a8d6eb","2020-04-11T20:00:00Z",206,1709,47238,47238,47238,24,35,296,2064,726,2790
"2656",20200411,"ME",616,6088,NA,NA,114,NA,NA,NA,NA,256,"A","4/11/2020 11:00","92c07d997c7ca9a34e81112f40b81ef0298089a1","2020-04-11T20:00:00Z",19,114,6704,6704,6704,23,2,3,0,30,30
"2657",20200411,"MI",23993,52021,NA,3636,NA,1582,NA,1441,NA,595,"B","4/11/2020 11:00","b2a7823aafa81a217fb6d15c2457417d81248cab","2020-04-11T20:00:00Z",1392,NA,76014,76014,76014,26,111,0,2760,1210,3970
"2658",20200411,"MN",1427,33977,NA,145,340,69,138,NA,NA,729,"A","4/10/2020 17:00","1834acc68688ebfc3380a8cd949bd18b41f8b60f","2020-04-11T20:00:00Z",64,340,35404,35404,35404,27,7,23,1419,91,1510
"2659",20200411,"MO",4024,39148,NA,506,NA,NA,NA,NA,NA,NA,"A","4/11/2020 15:00","56328595eb22919c369c7a3bf47fb3e9ebee5ef6","2020-04-11T20:00:00Z",109,NA,43172,43172,43172,29,13,0,2207,225,2432
"2660",20200411,"MP",11,27,9,NA,NA,NA,NA,NA,NA,NA,"","4/11/2020 00:00","187b17a38ecd4cf70c41a2140801208c5637c718","2020-04-11T20:00:00Z",2,NA,47,38,38,69,0,0,0,0,0
"2661",20200411,"MS",2642,18632,NA,NA,528,NA,NA,NA,NA,NA,"A","4/10/2020 19:00","2faeb4542e275d1b05dad5a6e7b40c1fb0fbaa68","2020-04-11T20:00:00Z",93,528,21274,21274,21274,28,11,46,0,173,173
"2662",20200411,"MT",377,8204,NA,21,46,NA,NA,NA,NA,169,"A","4/10/2020 00:00","b0963f72d5a9728307bac46c6fcc96713542f5fc","2020-04-11T20:00:00Z",6,46,8581,8581,8581,30,0,5,272,12,284
"2663",20200411,"NC",4312,56081,NA,362,NA,NA,NA,NA,NA,NA,"A","4/11/2020 11:00","499285a83edd743eb822dda9d344d6c0fa619ab0","2020-04-11T20:00:00Z",80,NA,60393,60393,60393,37,6,0,2344,404,2748
"2664",20200411,"ND",293,9787,NA,10,36,NA,NA,NA,NA,119,"B","4/11/2020 13:00","8468d1adaf5b9d317f4cefb765efa0c1736ca3d6","2020-04-11T20:00:00Z",7,36,10080,10080,10080,38,1,0,457,15,472
"2665",20200411,"NE",700,9285,NA,NA,NA,NA,NA,NA,NA,NA,"A","4/11/2020 14:00","b0b36a476e8efe49d68d16442d9bb3cbfcd5f2c5","2020-04-11T20:00:00Z",17,NA,9985,9985,9985,31,2,0,566,65,631
"2666",20200411,"NH",885,9608,93,NA,134,NA,NA,NA,NA,234,"B","4/9/2020 09:00","72cc0ae9a74610cdec63b2d6201a1998c2ca8f35","2020-04-11T20:00:00Z",22,134,10586,10493,10493,33,1,10,469,66,535
"2667",20200411,"NJ",58151,62042,NA,7618,NA,1746,NA,1650,NA,NA,"A","4/11/2020 13:00","78f470c861fdf7c6d45fd86375d24c60d548e6f5","2020-04-11T20:00:00Z",2183,NA,120193,120193,120193,34,251,0,3107,3563,6670
"2668",20200411,"NM",1091,26007,NA,75,NA,NA,NA,18,NA,235,"A","4/10/2020 00:00","ecea73deb24eaa38d43aa7425c5d9305f8b721eb","2020-04-11T20:00:00Z",19,NA,27098,27098,27098,35,0,0,0,0,0
"2669",20200411,"NV",2700,20887,NA,282,NA,NA,NA,NA,NA,NA,"A","4/11/2020 10:30","266140d6b6f9ac38f17e413528080ea91cd52423","2020-04-11T20:00:00Z",102,NA,23587,23587,23587,32,16,0,722,116,838
"2670",20200411,"NY",180458,260522,NA,18654,40679,5009,NA,NA,NA,22025,"A","4/11/2020 00:00","60d59689466fa1b6881e580773ee0d115443c6af","2020-04-11T20:00:00Z",8627,40679,440980,440980,440980,36,783,1861,13149,9946,23095
"2671",20200411,"OH",6250,54221,NA,NA,1859,NA,572,NA,NA,NA,"B","4/11/2020 14:00","178a8aab50ca07d5724eb59a8a4f7c73f8f92027","2020-04-11T20:00:00Z",247,1859,60471,60471,60471,39,16,104,1526,372,1898
"2672",20200411,"OK",1868,20790,NA,383,446,191,NA,NA,NA,865,"B","4/11/2020 08:00","b1d8cf0c5a94095729ba0460d021b8a2d1b27903","2020-04-11T20:00:00Z",94,446,22658,22658,22658,40,6,18,420,74,494
"2673",20200411,"OR",1371,25853,NA,140,338,58,NA,46,NA,NA,"A","4/10/2020 11:00","bb1e4f995a38b802751fd45c3ef066396cbe522e","2020-04-11T20:00:00Z",48,338,27224,27224,27224,41,4,12,1547,50,1597
"2674",20200411,"PA",21655,98498,NA,2115,NA,NA,NA,639,NA,NA,"A","4/11/2020 12:00","5d14e3f95510544cead308bbc6ee8940fbfe12bd","2020-04-11T20:00:00Z",494,NA,120153,120153,120153,42,78,0,5458,1676,7134
"2675",20200411,"PR",788,5583,1332,NA,NA,NA,NA,NA,NA,NA,"A","4/11/2020 07:00","1fae83dc9ac6d45fbda9fd4388c275d0cec2fae4","2020-04-11T20:00:00Z",42,NA,7703,6371,6371,72,3,0,462,63,525
"2676",20200411,"RI",2349,15858,NA,183,NA,50,NA,26,NA,35,"B","4/11/2020 00:00","6bded5d25aa468065955ee1dca799a4d22d4f68d","2020-04-11T20:00:00Z",56,NA,18207,18207,18207,44,7,0,3577,334,3911
"2677",20200411,"SC",3207,26886,NA,NA,496,NA,NA,NA,NA,NA,"B","4/11/2020 15:31","e86b8b2397e4b339e40c4545e593b3f7aa4268bb","2020-04-11T20:00:00Z",80,496,30093,30093,30093,45,8,0,1768,142,1910
"2678",20200411,"SD",626,7378,2,NA,33,NA,NA,NA,NA,189,"A","4/10/2020 18:00","035ea7382b97b5f6fb1c437bc4dcec80c2d32561","2020-04-11T20:00:00Z",6,33,8006,8004,8004,46,0,4,267,90,357
"2679",20200411,"TN",5114,61714,NA,NA,556,NA,NA,NA,NA,1386,"A","4/11/2020 15:00","198d5b4ada99ad74b1712a7fe14d3216de77c031","2020-04-11T20:00:00Z",101,556,66828,66828,66828,47,3,20,3777,252,4029
"2680",20200411,"TX",12561,107972,NA,1514,NA,NA,NA,NA,NA,1617,"A","4/11/2020 12:40","feb5a1f3f112cbb6be444af903cc4c79e5f1d40b","2020-04-11T20:00:00Z",254,NA,120533,120533,120533,48,28,0,3925,890,4815
"2681",20200411,"UT",2206,40340,NA,NA,190,NA,NA,NA,NA,NA,"A","4/11/2020 15:00","9d6d191c9c2ea784ad2ed85570cd9c8b2571ee46","2020-04-11T20:00:00Z",18,190,42546,42546,42546,49,1,7,1680,104,1784
"2682",20200411,"VA",5077,32922,517,1252,NA,426,NA,283,NA,NA,"A","4/10/2020 17:00","f5893567ec416bdf08a2aff15fe6cef78dfcfc06","2020-04-11T20:00:00Z",130,NA,38516,37999,37999,51,9,0,1972,568,2540
"2683",20200411,"VI",51,299,20,3,NA,NA,NA,NA,NA,43,"","4/11/2020 09:30","d74e5ce36226ff7315d0282b00b8434ce04decd8","2020-04-11T20:00:00Z",1,NA,370,350,350,78,0,0,26,1,27
"2684",20200411,"VT",733,8063,NA,77,NA,NA,NA,NA,NA,15,"A","4/11/2020 00:00","cbd2852383500a594fa86d090bf8a15942d6b219","2020-04-11T20:00:00Z",25,NA,8796,8796,8796,50,1,0,561,20,581
"2685",20200411,"WA",10504,118987,NA,649,NA,191,NA,NA,NA,NA,"C","4/11/2020 00:00","4b560350b099dbe3cd75d96673f04d5da3e7d1a4","2020-04-11T20:00:00Z",494,NA,129491,129491,129491,53,18,0,1888,154,2042
"2686",20200411,"WI",3213,34680,NA,444,950,179,257,NA,NA,NA,"A","4/11/2020 01:00","452c6d5dcb201632b5519a5f91d91166fd5a82db","2020-04-11T20:00:00Z",137,950,37893,37893,37893,55,9,46,1455,145,1600
"2687",20200411,"WV",577,14875,NA,85,NA,40,NA,22,NA,63,"B","4/11/2020 10:00","31fcc8cc5d107e65d1c139458c922bddcce05907","2020-04-11T20:00:00Z",5,NA,15452,15452,15452,54,0,0,874,23,897
"2688",20200411,"WY",261,5198,NA,NA,37,NA,NA,NA,NA,129,"A","4/11/2020 18:00","fce4a121734e726ec0a85bd483b794d7110b4a5e","2020-04-11T20:00:00Z",0,37,5459,5459,5459,56,0,0,462,8,470
"2689",20200410,"AK",246,7186,NA,NA,28,NA,NA,NA,NA,55,"A","4/10/2020 15:30","11c8b876833123a3c18cfaac4900d4218ae7522f","2020-04-10T20:00:00Z",7,28,7432,7432,7432,2,0,1,198,11,209
"2690",20200410,"AL",2968,18058,NA,NA,368,NA,NA,NA,NA,NA,"B","4/10/2020 00:00","e91676cc3e3dbe635ec583ab4607d4d02a3f3e73","2020-04-10T20:00:00Z",80,368,21026,21026,21026,1,6,35,0,199,199
"2691",20200410,"AR",1171,15949,NA,86,130,NA,43,33,39,312,"A","4/10/2020 14:36","2edb28149eacfc79d95c4a519c0071a41fe57096","2020-04-10T20:00:00Z",23,130,17120,17120,17120,5,2,0,2117,52,2169
"2692",20200410,"AS",0,3,2,NA,NA,NA,NA,NA,NA,NA,"","4/6/2020 16:00","dbbc6a1e0d8608e0d026394332ec6dcdc3834ce7","2020-04-10T20:00:00Z",0,NA,5,3,3,60,0,0,0,0,0
"2693",20200410,"AZ",3112,34622,NA,NA,NA,NA,NA,NA,NA,NA,"B","4/10/2020 00:00","dca27879e9e3867d590d7ff708aa5bdd1c2929f1","2020-04-10T20:00:00Z",97,NA,37734,37734,37734,4,8,0,462,94,556
"2694",20200410,"CA",19472,145391,13900,2897,NA,1145,NA,NA,NA,NA,"B","4/9/2020 00:00","8cfcf27a0009b4126a871dc45418782f90d90905","2020-04-10T20:00:00Z",541,NA,178763,164863,164863,6,49,0,200,1163,1363
"2695",20200410,"CO",6510,26143,NA,842,1312,NA,NA,NA,NA,NA,"A","4/8/2020 00:00","28e72947a4c70b4c63347e0f39c95846728e10e0","2020-04-10T20:00:00Z",250,1312,32653,32653,32653,8,57,150,2599,855,3454
"2696",20200410,"CT",10538,25750,NA,1562,NA,NA,NA,NA,NA,NA,"A","4/10/2020 17:00","a57ade9c378f1cf2ebf877845faa562bd8bb125e","2020-04-10T20:00:00Z",448,NA,36288,36288,36288,9,68,0,2032,754,2786
"2697",20200410,"DC",1660,7695,NA,NA,NA,NA,NA,NA,NA,426,"A","4/10/2020 10:00","dc7764306f4d8db969ff5264a1de807bab3826d5","2020-04-10T20:00:00Z",38,NA,9355,9355,9355,11,6,0,494,137,631
"2698",20200410,"DE",1326,10415,NA,181,NA,NA,NA,NA,NA,177,"A","4/10/2020 14:00","9be6836ea8b937fe022f580defe14ebeadcaac5a","2020-04-10T20:00:00Z",23,NA,11741,11741,11741,10,0,0,1732,119,1851
"2699",20200410,"FL",17531,145299,1411,NA,2487,NA,NA,NA,NA,NA,"A","4/10/2020 11:30","bde7efe5e1545cdfed724a61668ae8b942ef0548","2020-04-10T20:00:00Z",390,2487,164241,162830,162830,12,36,219,9114,1167,10281
"2700",20200410,"GA",11483,34664,NA,NA,2351,NA,NA,NA,NA,NA,"A","4/10/2020 11:28","ec22a6fca930679c883b2d47a6dd6df6e2764119","2020-04-10T20:00:00Z",416,2351,46147,46147,46147,13,37,192,4145,917,5062
"2701",20200410,"GU",130,662,NA,14,NA,2,NA,2,NA,41,"","4/9/2020 20:45","e659b13210dcefc1a0ee8213f6d0dfbf4278099b","2020-04-10T20:00:00Z",4,NA,792,792,792,66,0,0,69,2,71
"2702",20200410,"HI",442,15707,NA,NA,42,NA,6,NA,2,251,"A","4/9/2020 18:00","6e8312be0dca093d9125120eb14647e1e00b34be","2020-04-10T20:00:00Z",6,42,16149,16149,16149,15,1,0,391,7,398
"2703",20200410,"IA",1388,14565,NA,125,NA,55,NA,30,NA,506,"A","4/10/2020 00:00","0149fe025a46a5a2dd35e51b934ca17e04c08414","2020-04-10T20:00:00Z",31,NA,15953,15953,15953,19,2,0,862,118,980
"2704",20200410,"ID",1353,11741,NA,NA,127,NA,33,NA,NA,NA,"A","4/9/2020 19:00","615494e7a80bd530e2c60d031251194c32e20c02","2020-04-10T20:00:00Z",24,127,13094,13094,13094,16,6,14,442,121,563
"2705",20200410,"IL",17887,69640,NA,3680,NA,1166,NA,821,NA,NA,"A","4/10/2020 00:00","917761ab030f3e95c5190e61523ab9c1def68dfd","2020-04-10T20:00:00Z",596,NA,87527,87527,87527,17,68,0,5205,1465,6670
"2706",20200410,"IN",6907,28133,NA,NA,NA,820,NA,497,NA,NA,"B","4/10/2020 10:00","b1405e7b67921aaf898bb3d7cc56aafb046760ec","2020-04-10T20:00:00Z",300,NA,35040,35040,35040,18,55,0,2351,556,2907
"2707",20200410,"KS",1166,10248,NA,NA,274,NA,NA,NA,NA,NA,"B","4/10/2020 09:30","353cf136f94817eb650f5788806e31d83ded7da1","2020-04-10T20:00:00Z",50,274,11414,11414,11414,20,8,11,579,60,639
"2708",20200410,"KY",1693,22595,NA,271,459,105,177,NA,NA,464,"A","4/10/2020 17:00","b5d516c88a1d7ac6460abc1d5bd0ca5971adb9ac","2020-04-10T20:00:00Z",90,459,24288,24288,24288,21,17,459,2140,347,2487
"2709",20200410,"LA",19253,73027,NA,2054,NA,NA,NA,479,NA,NA,"A","4/10/2020 13:00","bc440f37a24b708ac2daea04a8323ad652b20058","2020-04-10T20:00:00Z",755,NA,92280,92280,92280,22,53,0,4391,970,5361
"2710",20200410,"MA",20878,81564,NA,2435,2435,NA,NA,NA,NA,NA,"B","4/10/2020 12:30","bd8ab000ee6ee7a5a020a8bb386b1eb7246d8c35","2020-04-10T20:00:00Z",832,2435,102442,102442,102442,25,107,133,5418,2035,7453
"2711",20200410,"MD",6968,37480,NA,NA,1413,NA,NA,NA,NA,397,"A","4/10/2020 10:00","aa3b7f19e3a7e78fdf9ae5354137bf1706bd3e01","2020-04-10T20:00:00Z",171,1413,44448,44448,44448,24,33,65,2136,783,2919
"2712",20200410,"ME",586,6088,NA,NA,111,NA,NA,NA,NA,246,"A","4/10/2020 12:00","11b3197b875b016ef915c786e0b1d9040ec83aba","2020-04-10T20:00:00Z",17,111,6674,6674,6674,23,1,6,0,26,26
"2713",20200410,"MI",22783,49261,NA,3823,NA,1663,NA,1394,NA,56,"B","4/10/2020 11:00","f221d5e7926fd2cf764f39b4acfaa9decdfaf754","2020-04-10T20:00:00Z",1281,NA,72044,72044,72044,26,205,0,3711,1279,4990
"2714",20200410,"MN",1336,32558,NA,143,317,64,131,NA,NA,675,"A","4/9/2020 17:00","48eab0d6a718a3621f0ee0a14ec73d87daad8ea3","2020-04-10T20:00:00Z",57,317,33894,33894,33894,27,7,24,1506,94,1600
"2715",20200410,"MO",3799,36941,NA,568,NA,NA,NA,NA,NA,NA,"A","4/10/2020 15:00","dbebd870875f930e4754654989c3124c4ec8f52f","2020-04-10T20:00:00Z",96,NA,40740,40740,40740,29,19,0,1986,260,2246
"2716",20200410,"MP",11,27,9,NA,NA,NA,NA,NA,NA,NA,"","4/10/2020 00:00","4103654fecc778a9d9307a099bc0178aa5432958","2020-04-10T20:00:00Z",2,NA,47,38,38,69,0,0,0,0,0
"2717",20200410,"MS",2469,18632,NA,NA,482,NA,NA,NA,NA,NA,"A","4/9/2020 19:00","afacd44c0d14a7ad7710082e77732f1dc53c9625","2020-04-10T20:00:00Z",82,482,21101,21101,21101,28,6,41,0,209,209
"2718",20200410,"MT",365,7932,NA,29,41,NA,NA,NA,NA,165,"A","4/10/2020 11:25","af7442f49c23e66b77e939b366412d35a2f9607d","2020-04-10T20:00:00Z",6,41,8297,8297,8297,30,0,5,426,11,437
"2719",20200410,"NC",3908,53737,NA,423,NA,NA,NA,NA,NA,NA,"A","4/10/2020 11:00","38fbbfb79456e061d8075c0b8cca51dba34aa0fb","2020-04-10T20:00:00Z",74,NA,57645,57645,57645,37,9,0,9579,257,9836
"2720",20200410,"ND",278,9330,NA,13,36,NA,NA,NA,NA,105,"B","4/10/2020 13:00","fc4f42e6828d806c56909736634fa39da4d5aecf","2020-04-10T20:00:00Z",6,36,9608,9608,9608,38,1,2,609,9,618
"2721",20200410,"NE",635,8719,NA,NA,NA,NA,NA,NA,NA,NA,"A","4/10/2020 13:50","6b30849d9f6ea1fe5bfdecf0ddcbedfff1643fcb","2020-04-10T20:00:00Z",15,NA,9354,9354,9354,31,1,0,603,68,671
"2722",20200410,"NH",819,9139,155,NA,124,NA,NA,NA,NA,234,"B","4/9/2020 09:00","b8ccb4fb46fe4f4574ef150119f75519f0e1eb4a","2020-04-10T20:00:00Z",21,124,10113,9958,9958,33,3,6,376,31,407
"2723",20200410,"NJ",54588,58935,NA,7570,NA,1679,NA,1663,NA,682,"A","4/10/2020 13:00","01b723126abfcd5daec6878934ed34dbf08dfe75","2020-04-10T20:00:00Z",1932,NA,113523,113523,113523,34,232,0,2770,3561,6331
"2724",20200410,"NM",1091,26007,NA,73,NA,NA,NA,18,NA,217,"A","4/10/2020 00:00","0a732fb018e09ef91626a5ae2cbb69d401e3ddaa","2020-04-10T20:00:00Z",19,NA,27098,27098,27098,35,3,0,3065,226,3291
"2725",20200410,"NV",2584,20165,NA,282,NA,NA,NA,NA,NA,NA,"A","4/10/2020 10:30","e0e2ec8349d1d1e669e1be9f2e20c07f25e50df5","2020-04-10T20:00:00Z",86,NA,22749,22749,22749,32,6,0,850,128,978
"2726",20200410,"NY",170512,247373,NA,18569,38818,4908,NA,NA,NA,20249,"A","4/10/2020 00:00","09162924c4b839ad6fbd55eb290671d94941e034","2020-04-10T20:00:00Z",7844,38818,417885,417885,417885,36,777,2242,15761,10575,26336
"2727",20200410,"OH",5878,52695,NA,NA,1755,NA,548,NA,NA,NA,"B","4/10/2020 14:00","e07afe96fb2c257159d6c59bc6717a645cf9764f","2020-04-10T20:00:00Z",231,1755,58573,58573,58573,39,18,143,2222,366,2588
"2728",20200410,"OK",1794,20370,NA,186,428,122,NA,NA,NA,790,"B","4/10/2020 08:00","a43d3c2cc06e8c7d040180f80b50526f77da0ad1","2020-04-10T20:00:00Z",88,428,22164,22164,22164,40,8,13,1775,110,1885
"2729",20200410,"OR",1321,24306,NA,146,326,66,NA,54,NA,NA,"A","4/9/2020 11:00","a938afe1f6be0b401565936b64273f3a609fa76e","2020-04-10T20:00:00Z",44,326,25627,25627,25627,41,0,0,0,0,0
"2730",20200410,"PA",19979,93040,NA,2072,NA,NA,NA,611,NA,NA,"A","4/10/2020 12:00","4946e0f62f1079582fb46d0cc987d15c90766b81","2020-04-10T20:00:00Z",416,NA,113019,113019,113019,42,78,0,5666,1751,7417
"2731",20200410,"PR",725,5121,1392,NA,NA,NA,NA,NA,NA,NA,"A","4/10/2020 06:00","2557c9bfdb56054246b15dfacf958220b6f3af2e","2020-04-10T20:00:00Z",39,NA,7238,5846,5846,72,6,0,418,42,460
"2732",20200410,"RI",2015,12281,NA,169,NA,45,NA,26,NA,35,"B","4/10/2020 00:00","9cee13637f94815b2a07a563ee5c13ba9ce49b10","2020-04-10T20:00:00Z",49,NA,14296,14296,14296,44,6,0,1599,288,1887
"2733",20200410,"SC",3065,25118,NA,NA,496,NA,NA,NA,NA,NA,"B","4/10/2020 15:49","92ddf60239129a4a18a084ff1329dbcc201d4062","2020-04-10T20:00:00Z",72,496,28183,28183,28183,45,5,255,543,273,816
"2734",20200410,"SD",536,7111,NA,NA,29,NA,NA,NA,NA,177,"A","4/9/2020 18:00","7e6bc7834074d96d85843c575f3789f502cdd350","2020-04-10T20:00:00Z",6,29,7647,7647,7647,46,0,2,411,89,500
"2735",20200410,"TN",4862,57937,NA,NA,536,NA,NA,NA,NA,1145,"A","4/10/2020 15:00","ccb554a6ac89dc05c2f8ec0b7da3f3d0500bf168","2020-04-10T20:00:00Z",98,536,62799,62799,62799,47,4,31,2722,228,2950
"2736",20200410,"TX",11671,104047,NA,1532,NA,NA,NA,NA,NA,1366,"A","4/10/2020 13:00","fd65ec707cff94972adc4e59c019d25a7ef5767b","2020-04-10T20:00:00Z",226,NA,115718,115718,115718,48,27,0,8143,1441,9584
"2737",20200410,"UT",2102,38660,NA,NA,183,NA,NA,NA,NA,NA,"A","4/10/2020 15:00","99db3faad6b4be6bdd94180ce603e8c429a1f481","2020-04-10T20:00:00Z",17,183,40762,40762,40762,49,4,15,2263,126,2389
"2738",20200410,"VA",4509,30950,521,1238,772,457,NA,287,NA,NA,"A","4/10/2020 09:00","4e91d26784ed1642d7d62e5f2adb74c6301d2e41","2020-04-10T20:00:00Z",121,772,35980,35459,35459,51,12,87,1966,467,2433
"2739",20200410,"VI",50,273,45,3,NA,NA,NA,NA,NA,43,"","4/9/2020 21:30","8fa139e8fa06876661ca11147b2780bb4623f26f","2020-04-10T20:00:00Z",1,NA,368,323,323,78,0,0,22,4,26
"2740",20200410,"VT",713,7502,NA,32,NA,NA,NA,NA,NA,15,"A","4/10/2020 00:00","315a7f977196e27416573b50ffc8b95f04e2e92b","2020-04-10T20:00:00Z",24,NA,8215,8215,8215,50,1,0,284,33,317
"2741",20200410,"WA",10350,117099,NA,642,NA,191,NA,NA,NA,NA,"C","4/10/2020 00:00","f3d790c977cd1688e1a0e07f5685a4a71c78eeb7","2020-04-10T20:00:00Z",476,NA,127449,127449,127449,53,17,0,3935,301,4236
"2742",20200410,"WI",3068,33225,NA,NA,904,190,247,NA,NA,NA,"A","4/10/2020 16:00","741f36f3d6ddb2c6da14823cd339ea848c8966ba","2020-04-10T20:00:00Z",128,904,36293,36293,36293,55,17,61,1801,183,1984
"2743",20200410,"WV",554,14001,NA,85,NA,20,NA,22,NA,63,"B","4/10/2020 10:00","b8b6ed8b5f6b09e1919936a573e9c0d73be8315d","2020-04-10T20:00:00Z",5,NA,14555,14555,14555,54,0,0,661,31,692
"2744",20200410,"WY",253,4736,NA,NA,37,NA,NA,NA,NA,105,"A","4/9/2020 18:00","7691314a3ef2b38726579d178cd9ffbac113b644","2020-04-10T20:00:00Z",0,37,4989,4989,4989,56,0,3,816,23,839
"2745",20200409,"AK",235,6988,NA,NA,27,NA,NA,NA,NA,49,"A","4/9/2020 16:00","a478c639e3438f3d28f09fe708285254623a4e7c","2020-04-09T20:00:00Z",7,27,7223,7223,7223,2,0,0,146,9,155
"2746",20200409,"AL",2769,18058,NA,NA,333,NA,NA,NA,NA,NA,"B","4/9/2020 00:00","5638f08cce65aa57ed5b63bf18b6150700ba1b88","2020-04-09T20:00:00Z",74,333,20827,20827,20827,1,8,19,1305,400,1705
"2747",20200409,"AR",1119,13832,NA,73,130,NA,43,31,39,288,"A","4/9/2020 14:35","6f80ea37a16c78bd868f7efabe39df79dab42038","2020-04-09T20:00:00Z",21,130,14951,14951,14951,5,3,0,302,119,421
"2748",20200409,"AS",0,3,2,NA,NA,NA,NA,NA,NA,NA,"","4/6/2020 16:00","36bc94e616972c26ef29e635c6c06532edfe013e","2020-04-09T20:00:00Z",0,NA,5,3,3,60,0,0,0,0,0
"2749",20200409,"AZ",3018,34160,NA,NA,NA,NA,NA,NA,NA,NA,"B","4/9/2020 00:00","570690c466f6e5eb5c6c122f848f619cd8f3c481","2020-04-09T20:00:00Z",89,NA,37178,37178,37178,4,9,0,2322,292,2614
"2750",20200409,"CA",18309,145191,14100,2825,NA,1132,NA,NA,NA,NA,"B","4/8/2020 19:00","2477e17e6e5a31c8346bc6c5d8f91f9a06a742cf","2020-04-09T20:00:00Z",492,NA,177600,163500,163500,6,50,0,17884,1352,19236
"2751",20200409,"CO",5655,23544,NA,848,1162,NA,NA,NA,NA,NA,"A","4/7/2020 00:00","94a59efd23ace1f326ec51ab5dcb32a166c00116","2020-04-09T20:00:00Z",193,1162,29199,29199,29199,8,14,83,879,226,1105
"2752",20200409,"CT",9784,23718,NA,1464,NA,NA,NA,NA,NA,NA,"A","4/9/2020 16:00","6cf25282e1244620197d5c446ad245c30d608be7","2020-04-09T20:00:00Z",380,NA,33502,33502,33502,9,103,0,2463,2003,4466
"2753",20200409,"DC",1523,7201,NA,NA,NA,NA,NA,NA,NA,393,"A","4/8/2020 00:00","7d0f7f7d7c40164ce8e7fb5df206b6ddc9f61b7a","2020-04-09T20:00:00Z",32,NA,8724,8724,8724,11,5,0,358,83,441
"2754",20200409,"DE",1207,8683,NA,201,NA,NA,NA,NA,NA,173,"A","4/9/2020 17:00","86734fd40e91e12cb60c6340c557ed784b3bde2a","2020-04-09T20:00:00Z",23,NA,9890,9890,9890,10,7,0,1055,279,1334
"2755",20200409,"FL",16364,136185,1395,NA,2268,NA,NA,NA,NA,NA,"A","4/9/2020 10:00","2b4d237641a293775733028babbea4e119378018","2020-04-09T20:00:00Z",354,2268,153944,152549,152549,12,45,206,8506,909,9415
"2756",20200409,"GA",10566,30519,NA,NA,2159,NA,NA,NA,NA,NA,"A","4/9/2020 11:54","4a6e0b70e2e2e1c470bdb80e295cb92fb4ab608c","2020-04-09T20:00:00Z",379,2159,41085,41085,41085,13,17,166,1633,665,2298
"2757",20200409,"GU",128,593,NA,14,NA,2,NA,2,NA,33,"","4/9/2020 08:00","87076c522b500977a9a961c78065395fac4f4c39","2020-04-09T20:00:00Z",4,NA,721,721,721,66,0,0,31,3,34
"2758",20200409,"HI",435,15316,NA,NA,42,NA,6,NA,NA,113,"A","4/8/2020 18:00","9a2af34cd2d5d2e68f5e8707bfbb026f6967bdf9","2020-04-09T20:00:00Z",5,42,15751,15751,15751,15,0,0,577,25,602
"2759",20200409,"IA",1270,13703,NA,122,NA,NA,NA,NA,NA,476,"A","4/9/2020 00:00","65353a292d2bf67ef1225687a24fa99167b97866","2020-04-09T20:00:00Z",29,NA,14973,14973,14973,19,2,0,882,125,1007
"2760",20200409,"ID",1232,11299,NA,NA,113,NA,29,NA,NA,NA,"A","4/8/2020 19:00","ed494dbdac59879d1e96f9c77a88342d7776b557","2020-04-09T20:00:00Z",18,113,12531,12531,12531,16,3,20,611,22,633
"2761",20200409,"IL",16422,64435,NA,3680,NA,1166,NA,821,NA,NA,"A","4/9/2020 00:00","20e9c24658a773bd8c3379a297f72bee27f2f4c6","2020-04-09T20:00:00Z",528,NA,80857,80857,80857,17,66,0,4447,1344,5791
"2762",20200409,"IN",6351,25782,NA,NA,NA,924,NA,507,NA,NA,"B","4/8/2020 23:59","a2dd454cbebb1333fbae0cd88dde58dd232a7ddb","2020-04-09T20:00:00Z",245,NA,32133,32133,32133,18,42,0,856,408,1264
"2763",20200409,"KS",1106,9669,NA,NA,263,NA,NA,NA,NA,NA,"B","4/9/2020 12:00","a3dda5e40d2f83081d09d43e57401f3c494b7ebd","2020-04-09T20:00:00Z",42,263,10775,10775,10775,20,4,40,532,60,592
"2764",20200409,"KY",1346,20455,NA,NA,NA,NA,NA,NA,NA,NA,"A","4/8/2020 17:00","94102ebf5a9e7e3ac13a38595e4d8cf39d7019ff","2020-04-09T20:00:00Z",73,NA,21801,21801,21801,21,8,0,0,197,197
"2765",20200409,"LA",18283,68636,NA,2014,NA,NA,NA,473,NA,NA,"A","4/9/2020 13:00","7df1bcab9684688806eb81c3c0272f06b6c29374","2020-04-09T20:00:00Z",702,NA,86919,86919,86919,22,50,0,4260,1253,5513
"2766",20200409,"MA",18843,76146,NA,2302,2302,NA,NA,NA,NA,NA,"B","4/9/2020 12:30","c3707e97b1200655e13e6ee7f49c643351082ddf","2020-04-09T20:00:00Z",725,2302,94989,94989,94989,25,110,183,5297,2151,7448
"2767",20200409,"MD",6185,35344,NA,NA,1348,NA,NA,NA,NA,376,"A","4/9/2020 10:00","2150d352956ca2a4fa67a4cf5ac1ce3be5d29d19","2020-04-09T20:00:00Z",138,1348,41529,41529,41529,24,14,138,2411,656,3067
"2768",20200409,"ME",560,6088,NA,NA,105,NA,NA,NA,NA,202,"A","4/9/2020 11:00","11c2db8e6663828e4197d7bc5829e9527e9418da","2020-04-09T20:00:00Z",16,105,6648,6648,6648,23,2,4,0,23,23
"2769",20200409,"MI",21504,45550,NA,3826,NA,1628,NA,1434,NA,56,"B","4/9/2020 11:00","6b3895dd6d55becf9979252146fd4fe4113d0649","2020-04-09T20:00:00Z",1076,NA,67054,67054,67054,26,117,0,0,915,915
"2770",20200409,"MN",1242,31052,NA,145,293,63,119,NA,NA,625,"A","4/9/2020 12:00","08468afa4526857da9483f83b8b0ba03c5259502","2020-04-09T20:00:00Z",50,293,32294,32294,32294,27,11,22,1453,88,1541
"2771",20200409,"MO",3539,34955,NA,568,NA,NA,NA,NA,NA,NA,"A","4/9/2020 15:00","dd1cf5eddd633dbe8f588908f7f4ab50b887f4a0","2020-04-09T20:00:00Z",77,NA,38494,38494,38494,29,19,0,4172,212,4384
"2772",20200409,"MP",11,27,9,NA,NA,NA,NA,NA,NA,NA,"","4/8/2020 00:00","f7ac648f01f2c91e38d3876e6fb05f67f2f72807","2020-04-09T20:00:00Z",2,NA,47,38,38,69,0,0,0,0,0
"2773",20200409,"MS",2260,18632,NA,NA,441,NA,NA,NA,NA,NA,"A","4/8/2020 00:00","5c0f4eeef13d6eda7b49558e78e49124c950c8ad","2020-04-09T20:00:00Z",76,441,20892,20892,20892,28,9,31,0,257,257
"2774",20200409,"MT",354,7506,NA,13,36,NA,NA,NA,NA,157,"A","4/9/2020 13:33","661e44b2b976907c3afe787400ae4881976c5a59","2020-04-09T20:00:00Z",6,36,7860,7860,7860,30,0,5,440,22,462
"2775",20200409,"NC",3651,44158,NA,398,NA,NA,NA,NA,NA,NA,"A","4/9/2020 11:00","77ea783344d6389abfc2843090bab59abd7e5d30","2020-04-09T20:00:00Z",65,NA,47809,47809,47809,37,12,0,4597,225,4822
"2776",20200409,"ND",269,8721,NA,14,34,NA,NA,NA,NA,101,"B","4/9/2020 13:00","d273aea75571cb25f2b48767af2b900879f06ca6","2020-04-09T20:00:00Z",5,34,8990,8990,8990,38,1,0,420,18,438
"2777",20200409,"NE",567,8116,NA,NA,NA,NA,NA,NA,NA,NA,"A","4/9/2020 13:36","8295e02ec055c0263f51a76dded6304ae1483af7","2020-04-09T20:00:00Z",14,NA,8683,8683,8683,31,2,0,674,48,722
"2778",20200409,"NH",788,8763,143,NA,118,NA,NA,NA,NA,227,"B","4/8/2020 09:00","48d1b7fc1e03fb4b7c92ee19cee43413421251a3","2020-04-09T20:00:00Z",18,118,9694,9551,9551,33,0,0,374,0,374
"2779",20200409,"NJ",51027,56165,NA,7363,NA,1523,NA,1551,NA,NA,"A","4/9/2020 08:00","854e96339ec4ecbc6865edf06f1bc7317313062a","2020-04-09T20:00:00Z",1700,NA,107192,107192,107192,34,196,0,3186,3590,6776
"2780",20200409,"NM",865,22942,NA,59,NA,NA,NA,18,NA,201,"A","4/8/2020 00:00","e8d21e222cbb459d754a6d6df9fab6d95f097eba","2020-04-09T20:00:00Z",16,NA,23807,23807,23807,35,3,0,1491,71,1562
"2781",20200409,"NV",2456,19315,NA,282,NA,NA,NA,NA,NA,NA,"A","4/9/2020 09:30","85cf92368b6edb22ca180eb8ca84b1fcf82684bb","2020-04-09T20:00:00Z",80,NA,21771,21771,21771,32,9,0,1067,138,1205
"2782",20200409,"NY",159937,231612,NA,18279,36576,4925,NA,NA,NA,18297,"A","4/9/2020 00:00","afff59b2d7d4d0cc05fd29425776b6cbaa293c90","2020-04-09T20:00:00Z",7067,36576,391549,391549,391549,36,799,2144,15775,10621,26396
"2783",20200409,"OH",5512,50473,NA,NA,1612,NA,497,NA,NA,NA,"B","4/9/2020 14:00","7cd46d18eb931e871133d25a3f84976a599a10e6","2020-04-09T20:00:00Z",213,1612,55985,55985,55985,39,20,117,2280,364,2644
"2784",20200409,"OK",1684,18595,NA,188,415,120,NA,NA,NA,686,"B","4/9/2020 08:00","a975a9d002fb9a13bbfd4703ac9dad80dc45210a","2020-04-09T20:00:00Z",80,415,20279,20279,20279,40,1,25,6774,160,6934
"2785",20200409,"OR",1321,24306,NA,146,326,66,NA,54,NA,NA,"A","4/9/2020 11:00","c15d0a74b5733827dfc61300bfe57db91e441b9d","2020-04-09T20:00:00Z",44,326,25627,25627,25627,41,11,2,981,82,1063
"2786",20200409,"PA",18228,87374,NA,2051,NA,NA,NA,592,NA,NA,"A","4/9/2020 12:00","7394d73f97e52de6f5b0c06330b24aa71edc6a59","2020-04-09T20:00:00Z",338,NA,105602,105602,105602,42,29,0,5075,1989,7064
"2787",20200409,"PR",683,4703,1304,NA,NA,NA,NA,NA,NA,NA,"A","4/9/2020 07:00","9ce9b4da229e0415d2eba68578b4c399567249f0","2020-04-09T20:00:00Z",33,NA,6690,5386,5386,72,9,0,437,63,500
"2788",20200409,"RI",1727,10682,NA,160,NA,45,NA,26,NA,35,"B","4/9/2020 00:00","93ac15758844936eb0cd78a11cd0ce996b2dc524","2020-04-09T20:00:00Z",43,NA,12409,12409,12409,44,8,0,0,277,277
"2789",20200409,"SC",2792,24575,NA,NA,241,NA,NA,NA,NA,NA,"B","4/9/2020 16:08","5d7eb6363452e4b44c9792cc7865bd708b883ca4","2020-04-09T20:00:00Z",67,241,27367,27367,27367,45,4,0,2493,240,2733
"2790",20200409,"SD",447,6700,NA,NA,27,NA,NA,NA,NA,161,"A","4/8/2020 18:00","33e176925f91fefb28c890f2c3cd53ee5e7877ec","2020-04-09T20:00:00Z",6,27,7147,7147,7147,46,0,1,345,54,399
"2791",20200409,"TN",4634,55215,NA,NA,505,NA,NA,NA,NA,921,"A","4/9/2020 15:00","3b0c6a934a3b4d8486e5604941be99fda6883858","2020-04-09T20:00:00Z",94,505,59849,59849,59849,47,15,56,2959,272,3231
"2792",20200409,"TX",10230,95904,NA,1439,NA,NA,NA,NA,NA,1101,"A","4/9/2020 13:15","89970898529964095da7c8243a60c6e7a20f4f13","2020-04-09T20:00:00Z",199,NA,106134,106134,106134,48,22,0,8999,877,9876
"2793",20200409,"UT",1976,36397,NA,NA,168,NA,NA,NA,NA,NA,"A","4/9/2020 15:00","917f6aa621edea0eb3138a37e72ef82c2490e9c4","2020-04-09T20:00:00Z",13,168,38373,38373,38373,49,0,10,2127,130,2257
"2794",20200409,"VA",4042,28984,627,669,685,469,NA,285,NA,NA,"A","4/9/2020 00:00","df12a147f17ada1308c36ac022afdf5213821154","2020-04-09T20:00:00Z",109,685,33653,33026,33026,51,34,70,1984,397,2381
"2795",20200409,"VI",46,251,42,NA,NA,NA,NA,NA,NA,39,"","4/8/2020 22:00","32754ad39d1e0c7d6c6cfd4d26db914ce67b1478","2020-04-09T20:00:00Z",1,NA,339,297,297,78,0,0,9,1,10
"2796",20200409,"VT",680,7218,NA,33,NA,NA,NA,NA,NA,15,"A","4/9/2020 00:00","bbb816a31dbc25a940be89a078d6f82ef5bfcf5f","2020-04-09T20:00:00Z",23,NA,7898,7898,7898,50,0,0,217,49,266
"2797",20200409,"WA",10049,113164,NA,650,NA,191,NA,NA,NA,NA,"A","4/9/2020 00:00","806c463f0f023b996bf6fed21d733a5e59220c20","2020-04-09T20:00:00Z",459,NA,123213,123213,123213,53,16,0,3832,362,4194
"2798",20200409,"WI",2885,31424,NA,NA,843,NA,230,NA,NA,NA,"A","4/9/2020 16:00","74f82985fa18524f49994f9f1088d114275dc6aa","2020-04-09T20:00:00Z",111,843,34309,34309,34309,55,12,53,1309,129,1438
"2799",20200409,"WV",523,13340,NA,NA,NA,NA,NA,NA,NA,NA,"B","4/9/2020 17:00","b4aa5d2cb3745f6414b92c24d33555288cc6b48d","2020-04-09T20:00:00Z",5,NA,13863,13863,13863,54,1,0,1257,61,1318
"2800",20200409,"WY",230,3920,NA,NA,34,NA,NA,NA,NA,94,"A","4/8/2020 16:59","ca2ca6527d9f921c32b252dfebb329220d411c2c","2020-04-09T20:00:00Z",0,34,4150,4150,4150,56,0,1,77,9,86
"2801",20200408,"AK",226,6842,NA,NA,27,NA,NA,NA,NA,32,"A","4/8/2020 15:00","40fd3e7913276eaea19928e5d8732dfd79711f4a","2020-04-08T20:00:00Z",7,27,7068,7068,7068,2,1,4,142,13,155
"2802",20200408,"AL",2369,16753,NA,NA,314,NA,NA,NA,NA,NA,"B","4/8/2020 00:00","8dd02ebdbd8c512631a6b96fd97f58858b154141","2020-04-08T20:00:00Z",66,314,19122,19122,19122,1,10,43,3956,250,4206
"2803",20200408,"AR",1000,13530,NA,76,130,NA,43,30,39,208,"A","4/8/2020 14:35","5efb513d52bdcc1770239d45f8ddcd0a26d3fc4e","2020-04-08T20:00:00Z",18,130,14530,14530,14530,5,2,-18,838,54,892
"2804",20200408,"AS",0,3,2,NA,NA,NA,NA,NA,NA,NA,"","4/6/2020 16:00","6eee3816e4649284f34668acdb996bba204f8468","2020-04-08T20:00:00Z",0,NA,5,3,3,60,0,0,0,0,0
"2805",20200408,"AZ",2726,31838,NA,NA,NA,NA,NA,NA,NA,NA,"B","4/8/2020 00:00","231f7ca5a70d506dcd92a4a864bc2ebb013b616b","2020-04-08T20:00:00Z",80,NA,34564,34564,34564,4,7,0,1038,151,1189
"2806",20200408,"CA",16957,127307,14600,2714,NA,1154,NA,NA,NA,NA,"B","4/7/2020 18:00","9292e9045ac33dbf84a41da49e64f141148b7f32","2020-04-08T20:00:00Z",442,NA,158864,144264,144264,6,68,0,11943,1092,13035
"2807",20200408,"CO",5429,22665,NA,833,1079,NA,NA,NA,NA,NA,"A","4/6/2020 00:00","a6c7fec86af487baae0a503f2ee84e863b3b0a9c","2020-04-08T20:00:00Z",179,1079,28094,28094,28094,8,29,85,962,257,1219
"2808",20200408,"CT",7781,21255,NA,1308,NA,NA,NA,NA,NA,NA,"A","4/7/2020 22:00","007ae9738781cdeb80938f42f2ba43d4d15b9203","2020-04-08T20:00:00Z",277,NA,29036,29036,29036,9,0,0,0,0,0
"2809",20200408,"DC",1440,6843,NA,NA,NA,NA,NA,NA,NA,361,"A","4/7/2020 00:00","b9354c150dac12c1c448d2f49b903f2cfd757028","2020-04-08T20:00:00Z",27,NA,8283,8283,8283,11,5,0,231,229,460
"2810",20200408,"DE",928,7628,NA,147,NA,NA,NA,NA,NA,144,"A","4/7/2020 16:30","e1c821e584a80f3545d2f378d79bb55f1f6352cd","2020-04-08T20:00:00Z",16,NA,8556,8556,8556,10,0,0,0,0,0
"2811",20200408,"FL",15455,127679,1324,NA,2062,NA,NA,NA,NA,NA,"A","4/8/2020 14:00","f77a46765d58b6bb6a7d64a224feb28da779a2fa","2020-04-08T20:00:00Z",309,2062,144458,143134,143134,12,13,63,4264,708,4972
"2812",20200408,"GA",9901,28886,NA,NA,1993,NA,NA,NA,NA,NA,"A","4/8/2020 12:29","2953eeecaf95823f073084f60e4696aee94783ee","2020-04-08T20:00:00Z",362,1993,38787,38787,38787,13,33,219,3991,1083,5074
"2813",20200408,"GU",125,562,NA,21,NA,2,NA,2,NA,31,"","4/8/2020 07:30","64ef5a20ea5799651aea134f7e66bb0094dd16b9","2020-04-08T20:00:00Z",4,NA,687,687,687,66,0,0,33,4,37
"2814",20200408,"HI",410,14739,NA,NA,42,NA,6,NA,NA,113,"A","4/7/2020 18:00","73daa76a041cc37889c89dc896bcec3ed201b0a2","2020-04-08T20:00:00Z",5,42,15149,15149,15149,15,0,16,1584,23,1607
"2815",20200408,"IA",1145,12821,NA,122,193,NA,NA,NA,NA,431,"A","4/8/2020 13:00","c6930595be9bafb616206f207b8c528faa24d400","2020-04-08T20:00:00Z",27,193,13966,13966,13966,19,1,0,1151,97,1248
"2816",20200408,"ID",1210,10688,NA,NA,93,NA,24,NA,NA,NA,"A","4/7/2020 19:00","e71eb7dabb32c58c05a5471cb794ad8b2cb7152a","2020-04-08T20:00:00Z",15,93,11898,11898,11898,16,2,10,612,40,652
"2817",20200408,"IL",15078,59988,NA,3680,NA,1166,NA,821,NA,NA,"A","4/8/2020 00:00","392c377290c9304cbbae91cb0d719d6cb8b7b810","2020-04-08T20:00:00Z",462,NA,75066,75066,75066,17,82,0,4805,1529,6334
"2818",20200408,"IN",5943,24926,NA,NA,NA,924,NA,507,NA,NA,"B","4/8/2020 02:45","86a7bd6299f4d7ec6a95722a614d175eacbd4a15","2020-04-08T20:00:00Z",203,NA,30869,30869,30869,18,30,0,1669,436,2105
"2819",20200408,"KS",1046,9137,NA,NA,223,NA,NA,NA,NA,NA,"B","4/7/2020 12:00","f96d32a96b67cbedbea5f4e98cde88b5b024fb3a","2020-04-08T20:00:00Z",38,223,10183,10183,10183,20,11,0,523,146,669
"2820",20200408,"KY",1149,20455,NA,NA,NA,NA,NA,NA,NA,NA,"A","4/7/2020 17:00","26f2065a5cd8e1e67d1aa34c3d5a79f7eb08fa40","2020-04-08T20:00:00Z",65,NA,21604,21604,21604,21,6,0,1508,141,1649
"2821",20200408,"LA",17030,64376,NA,1983,NA,NA,NA,490,NA,NA,"A","4/8/2020 13:00","7fbcc016c35945cc558b68d151d41a2e30e72b80","2020-04-08T20:00:00Z",652,NA,81406,81406,81406,22,70,0,6005,746,6751
"2822",20200408,"MA",16692,70849,NA,2119,2119,NA,NA,NA,NA,NA,"B","4/8/2020 12:30","69ef7f3af46d28616da685ec7a54f9d6d1c3ef47","2020-04-08T20:00:00Z",615,2119,87541,87541,87541,25,100,288,4579,1588,6167
"2823",20200408,"MD",5529,32933,NA,NA,1210,NA,NA,NA,NA,365,"A","4/8/2020 10:00","6446fac46405ef87cbde555e72dca50ceed52b49","2020-04-08T20:00:00Z",124,1210,38462,38462,38462,24,21,104,5677,1158,6835
"2824",20200408,"ME",537,6088,NA,NA,101,NA,NA,NA,NA,187,"A","4/8/2020 11:00","cf407af1f6eb02937e5519280933a02548938679","2020-04-08T20:00:00Z",14,101,6625,6625,6625,23,2,2,0,18,18
"2825",20200408,"MI",20589,45550,NA,NA,NA,NA,NA,NA,NA,56,"B","4/8/2020 11:00","db57d360de8b7d44f6e310cfc8bd8de3fe224cee","2020-04-08T20:00:00Z",959,NA,66139,66139,66139,26,114,0,0,766,766
"2826",20200408,"MN",1154,29599,NA,135,271,64,105,NA,NA,593,"A","4/8/2020 17:00","f551e336f1a39ae4fb7ca3064794743b5d0e4616","2020-04-08T20:00:00Z",39,271,30753,30753,30753,27,5,29,1408,85,1493
"2827",20200408,"MO",3327,30783,NA,519,NA,NA,NA,NA,NA,NA,"A","4/8/2020 15:00","3de03b31d6c7655b2e4d633500661f518cea3dc7","2020-04-08T20:00:00Z",58,NA,34110,34110,34110,29,5,0,1851,290,2141
"2828",20200408,"MP",11,27,9,NA,NA,NA,NA,NA,NA,NA,"","4/8/2020 00:00","f03ea0ed7517200fdcbeb3e530f5ccae0ef20086","2020-04-08T20:00:00Z",2,NA,47,38,38,69,0,0,12,3,15
"2829",20200408,"MS",2003,18632,NA,NA,410,NA,NA,NA,NA,NA,"A","4/7/2020 19:00","425a94011e188e1099e81ad09680f497f6c3e7ef","2020-04-08T20:00:00Z",67,410,20635,20635,20635,28,8,33,0,88,88
"2830",20200408,"MT",332,7066,NA,NA,31,NA,NA,NA,NA,135,"A","4/8/2020 13:45","f3bbbf0831d3ed7999d4a39a2f646990a8ccad92","2020-04-08T20:00:00Z",6,31,7398,7398,7398,30,0,3,400,13,413
"2831",20200408,"NC",3426,39561,NA,386,NA,NA,NA,NA,NA,NA,"A","4/8/2020 11:00","97ac0d264bd841b853d84e2f6b8d3e54d84639fe","2020-04-08T20:00:00Z",53,NA,42987,42987,42987,37,7,0,1700,205,1905
"2832",20200408,"ND",251,8301,NA,16,34,NA,NA,NA,NA,98,"B","4/8/2020 13:54","dc0289da8b9a466f66391bce7f30cdc93db3b5c6","2020-04-08T20:00:00Z",4,34,8552,8552,8552,38,0,1,835,14,849
"2833",20200408,"NE",519,7442,NA,NA,NA,NA,NA,NA,NA,NA,"A","4/8/2020 13:45","70587f033bb60a13f8355defa9c58aef5445883a","2020-04-08T20:00:00Z",12,NA,7961,7961,7961,31,2,0,631,72,703
"2834",20200408,"NH",788,8389,89,NA,118,NA,NA,NA,NA,211,"B","4/8/2020 15:11","09d979c935204b3b36e66ef0ebf545582a52d0ef","2020-04-08T20:00:00Z",18,118,9266,9177,9177,33,9,15,370,73,443
"2835",20200408,"NJ",47437,52979,NA,7026,NA,1617,NA,1576,NA,NA,"A","4/8/2020 14:08","746da598aad50e79b61504afd3cfb34442686923","2020-04-08T20:00:00Z",1504,NA,100416,100416,100416,34,272,0,2421,3021,5442
"2836",20200408,"NM",794,21451,NA,51,NA,NA,NA,18,NA,171,"A","4/7/2020 00:00","504080749d430ed62857a9342d5e68d71b6792b8","2020-04-08T20:00:00Z",13,NA,22245,22245,22245,35,1,0,312,108,420
"2837",20200408,"NV",2318,18248,NA,282,NA,NA,NA,NA,NA,NA,"A","4/8/2020 15:00","c3293543c0ffbe7b573d0d36bd6075f137264c61","2020-04-08T20:00:00Z",71,NA,20566,20566,20566,32,13,0,1696,231,1927
"2838",20200408,"NY",149316,215837,NA,18079,34432,4593,NA,NA,NA,16353,"A","4/7/2020 00:00","6f03c2a4ffb2a7a0801a214d9799cbf51d2e85f1","2020-04-08T20:00:00Z",6268,34432,365153,365153,365153,36,779,2349,14642,10453,25095
"2839",20200408,"OH",5148,48193,NA,NA,1495,NA,472,NA,NA,NA,"B","4/8/2020 14:00","59d1f173d6170fdf9810191ac0baf947688f04a1","2020-04-08T20:00:00Z",193,1495,53341,53341,53341,39,26,141,2137,366,2503
"2840",20200408,"OK",1524,11821,NA,188,390,120,NA,NA,NA,686,"B","4/8/2020 08:00","809aaedeaaf56eda76a105fa2812d574b6e7dbf5","2020-04-08T20:00:00Z",79,390,13345,13345,13345,40,12,14,0,52,52
"2841",20200408,"OR",1239,23325,NA,156,324,61,NA,58,69,NA,"A","4/7/2020 11:00","da4eafb81f5f1b9431a8db2eae6a5f96776226e2","2020-04-08T20:00:00Z",33,324,24564,24564,24564,41,0,0,1499,58,1557
"2842",20200408,"PA",16239,82299,NA,1898,NA,NA,NA,603,NA,NA,"A","4/8/2020 14:45","cb3c7c5261ca1a29bb38efe92b51eda1438b9260","2020-04-08T20:00:00Z",309,NA,98538,98538,98538,42,69,0,5580,1680,7260
"2843",20200408,"PR",620,4266,1160,NA,NA,NA,NA,NA,NA,NA,"A","4/8/2020 09:00","db8e236d3c4756b756546f0917e3c9cd9a215b64","2020-04-08T20:00:00Z",24,NA,6046,4886,4886,72,1,0,300,47,347
"2844",20200408,"RI",1450,10682,NA,143,NA,45,NA,26,NA,35,"B","4/8/2020 00:00","8cf26970c0f44588c823be78ea2805d27b231e28","2020-04-08T20:00:00Z",35,NA,12132,12132,12132,44,5,0,1605,220,1825
"2845",20200408,"SC",2552,22082,NA,NA,241,NA,NA,NA,NA,NA,"B","4/8/2020 15:30","7309e5d10fee8a3625a11b8c5625d896ea65cf98","2020-04-08T20:00:00Z",63,241,24634,24634,24634,45,12,0,819,135,954
"2846",20200408,"SD",393,6355,0,NA,26,NA,NA,NA,NA,146,"A","4/8/2020 12:30","48cca70f692962931bd370a8e6827ed614a4f25b","2020-04-08T20:00:00Z",6,26,6748,6748,6748,46,0,3,407,73,480
"2847",20200408,"TN",4362,52256,NA,NA,449,NA,NA,NA,NA,592,"A","4/8/2020 15:00","26a231b21a0d8b0ee915536cf0eee1eab0eeabfb","2020-04-08T20:00:00Z",79,449,56618,56618,56618,47,7,41,3520,224,3744
"2848",20200408,"TX",9353,86905,NA,1491,NA,NA,NA,NA,NA,38,"A","4/8/2020 14:21","aad63fb55e4795e27f30e717ac588682ff62d8bb","2020-04-08T20:00:00Z",177,NA,96258,96258,96258,48,23,0,6518,1091,7609
"2849",20200408,"UT",1846,34270,NA,NA,158,NA,NA,NA,NA,NA,"A","4/8/2020 15:00","b4e5ed981d99dda125928e65c72b7d441b384627","2020-04-08T20:00:00Z",13,158,36116,36116,36116,49,0,10,1361,108,1469
"2850",20200408,"VA",3645,27000,NA,NA,615,NA,145,NA,108,NA,"A","4/7/2020 17:00","22f8fac14598c880969baaf7a75ad771591725df","2020-04-08T20:00:00Z",75,615,30645,30645,30645,51,12,52,1688,312,2000
"2851",20200408,"VI",45,242,35,NA,NA,NA,NA,NA,NA,39,"","4/7/2020 19:00","ab9315ef3207f85b5b7e543e94ce8837f901672f","2020-04-08T20:00:00Z",1,NA,322,287,287,78,0,0,20,2,22
"2852",20200408,"VT",631,7001,NA,35,50,NA,NA,NA,NA,15,"A","4/8/2020 00:00","1b7fb38d6e83a33750737b28a981c4bacd59d70d","2020-04-08T20:00:00Z",23,50,7632,7632,7632,50,0,5,356,23,379
"2853",20200408,"WA",9687,109332,NA,655,NA,186,NA,NA,NA,NA,"A","4/8/2020 00:00","0253242a6935beae6fad27d8c3b201012c4450c6","2020-04-08T20:00:00Z",443,NA,119019,119019,119019,53,14,0,4389,341,4730
"2854",20200408,"WI",2756,30115,NA,NA,790,NA,218,NA,NA,NA,"A","4/8/2020 16:00","1150361426c4dbc521e533b39807d24a678c1711","2020-04-08T20:00:00Z",99,790,32871,32871,32871,55,7,45,1603,178,1781
"2855",20200408,"WV",462,12083,NA,NA,NA,NA,NA,NA,NA,NA,"B","4/8/2020 10:00","0264e0ad4c0764d1df119cdccef714e9b93e2cec","2020-04-08T20:00:00Z",4,NA,12545,12545,12545,54,0,0,436,50,486
"2856",20200408,"WY",221,3843,NA,NA,33,NA,NA,NA,NA,62,"A","4/7/2020 18:21","13e9cd8840a3108fbf19acf39b8cfa3f7781006a","2020-04-08T20:00:00Z",0,33,4064,4064,4064,56,0,0,54,5,59
"2857",20200407,"AK",213,6700,NA,NA,23,NA,NA,NA,NA,29,"A","4/7/2020 15:15","0ef9800944e34eadfb6732ef777f802afe136d8b","2020-04-07T20:00:00Z",6,23,6913,6913,6913,2,0,0,8,22,30
"2858",20200407,"AL",2119,12797,NA,NA,271,NA,NA,NA,NA,NA,"B","4/7/2020 00:00","9062153a0bf58f2f2870828d3f87a64cc7ba196b","2020-04-07T20:00:00Z",56,271,14916,14916,14916,1,6,31,0,151,151
"2859",20200407,"AR",946,12692,NA,74,148,NA,NA,26,43,142,"A","4/7/2020 14:41","da9c5dcb949b901a32db6dbb86da35d9e0734750","2020-04-07T20:00:00Z",16,148,13638,13638,13638,5,0,11,722,71,793
"2860",20200407,"AS",0,3,2,NA,NA,NA,NA,NA,NA,NA,"","4/6/2020 16:00","d0c19bab3a0ad66d5a8587a5cc2261c91d75ce4f","2020-04-07T20:00:00Z",0,NA,5,3,3,60,0,0,0,0,0
"2861",20200407,"AZ",2575,30800,NA,NA,NA,NA,NA,NA,NA,NA,"B","4/7/2020 00:00","a4099789827f1b6e913214851b48e04347c63292","2020-04-07T20:00:00Z",73,NA,33375,33375,33375,4,8,0,722,119,841
"2862",20200407,"CA",15865,115364,14100,2611,NA,1108,NA,NA,NA,NA,"B","4/7/2020 18:00","9305e5d010ccbc639c8bac68aac2119c78ce7d1c","2020-04-07T20:00:00Z",374,NA,145329,131229,131229,6,31,0,12269,1529,13798
"2863",20200407,"CO",5172,21703,NA,786,994,NA,NA,NA,NA,NA,"A","4/5/2020 00:00","3d7324f7aeceabb51b8ed8e5d393fb2dca1090b4","2020-04-07T20:00:00Z",150,994,26875,26875,26875,8,10,70,880,222,1102
"2864",20200407,"CT",7781,21255,NA,1308,NA,NA,NA,NA,NA,NA,"A","4/7/2020 04:00","655e89888811b9871c7e3ef529500a247c442456","2020-04-07T20:00:00Z",277,NA,29036,29036,29036,9,71,0,1475,875,2350
"2865",20200407,"DC",1211,6612,NA,NA,NA,NA,NA,NA,NA,318,"A","4/6/2020 00:00","e65cac5a9427990c2305479b7349207d1a54fe9d","2020-04-07T20:00:00Z",22,NA,7823,7823,7823,11,-2,0,256,114,370
"2866",20200407,"DE",928,7628,NA,147,NA,NA,NA,NA,NA,144,"A","4/7/2020 16:30","a4f29e8b852a1199dc502d4c45b26bbb1734f843","2020-04-07T20:00:00Z",16,NA,8556,8556,8556,10,2,0,1307,255,1562
"2867",20200407,"FL",14747,123415,1407,NA,1999,NA,NA,NA,NA,NA,"A","4/7/2020 16:36","cc3a8a4bfbb20601d42ab835188a8bad88d53338","2020-04-07T20:00:00Z",296,1999,139569,138162,138162,12,60,317,13465,1423,14888
"2868",20200407,"GA",8818,24895,NA,NA,1774,NA,NA,NA,NA,NA,"A","4/7/2020 11:28","57bf1ff43f9dee459124f409f1e7509748ea4820","2020-04-07T20:00:00Z",329,1774,33713,33713,33713,13,100,442,935,1504,2439
"2869",20200407,"GU",121,529,NA,21,NA,2,NA,2,NA,27,"","4/7/2020 07:00","896594fdd1dada99d5fff422de915e7be34338ae","2020-04-07T20:00:00Z",4,NA,650,650,650,66,0,0,24,8,32
"2870",20200407,"HI",387,13155,NA,NA,26,NA,6,NA,NA,89,"A","4/6/2020 18:00","480c13feb6dd3ee938f00079817d8c5fc84d8c5c","2020-04-07T20:00:00Z",5,26,13542,13542,13542,15,1,5,0,16,16
"2871",20200407,"IA",1048,11670,NA,104,193,NA,NA,NA,NA,341,"A","4/7/2020 00:00","11e2c37a7ffbe1e1603c05e9a26f500a9374ce82","2020-04-07T20:00:00Z",26,193,12718,12718,12718,19,1,14,1017,102,1119
"2872",20200407,"ID",1170,10076,NA,NA,83,NA,21,NA,NA,NA,"A","4/6/2020 19:00","270d8fbaba8da85e8fb4a8379a1fa34c943b0250","2020-04-07T20:00:00Z",13,83,11246,11246,11246,16,3,6,182,69,251
"2873",20200407,"IL",13549,55183,NA,3680,NA,1166,NA,821,NA,NA,"A","4/7/2020 00:00","5c350545113d11b495c81d024b2352240843d669","2020-04-07T20:00:00Z",380,NA,68732,68732,68732,17,73,0,4503,1287,5790
"2874",20200407,"IN",5507,23257,NA,NA,NA,924,NA,507,NA,NA,"B","4/6/2020 23:59","fc2df1ca427310fea53703a621a4d379433bfbd9","2020-04-07T20:00:00Z",173,NA,28764,28764,28764,18,34,0,2010,563,2573
"2875",20200407,"KS",900,8614,NA,NA,223,NA,NA,NA,NA,NA,"B","4/7/2020 12:00","4aedd6be5b9697ccfd2096706966841aad478d18","2020-04-07T20:00:00Z",27,223,9514,9514,9514,20,2,25,375,55,430
"2876",20200407,"KY",1008,18947,NA,NA,NA,NA,NA,NA,NA,NA,"A","4/6/2020 17:00","e8a15e2eedd890922f50cb539af467909b92d42e","2020-04-07T20:00:00Z",59,NA,19955,19955,19955,21,14,0,1135,53,1188
"2877",20200407,"LA",16284,58371,NA,1996,NA,NA,NA,519,NA,NA,"A","4/7/2020 13:00","83fb05a719bdf4e08311f0a0f9686ce512cbec5c","2020-04-07T20:00:00Z",582,NA,74655,74655,74655,22,70,0,4072,1417,5489
"2878",20200407,"MA",15104,66270,NA,1831,1831,NA,NA,NA,NA,NA,"B","4/7/2020 12:30","feaae2686b8d2ee1a310f095aa5d9f84252a957f","2020-04-07T20:00:00Z",515,1831,81374,81374,81374,25,67,164,3550,1365,4915
"2879",20200407,"MD",4371,27256,NA,NA,1106,NA,NA,NA,NA,288,"A","4/7/2020 10:00","b05b05647ae61796dc891dbf9d8e742e2b8bccbd","2020-04-07T20:00:00Z",103,1106,31627,31627,31627,24,12,47,1684,326,2010
"2880",20200407,"ME",519,6088,NA,NA,99,NA,NA,NA,NA,176,"A","4/7/2020 11:45","fad10cbd2cd4e4ddea073cdee8e26030597845e7","2020-04-07T20:00:00Z",12,99,6607,6607,6607,23,2,7,0,20,20
"2881",20200407,"MI",19823,45550,NA,NA,NA,NA,NA,NA,NA,56,"B","4/7/2020 11:00","f9a166835a12d4df4131993ce836c3f0aea9dbe6","2020-04-07T20:00:00Z",845,NA,65373,65373,65373,26,118,0,2430,973,3403
"2882",20200407,"MN",1069,28191,NA,120,242,64,100,NA,NA,515,"A","4/6/2020 17:00","f0e71d3b42957e2947097c684a7268dcec088b33","2020-04-07T20:00:00Z",34,242,29260,29260,29260,27,4,19,1049,83,1132
"2883",20200407,"MO",3037,28932,NA,508,NA,NA,NA,NA,NA,NA,"A","4/7/2020 15:00","cae0da068a529200b50c5ee9f833be1953e37733","2020-04-07T20:00:00Z",53,NA,31969,31969,31969,29,14,0,1819,315,2134
"2884",20200407,"MP",8,15,NA,NA,NA,NA,NA,NA,NA,NA,"","4/7/2020 05:39","a71407bbfc58c37a3bec279f6b2bc0927062e352","2020-04-07T20:00:00Z",2,NA,23,23,23,69,1,0,2,0,2
"2885",20200407,"MS",1915,18632,NA,NA,377,NA,NA,NA,NA,NA,"A","4/7/2020 19:00","e1f75f9741b5f11b2c4f2e525e1d3f08ce2a5dcd","2020-04-07T20:00:00Z",59,377,20547,20547,20547,28,8,-98,0,177,177
"2886",20200407,"MT",319,6666,NA,NA,28,NA,NA,NA,NA,NA,"A","4/7/2020 13:28","9c9b06492b31cb45fad457d8ddc7286439a6d4e9","2020-04-07T20:00:00Z",6,28,6985,6985,6985,30,0,4,175,20,195
"2887",20200407,"NC",3221,37861,NA,354,NA,NA,NA,NA,NA,NA,"A","4/7/2020 10:15","42731310d02235c7c24ba6e02f3c036ca5c0f4c9","2020-04-07T20:00:00Z",46,NA,41082,41082,41082,37,13,0,5,351,356
"2888",20200407,"ND",237,7466,NA,18,33,NA,NA,NA,NA,82,"B","4/7/2020 13:00","56acac8b5ffd862c62bb49e60e9d53684a766ef1","2020-04-07T20:00:00Z",4,33,7703,7703,7703,38,1,1,478,12,490
"2889",20200407,"NE",447,6811,NA,NA,NA,NA,NA,NA,NA,NA,"A","4/7/2020 14:38","d0863d756bafcd5d989ec214d579053a07042085","2020-04-07T20:00:00Z",10,NA,7258,7258,7258,31,2,0,433,38,471
"2890",20200407,"NH",715,8019,49,NA,103,NA,NA,NA,NA,151,"B","4/6/2020 09:00","b30a14bdee39fe75c65d59a4d72b8642675d7e6a","2020-04-07T20:00:00Z",9,103,8783,8734,8734,33,0,11,318,46,364
"2891",20200407,"NJ",44416,50558,NA,7017,NA,1651,NA,1540,NA,NA,"A","4/7/2020 13:00","5a69cba0094a937021527d5e6e561e38a75b4151","2020-04-07T20:00:00Z",1232,NA,94974,94974,94974,34,229,0,2616,3326,5942
"2892",20200407,"NM",686,21139,NA,48,NA,NA,NA,18,NA,133,"A","4/6/2020 00:00","4fa835cc6795be27a9c5d56316eb1217d0f22fca","2020-04-07T20:00:00Z",12,NA,21825,21825,21825,35,0,0,2627,62,2689
"2893",20200407,"NV",2087,16552,NA,282,NA,NA,NA,NA,NA,NA,"A","4/7/2020 10:00","01f34c7e91f91e15d9896a5d5d167245a5ab1b9c","2020-04-07T20:00:00Z",58,NA,18639,18639,18639,32,12,0,876,134,1010
"2894",20200407,"NY",138863,201195,NA,17493,32083,4593,NA,NA,NA,14590,"A","4/6/2020 00:00","55f26b837736acab4f58391322359e3a2f1ea173","2020-04-07T20:00:00Z",5489,32083,340058,340058,340058,36,731,1880,11073,8174,19247
"2895",20200407,"OH",4782,46056,NA,NA,1354,NA,417,NA,NA,NA,"B","4/7/2020 14:00","f246c090ef95ec326b372e8dc484d84db97cd5f5","2020-04-07T20:00:00Z",167,1354,50838,50838,50838,39,25,140,2128,332,2460
"2896",20200407,"OK",1472,11821,NA,186,376,137,NA,NA,NA,612,"B","4/7/2020 08:00","6f7207da73f80a9a0be6e333b1150c84e5b9ef5a","2020-04-07T20:00:00Z",67,376,13293,13293,13293,40,16,36,10399,145,10544
"2897",20200407,"OR",1181,21826,NA,NA,324,NA,NA,69,NA,NA,"A","4/6/2020 11:00","a2caec087f5e339e71e04eb5f5028b1730ff544c","2020-04-07T20:00:00Z",33,324,23007,23007,23007,41,6,66,1157,49,1206
"2898",20200407,"PA",14559,76719,NA,1665,NA,NA,NA,548,NA,NA,"A","4/7/2020 13:00","dbc1ace64c985abbb9552fbfd0f3d852e6397418","2020-04-07T20:00:00Z",240,NA,91278,91278,91278,42,78,0,5845,1579,7424
"2899",20200407,"PR",573,3966,968,NA,NA,NA,NA,NA,NA,NA,"A","4/7/2020 07:00","b55008d918d95c4cff386df41d422dc76d4aa6c8","2020-04-07T20:00:00Z",23,NA,5507,4539,4539,72,2,0,534,60,594
"2900",20200407,"RI",1230,9077,NA,123,NA,40,NA,26,NA,35,"B","4/7/2020 00:00","e6a2d4a53ccd98517e916139acc762ea883075be","2020-04-07T20:00:00Z",30,NA,10307,10307,10307,44,3,0,1678,148,1826
"2901",20200407,"SC",2417,21263,NA,NA,241,NA,NA,NA,NA,NA,"B","4/7/2020 16:02","e1d92747f845bc7a1a4432cb4071b2508a8beeb4","2020-04-07T20:00:00Z",51,241,23680,23680,23680,45,7,0,4336,368,4704
"2902",20200407,"SD",320,5948,2,NA,23,NA,NA,NA,NA,98,"A","4/6/2020 18:00","c88f6784d53e0811a729fbc1837565f169f62fc5","2020-04-07T20:00:00Z",6,23,6270,6268,6268,46,2,0,216,32,248
"2903",20200407,"TN",4138,48736,NA,NA,408,NA,NA,NA,NA,466,"A","4/7/2020 15:00","986566824fbe4173a2a72ca641ff6144d159c992","2020-04-07T20:00:00Z",72,408,52874,52874,52874,47,7,56,5188,336,5524
"2904",20200407,"TX",8262,80387,NA,1252,NA,NA,NA,NA,NA,38,"A","4/6/2020 21:00","ea5f7730a3c138578dc7704cf579f4b3df5638c3","2020-04-07T20:00:00Z",154,NA,88649,88649,88649,48,14,0,2306,986,3292
"2905",20200407,"UT",1738,32909,NA,NA,148,NA,NA,NA,NA,NA,"A","4/7/2020 15:00","9039c616202dfde175f6516d344165a8c5a687ac","2020-04-07T20:00:00Z",13,148,34647,34647,34647,49,0,10,1190,63,1253
"2906",20200407,"VA",3333,25312,NA,NA,563,NA,145,NA,108,NA,"A","4/6/2020 17:00","58b43454d81c592215d106bc2427637948deee8f","2020-04-07T20:00:00Z",63,563,28645,28645,28645,51,9,66,3669,455,4124
"2907",20200407,"VI",43,222,20,NA,NA,NA,NA,NA,NA,36,"","4/6/2020 21:50","6818776dba7570c4cd072b1189926dada86c7593","2020-04-07T20:00:00Z",1,NA,285,265,265,78,0,0,0,0,0
"2908",20200407,"VT",608,6645,NA,29,45,NA,NA,NA,NA,15,"A","4/7/2020 00:00","4f528a8e6e8045827b7fc1cf2b69f31a22b73844","2020-04-07T20:00:00Z",23,45,7253,7253,7253,50,0,0,484,33,517
"2909",20200407,"WA",9346,104943,NA,641,NA,190,NA,NA,NA,NA,"A","4/7/2020 00:00","29328f7ce5a11666055bda5c5dfcebbf6569ba93","2020-04-07T20:00:00Z",429,NA,114289,114289,114289,53,22,0,4740,409,5149
"2910",20200407,"WI",2578,28512,NA,NA,745,NA,200,NA,NA,NA,"A","4/7/2020 16:00","bcb48ea2671c3f4c809d8cb6152f056098dd6798","2020-04-07T20:00:00Z",92,745,31090,31090,31090,55,15,77,1938,138,2076
"2911",20200407,"WV",412,11647,NA,NA,NA,NA,NA,NA,NA,NA,"B","4/7/2020 10:00","e388498ee3a9b4b979231d85b5ef3e99ba732588","2020-04-07T20:00:00Z",4,NA,12059,12059,12059,54,0,0,2052,67,2119
"2912",20200407,"WY",216,3789,NA,NA,33,NA,NA,NA,NA,62,"A","4/7/2020 10:57","ea6122fd474756818393bf830fd49386bfb57e6e","2020-04-07T20:00:00Z",0,33,4005,4005,4005,56,0,10,70,6,76
"2913",20200406,"AK",191,6692,NA,NA,23,NA,NA,NA,NA,NA,"A","4/6/2020 14:45","1d4b2f9d0f737627c7103bb93f22cb9216446390","2020-04-06T20:00:00Z",6,23,6883,6883,6883,2,0,3,593,6,599
"2914",20200406,"AL",1968,12797,NA,NA,240,NA,NA,NA,NA,NA,"B","4/6/2020 00:00","984cb27a09c05f902fc7de2d8824a1409ae53f60","2020-04-06T20:00:00Z",50,240,14765,14765,14765,1,5,9,1515,172,1687
"2915",20200406,"AR",875,11970,NA,74,137,NA,NA,22,39,102,"A","4/6/2020 14:35","235da230b2c2ee57bb1c72f583d66cd4b243d5e1","2020-04-06T20:00:00Z",16,137,12845,12845,12845,5,0,7,1558,45,1603
"2916",20200406,"AS",0,3,2,NA,NA,NA,NA,NA,NA,NA,"","4/6/2020 16:00","bb54229b62f9955105c6033d24d9401be02a95e9","2020-04-06T20:00:00Z",0,NA,5,3,3,60,0,0,0,0,0
"2917",20200406,"AZ",2456,30078,NA,NA,NA,NA,NA,NA,NA,NA,"B","4/6/2020 00:00","62abd6e6431240c69764f04a2e688e01ed7550e4","2020-04-06T20:00:00Z",65,NA,32534,32534,32534,4,1,0,4937,187,5124
"2918",20200406,"CA",14336,103095,15000,2509,NA,1085,NA,NA,NA,NA,"B","4/6/2020 00:00","950d32c052a87c2378fcc055d85a051e392d9bf1","2020-04-06T20:00:00Z",343,NA,132431,117431,117431,6,24,0,0,898,898
"2919",20200406,"CO",4950,20823,NA,786,924,NA,NA,NA,NA,NA,"A","4/4/2020 00:00","e88ed56323f537a9a080fdc4f1c3ddc30740e2bd","2020-04-06T20:00:00Z",140,924,25773,25773,25773,8,14,49,1488,385,1873
"2920",20200406,"CT",6906,19780,NA,1221,NA,NA,NA,NA,NA,NA,"A","4/6/2020 15:15","b4fabae43ce6d4a6fc6b2219b9f08a78180aae6c","2020-04-06T20:00:00Z",206,NA,26686,26686,26686,9,17,0,2185,1231,3416
"2921",20200406,"DC",1097,6356,NA,NA,NA,NA,NA,NA,NA,287,"A","4/5/2020 00:00","341c3e2159711ef2be5efa972f8dae12d47902f9","2020-04-06T20:00:00Z",24,NA,7453,7453,7453,11,2,0,520,99,619
"2922",20200406,"DE",673,6321,NA,101,NA,NA,NA,NA,NA,71,"A","4/5/2020 03:30","fdbe3153e1855e1060496d3cd49ccff170ff5026","2020-04-06T20:00:00Z",14,NA,6994,6994,6994,10,0,0,0,0,0
"2923",20200406,"FL",13324,109950,1142,NA,1682,NA,NA,NA,NA,NA,"A","4/6/2020 12:17","f746c23ba2945880d1166f5d48ed41231789b38a","2020-04-06T20:00:00Z",236,1682,124416,123274,123274,12,18,110,8697,1173,9870
"2924",20200406,"GA",7314,23960,NA,NA,1332,NA,NA,NA,NA,NA,"A","4/6/2020 11:28","ae6a1dbe880a1e383251bcfa7ffd17a2449cb3fc","2020-04-06T20:00:00Z",229,1332,31274,31274,31274,13,18,49,2775,667,3442
"2925",20200406,"GU",113,505,NA,21,NA,2,NA,NA,NA,25,"","4/6/2020 06:00","49a5136a5e9c7a0645fe89f7fa647061c6f0b592","2020-04-06T20:00:00Z",4,NA,618,618,618,66,0,0,12,1,13
"2926",20200406,"HI",371,13155,NA,NA,21,NA,6,NA,NA,85,"A","4/5/2020 18:00","4a6174d611b9548a92ce4f4ac835a4ed878767e9","2020-04-06T20:00:00Z",4,21,13526,13526,13526,15,0,2,551,20,571
"2927",20200406,"IA",946,10653,NA,99,179,NA,NA,NA,NA,284,"A","4/6/2020 00:00","715a722413bccfe35a777e46cc7a56e238916212","2020-04-06T20:00:00Z",25,179,11599,11599,11599,19,3,14,680,78,758
"2928",20200406,"ID",1101,9894,NA,NA,77,NA,16,NA,NA,NA,"A","4/5/2020 19:00","50b5447485020c1926c75944e973468937af5cba","2020-04-06T20:00:00Z",10,77,10995,10995,10995,16,0,11,710,24,734
"2929",20200406,"IL",12262,50680,NA,NA,NA,NA,NA,NA,NA,NA,"A","4/6/2020 00:00","37375072af04066c00dc321fda75f48cdb3a1a48","2020-04-06T20:00:00Z",307,NA,62942,62942,62942,17,33,0,2953,1006,3959
"2930",20200406,"IN",4944,21247,NA,NA,NA,924,NA,507,NA,NA,"B","4/6/2020 14:00","8586e8d00f159fbb60cd4afac33e76f3a5368885","2020-04-06T20:00:00Z",139,NA,26191,26191,26191,18,12,0,3006,533,3539
"2931",20200406,"KS",845,8239,NA,NA,198,NA,NA,NA,NA,NA,"B","4/6/2020 12:00","01e8134ef78b859f9e74e3e81f7e4acaf31c128d","2020-04-06T20:00:00Z",25,198,9084,9084,9084,20,3,15,763,98,861
"2932",20200406,"KY",955,17812,NA,NA,NA,NA,NA,NA,NA,NA,"A","4/5/2020 17:00","eb79ae8ceb19e703b8fa1dc6b05cee05e37afd23","2020-04-06T20:00:00Z",45,NA,18767,18767,18767,21,5,0,2066,38,2104
"2933",20200406,"LA",14867,54299,NA,1981,NA,NA,NA,552,NA,NA,"A","4/6/2020 13:00","03da4db158c4cc114d17ed5c79258329341fdd5e","2020-04-06T20:00:00Z",512,NA,69166,69166,69166,22,35,0,6984,1857,8841
"2934",20200406,"MA",13739,62720,NA,1667,1667,NA,NA,NA,NA,NA,"B","4/6/2020 12:30","92fe6407240a8971ee08b7dcfa70b33ea3476044","2020-04-06T20:00:00Z",448,1667,76459,76459,76459,25,78,35,3155,1337,4492
"2935",20200406,"MD",4045,25572,NA,NA,1059,NA,NA,NA,NA,184,"A","4/6/2020 10:00","ca2116b13b1421ff525155aaedef9487ec2b8aaa","2020-04-06T20:00:00Z",91,1059,29617,29617,29617,24,24,123,844,436,1280
"2936",20200406,"ME",499,6088,NA,NA,92,NA,NA,NA,NA,158,"A","4/6/2020 11:00","941f06892de9dbcdaa19e57444ecf1bc28cd528f","2020-04-06T20:00:00Z",10,92,6587,6587,6587,23,0,6,0,29,29
"2937",20200406,"MI",18850,43120,NA,NA,NA,NA,NA,NA,NA,56,"B","4/6/2020 11:00","406969c0a33e34681b6738111a1aaebc965b07d5","2020-04-06T20:00:00Z",727,NA,61970,61970,61970,26,110,0,2789,1283,4072
"2938",20200406,"MN",986,27142,NA,115,223,57,90,NA,NA,440,"A","4/6/2020 17:11","335ece08e6bf93545952865bfe8b90f1318264d0","2020-04-06T20:00:00Z",30,223,28128,28128,28128,27,1,21,1300,51,1351
"2939",20200406,"MO",2722,27113,NA,439,NA,NA,NA,NA,NA,NA,"A","4/6/2020 16:28","199583f7e9ed24b2c7df261fed98e14ab52de661","2020-04-06T20:00:00Z",39,NA,29835,29835,29835,29,5,0,2231,355,2586
"2940",20200406,"MP",8,13,10,NA,NA,NA,NA,NA,NA,NA,"","4/6/2020 02:57","94a74f1e789c163021b21f07042aad2ec6fe3d62","2020-04-06T20:00:00Z",1,NA,31,21,21,69,0,0,0,0,0
"2941",20200406,"MS",1738,18632,NA,NA,475,NA,NA,NA,NA,NA,"A","4/6/2020 16:33","e94706b48537a9596904a81dce9cfddb117940f4","2020-04-06T20:00:00Z",51,475,20370,20370,20370,28,8,0,13052,100,13152
"2942",20200406,"MT",299,6491,NA,NA,24,NA,NA,NA,NA,NA,"A","4/6/2020 10:00","b9f1650346438bfd21d9f2a18a904680c48dba15","2020-04-06T20:00:00Z",6,24,6790,6790,6790,30,0,0,174,13,187
"2943",20200406,"NC",2870,37856,NA,270,NA,NA,NA,NA,NA,NA,"A","4/6/2020 11:00","83f3be16a399342f6a709875bea7c3070211cc74","2020-04-06T20:00:00Z",33,NA,40726,40726,40726,37,2,0,396,285,681
"2944",20200406,"ND",225,6988,NA,19,32,NA,NA,NA,NA,74,"B","4/6/2020 13:05","a2cd500e0af338667f11697275eda797164bf678","2020-04-06T20:00:00Z",3,32,7213,7213,7213,38,0,1,408,18,426
"2945",20200406,"NE",409,6378,8,NA,NA,NA,NA,NA,NA,NA,"A","4/6/2020 13:38","8eec59dc0d6aba42fcfb8ea5b5af7804c666dd3f","2020-04-06T20:00:00Z",8,NA,6795,6787,6787,31,0,0,820,46,866
"2946",20200406,"NH",669,7701,101,NA,92,NA,NA,NA,NA,147,"B","4/5/2020 09:00","cdacba38bb4ad8621b5d885ec36b1627e57cfaa7","2020-04-06T20:00:00Z",9,92,8471,8370,8370,33,0,6,290,48,338
"2947",20200406,"NJ",41090,47942,NA,6390,NA,NA,NA,1263,NA,NA,"A","4/6/2020 13:00","a74fe0e06299a4f19046463144d64c47233d712a","2020-04-06T20:00:00Z",1003,NA,89032,89032,89032,34,86,0,3281,3585,6866
"2948",20200406,"NM",624,18512,NA,45,NA,NA,NA,18,NA,130,"A","4/6/2020 00:00","19786798da034b299a88aafefbdc73da81616b5e","2020-04-06T20:00:00Z",12,NA,19136,19136,19136,35,1,0,2227,81,2308
"2949",20200406,"NV",1953,15676,NA,NA,NA,NA,NA,NA,NA,NA,"A","4/6/2020 10:00","db86f16e04ed4b25a821666e2268acbc2c1756a9","2020-04-06T20:00:00Z",46,NA,17629,17629,17629,32,0,0,681,117,798
"2950",20200406,"NY",130689,190122,NA,16837,30203,4504,NA,NA,NA,13366,"A","4/6/2020 00:00","7157819a1cbc0028c234f57e016bf324decf9833","2020-04-06T20:00:00Z",4758,30203,320811,320811,320811,36,599,2111,9873,8658,18531
"2951",20200406,"OH",4450,43928,NA,NA,1214,NA,371,NA,NA,NA,"B","4/6/2020 14:00","115fbef1d576aaa164ca1fa6df4e972e209c2dda","2020-04-06T20:00:00Z",142,1214,48378,48378,48378,39,23,110,4215,407,4622
"2952",20200406,"OK",1327,1422,NA,161,340,143,NA,NA,NA,522,"B","4/6/2020 08:00","a8cf3fdaff21ac0bef6a2195edbfbd862edaa865","2020-04-06T20:00:00Z",51,340,2749,2749,2749,40,5,10,21,75,96
"2953",20200406,"OR",1132,20669,NA,NA,258,NA,NA,40,NA,NA,"A","4/5/2020 11:00","7cef2a397ba319c40eb3cf213a5fe878d61061fb","2020-04-06T20:00:00Z",27,258,21801,21801,21801,41,0,0,1113,64,1177
"2954",20200406,"PA",12980,70874,NA,NA,1145,NA,NA,533,NA,NA,"A","4/6/2020 12:00","248bddf6dc4760944abe16be76b730369a39f970","2020-04-06T20:00:00Z",162,1145,83854,83854,83854,42,12,73,4613,1470,6083
"2955",20200406,"PR",513,3432,1000,NA,NA,NA,NA,NA,NA,NA,"A","4/6/2020 07:00","020f5cbf062d2387d2c4845ef96c07bc2082d2b0","2020-04-06T20:00:00Z",21,NA,4945,3945,3945,72,1,0,359,38,397
"2956",20200406,"RI",1082,7399,NA,109,NA,37,NA,26,NA,35,"B","4/6/2020 00:00","0d3882733cc94a956ca33bfdd12bd826a7f1881f","2020-04-06T20:00:00Z",27,NA,8481,8481,8481,44,2,0,1140,160,1300
"2957",20200406,"SC",2049,16927,NA,NA,241,NA,NA,NA,NA,NA,"B","4/5/2020 15:30","fed56482023362b33a5a9606a2d2adcafd12262c","2020-04-06T20:00:00Z",44,241,18976,18976,18976,45,0,0,0,0,0
"2958",20200406,"SD",288,5732,0,NA,23,NA,NA,NA,NA,91,"A","4/6/2020 12:30","496cfcfa761d081dca7f76167cc8b5197ef25420","2020-04-06T20:00:00Z",4,23,6020,6020,6020,46,2,1,379,48,427
"2959",20200406,"TN",3802,43548,NA,NA,352,NA,NA,NA,NA,356,"A","4/6/2020 15:00","0b9c139c072bf8d3310e48637e5f307d31364ce4","2020-04-06T20:00:00Z",65,352,47350,47350,47350,47,21,24,1881,169,2050
"2960",20200406,"TX",7276,78081,NA,1153,NA,NA,NA,NA,NA,38,"A","4/5/2020 21:00","594cef2a8c6fcbc8eba602c7c5e33d868a55bbc7","2020-04-06T20:00:00Z",140,NA,85357,85357,85357,48,13,0,13955,464,14419
"2961",20200406,"UT",1675,31719,NA,NA,138,NA,NA,NA,NA,NA,"A","4/5/2020 15:00","1cb02c887f73a6b940469296194d261e675dc502","2020-04-06T20:00:00Z",13,138,33394,33394,33394,49,5,14,2432,70,2502
"2962",20200406,"VA",2878,21643,NA,NA,497,NA,145,NA,108,NA,"A","4/5/2020 17:00","03f55535e9a10519d2b3077c136ae75790f49521","2020-04-06T20:00:00Z",54,497,24521,24521,24521,51,3,66,609,241,850
"2963",20200406,"VI",43,222,20,NA,NA,NA,NA,NA,NA,36,"","4/5/2020 21:50","58879d33a2a5ecc222387d25473a08d296e80aff","2020-04-06T20:00:00Z",1,NA,285,265,265,78,0,0,16,1,17
"2964",20200406,"VT",575,6161,NA,28,45,NA,NA,NA,NA,15,"A","4/6/2020 00:00","d2a1859f42e65b820777dcc0ee2bfb7a7278ea16","2020-04-06T20:00:00Z",23,45,6736,6736,6736,50,1,0,331,32,363
"2965",20200406,"WA",8937,100203,NA,638,NA,191,NA,NA,NA,NA,"A","4/6/2020 00:00","13df9ddbcbe8a552d9b680be3fd6e556c5a8c637","2020-04-06T20:00:00Z",407,NA,109140,109140,109140,53,21,0,4658,393,5051
"2966",20200406,"WI",2440,26574,NA,NA,668,NA,186,NA,NA,NA,"A","4/6/2020 16:00","2def0fc7a4c4c32ff930bc6125013710ad666092","2020-04-06T20:00:00Z",77,668,29014,29014,29014,55,9,44,1405,173,1578
"2967",20200406,"WV",345,9595,NA,NA,NA,NA,NA,NA,NA,NA,"B","4/6/2020 10:00","0d851d9c345cd7321c01f0ccf851055fddeca63f","2020-04-06T20:00:00Z",4,NA,9940,9940,9940,54,1,0,1081,21,1102
"2968",20200406,"WY",210,3719,NA,NA,23,NA,NA,NA,NA,52,"A","4/6/2020 11:32","fa40a3be8efc151cd0c37e902f0af3d05bf6202c","2020-04-06T20:00:00Z",0,23,3929,3929,3929,56,0,0,679,13,692
"2969",20200405,"AK",185,6099,NA,NA,20,NA,NA,NA,NA,NA,"A","4/5/2020 00:00","6fe21c4ec71dc8b13e0de1521e8a4fe161ac3325","2020-04-05T20:00:00Z",6,20,6284,6284,6284,2,1,4,230,14,244
"2970",20200405,"AL",1796,11282,NA,NA,231,NA,NA,NA,NA,NA,"B","4/5/2020 00:00","61a882f70233d0908881fa9857ffdec9c96f5375","2020-04-05T20:00:00Z",45,231,13078,13078,13078,1,2,19,2009,216,2225
"2971",20200405,"AR",830,10412,NA,67,130,NA,NA,27,39,97,"A","4/5/2020 14:34","165a8f8b5c2c71334b87f45580c501b73444cc51","2020-04-05T20:00:00Z",16,130,11242,11242,11242,5,2,24,785,87,872
"2972",20200405,"AS",0,3,2,NA,NA,NA,NA,NA,NA,NA,"","3/30/2020 23:00","014b305a9bc1adc41028402aedfb7c0c9e958a0f","2020-04-05T20:00:00Z",0,NA,5,3,3,60,0,0,0,0,0
"2973",20200405,"AZ",2269,25141,NA,NA,NA,NA,NA,NA,NA,NA,"B","4/5/2020 00:00","102f45389259503aed2b18f79cbdef710b998f4d","2020-04-05T20:00:00Z",64,NA,27410,27410,27410,4,12,0,0,250,250
"2974",20200405,"CA",13438,103095,15000,2398,NA,1040,NA,NA,NA,NA,"B","4/4/2020 00:00","a3a9a3ad15df74f58af675bff0f6fb5d62b26b52","2020-04-05T20:00:00Z",319,NA,131533,116533,116533,6,43,0,1421,1412,2833
"2975",20200405,"CO",4565,19335,NA,783,875,NA,NA,NA,NA,NA,"A","4/3/2020 00:00","d2750576ccd2b14106b1e5f048465db1026a68d1","2020-04-05T20:00:00Z",126,875,23900,23900,23900,8,15,52,1437,392,1829
"2976",20200405,"CT",5675,17595,NA,1142,NA,NA,NA,NA,NA,NA,"A","4/5/2020 12:00","9e2b40179d4d129911c3b12f68f87f1d8d03d378","2020-04-05T20:00:00Z",189,NA,23270,23270,23270,9,24,0,842,399,1241
"2977",20200405,"DC",998,5836,NA,NA,NA,NA,NA,NA,NA,258,"A","4/4/2020 00:00","c7f0fe5340a0a72d93b5356fa8a8e5354f5f83e0","2020-04-05T20:00:00Z",22,NA,6834,6834,6834,11,1,0,300,96,396
"2978",20200405,"DE",673,6321,NA,101,NA,NA,NA,NA,NA,71,"C","4/5/2020 12:30","21ad8ad3f3e26a6096bea1890c2ba261bed8891d","2020-04-05T20:00:00Z",14,NA,6994,6994,6994,10,0,0,447,80,527
"2979",20200405,"FL",12151,101253,1129,NA,1572,NA,NA,NA,NA,NA,"A","4/5/2020 13:30","1006c1e12dde1100c7046bb50b048cdd2e991c3a","2020-04-05T20:00:00Z",218,1572,114533,113404,113404,12,27,110,10297,1040,11337
"2980",20200405,"GA",6647,21185,NA,NA,1283,NA,NA,NA,NA,NA,"A","4/5/2020 11:27","4f91670b296cddbbcfb1ff10b705f776699690ac","2020-04-05T20:00:00Z",211,1283,27832,27832,27832,13,10,44,1051,487,1538
"2981",20200405,"GU",112,493,NA,21,NA,2,NA,NA,NA,23,"","4/5/2020 09:05","23c8f6dcd54e70d8c1dffcc32698baaf2890042e","2020-04-05T20:00:00Z",4,NA,605,605,605,66,0,0,21,19,40
"2982",20200405,"HI",351,12604,NA,NA,19,NA,6,NA,NA,82,"A","4/4/2020 18:00","d8f20460299185e68a9155a69b4a6decbd74e0ab","2020-04-05T20:00:00Z",4,19,12955,12955,12955,15,1,1,645,32,677
"2983",20200405,"IA",868,9973,NA,91,165,NA,NA,NA,NA,188,"C","4/5/2020 00:00","ddfa424801ab60f4ff3b34b468d3e112463ca210","2020-04-05T20:00:00Z",22,165,10841,10841,10841,19,8,12,519,82,601
"2984",20200405,"ID",1077,9184,NA,NA,66,NA,11,NA,NA,NA,"A","4/4/2020 19:00","b898143797c3cbeb04ca39d96477e3d0f912948a","2020-04-05T20:00:00Z",10,66,10261,10261,10261,16,0,4,1327,64,1391
"2985",20200405,"IL",11256,47727,NA,NA,NA,NA,NA,NA,NA,NA,"A","4/5/2020 00:00","028360c7575c832d851c2a3bb927a7c371860578","2020-04-05T20:00:00Z",274,NA,58983,58983,58983,17,31,0,4503,899,5402
"2986",20200405,"IN",4411,18241,NA,NA,NA,NA,NA,NA,NA,NA,"B","4/4/2020 11:59","b052bdd8a680a779f4a79dd2102a50a02cb46410","2020-04-05T20:00:00Z",127,NA,22652,22652,22652,18,11,0,2394,458,2852
"2987",20200405,"KS",747,7476,NA,NA,183,NA,NA,NA,NA,NA,"B","4/5/2020 12:00","a65ae415b49ecc4840648e7d550639963c13dad2","2020-04-05T20:00:00Z",22,183,8223,8223,8223,20,1,11,596,49,645
"2988",20200405,"KY",917,15746,NA,NA,NA,NA,NA,NA,NA,NA,"A","4/4/2020 17:00","3067cdf46aaa338ed15460187acfff460d1af2c2","2020-04-05T20:00:00Z",40,NA,16663,16663,16663,21,3,0,1005,86,1091
"2989",20200405,"LA",13010,47315,NA,1803,NA,NA,NA,561,NA,NA,"A","4/5/2020 13:00","7f49cd9fac471ff403739c372c2db3608fcbae55","2020-04-05T20:00:00Z",477,NA,60325,60325,60325,22,68,0,1313,514,1827
"2990",20200405,"MA",12402,59565,NA,1632,1632,NA,NA,NA,NA,NA,"B","4/5/2020 12:30","8afb901ea410e0a097fcb0740103c8632065372a","2020-04-05T20:00:00Z",370,1632,71967,71967,71967,25,66,262,2374,765,3139
"2991",20200405,"MD",3609,24728,NA,NA,936,NA,NA,NA,NA,159,"A","4/5/2020 10:00","05576a6aa37bcb3ae5b8c2654d888e2486bc2d46","2020-04-05T20:00:00Z",67,936,28337,28337,28337,24,14,115,2243,484,2727
"2992",20200405,"ME",470,6088,NA,NA,86,NA,NA,NA,NA,156,"A","4/5/2020 11:00","4814403baa5768898bd7a7b6ea80f4ab5fa67554","2020-04-05T20:00:00Z",10,86,6558,6558,6558,23,0,3,0,14,14
"2993",20200405,"MI",17567,40331,NA,NA,NA,NA,NA,NA,NA,56,"B","4/5/2020 11:00","4eb9c36f867db3d243b0b82dd26ad18aa5e720a3","2020-04-05T20:00:00Z",617,NA,57898,57898,57898,26,77,0,2926,1172,4098
"2994",20200405,"MN",935,25842,NA,106,202,48,77,NA,NA,422,"A","4/4/2020 17:00","6781c7da5b0258daddd8b0f4e6e9f8af174dbc72","2020-04-05T20:00:00Z",29,202,26777,26777,26777,27,5,22,1284,70,1354
"2995",20200405,"MO",2367,24882,NA,424,NA,NA,NA,NA,NA,NA,"C","4/5/2020 15:00","d1e49f2389c6e0f20a58e417a427e95cd5c0d46c","2020-04-05T20:00:00Z",34,NA,27249,27249,27249,29,10,0,2268,76,2344
"2996",20200405,"MP",8,13,10,NA,NA,NA,NA,NA,NA,NA,"","4/4/2020 18:30","d8dca952111844ccd61f4db7fc78a68f06d65166","2020-04-05T20:00:00Z",1,NA,31,21,21,69,0,0,0,0,0
"2997",20200405,"MS",1638,5580,NA,NA,475,NA,NA,NA,NA,NA,"B","4/4/2020 19:00","0047e3cb18db13ec186265aacc7af335508ef92a","2020-04-05T20:00:00Z",43,475,7218,7218,7218,28,8,39,447,183,630
"2998",20200405,"MT",286,6317,NA,NA,24,NA,NA,NA,NA,NA,"A","4/5/2020 10:00","d1137189523e5447c6854c3f17c2e2ba186237f7","2020-04-05T20:00:00Z",6,24,6603,6603,6603,30,1,0,405,21,426
"2999",20200405,"NC",2585,37460,NA,261,NA,NA,NA,NA,NA,NA,"A","4/5/2020 11:00","9068c626b45bdb5ff9aa9ce4fd092d7bd666dce9","2020-04-05T20:00:00Z",31,NA,40045,40045,40045,37,7,0,1089,183,1272
"3000",20200405,"ND",207,6580,NA,20,31,NA,NA,NA,NA,63,"B","4/5/2020 12:51","ef67c0333eaed271d8f31652c1a82b5d085acb7a","2020-04-05T20:00:00Z",3,31,6787,6787,6787,38,0,1,559,21,580
"3001",20200405,"NE",363,5558,12,NA,NA,NA,NA,NA,NA,NA,"A","4/5/2020 13:50","62578131398666df086d00d5b3466f0b8bdb64f0","2020-04-05T20:00:00Z",8,NA,5933,5921,5921,31,2,0,500,42,542
"3002",20200405,"NH",621,7411,93,NA,86,NA,NA,NA,NA,146,"B","4/4/2020 09:00","f8ccba43400f4fda7bbce932bb2b3cdbeb561dc1","2020-04-05T20:00:00Z",9,86,8125,8032,8032,33,2,6,446,81,527
"3003",20200405,"NJ",37505,44661,NA,4000,NA,NA,NA,NA,NA,NA,"A","4/5/2020 13:00","4bef04414f31a9e0907940538128be5d99f3e924","2020-04-05T20:00:00Z",917,NA,82166,82166,82166,34,71,0,3429,3381,6810
"3004",20200405,"NM",543,16285,NA,37,NA,NA,NA,18,NA,54,"A","4/4/2020 00:00","9cfc858d993699375880170d4f4a28cbf9e2b819","2020-04-05T20:00:00Z",11,NA,16828,16828,16828,35,1,0,1148,48,1196
"3005",20200405,"NV",1836,14995,NA,NA,NA,NA,NA,NA,NA,NA,"A","4/5/2020 09:30","b0e111d738c821235bd616f7173fef4c0be5c0e7","2020-04-05T20:00:00Z",46,NA,16831,16831,16831,32,0,0,574,94,668
"3006",20200405,"NY",122031,180249,NA,16479,28092,4376,NA,NA,NA,12187,"A","4/4/2020 00:00","86edd46199b4247433dc8387311bb1957f054ca4","2020-04-05T20:00:00Z",4159,28092,302280,302280,302280,36,594,1709,10332,8327,18659
"3007",20200405,"OH",4043,39713,NA,NA,1104,NA,346,NA,NA,NA,"B","4/5/2020 14:00","8adb790943cb9abcab01b70d2b7f6df99dd99893","2020-04-05T20:00:00Z",119,1104,43756,43756,43756,39,17,98,1581,304,1885
"3008",20200405,"OK",1252,1401,NA,NA,330,NA,NA,NA,NA,NA,"B","4/5/2020 08:00","1c09627f64b45e6a626ac3c31033c153bfe706b3","2020-04-05T20:00:00Z",46,330,2653,2653,2653,40,4,14,39,93,132
"3009",20200405,"OR",1068,19556,NA,NA,258,NA,NA,40,NA,NA,"A","4/4/2020 11:00","f1b18affbbc6838a5ca1342c5beb093f06e354c1","2020-04-05T20:00:00Z",27,258,20624,20624,20624,41,1,19,3021,69,3090
"3010",20200405,"PA",11510,66261,NA,NA,1072,NA,NA,NA,NA,NA,"A","4/5/2020 12:00","47b671abe077b72f600fa3b019fb2f9d1acee9f7","2020-04-05T20:00:00Z",150,1072,77771,77771,77771,42,14,68,6248,1493,7741
"3011",20200405,"PR",475,3073,1039,NA,NA,NA,NA,NA,NA,NA,"A","4/5/2020 07:00","4a81a89ffa3167a1b555f433c1e2ddc116195164","2020-04-05T20:00:00Z",20,NA,4587,3548,3548,72,2,0,468,23,491
"3012",20200405,"RI",922,6259,NA,103,NA,33,NA,6,NA,35,"B","4/5/2020 00:00","b165f5c7bfe8894a0fc9b3a3141b3ce8a8101bf7","2020-04-05T20:00:00Z",25,NA,7181,7181,7181,44,8,0,675,116,791
"3013",20200405,"SC",2049,16927,NA,NA,241,NA,NA,NA,NA,NA,"B","4/5/2020 15:30","16d19cc7f9b970e7fc9cdac0aa31f6a8cf317828","2020-04-05T20:00:00Z",44,241,18976,18976,18976,45,4,0,530,132,662
"3014",20200405,"SD",240,5353,NA,NA,22,NA,NA,NA,NA,84,"A","4/4/2020 18:00","688322773fbf267d6a92aec3e0a94de84d20c7fe","2020-04-05T20:00:00Z",2,22,5593,5593,5593,46,0,3,341,28,369
"3015",20200405,"TN",3633,41667,NA,NA,328,NA,NA,NA,NA,295,"A","4/4/2020 15:00","2fac2b2a88b6ac45b64f85cf2ce087d6ee7c8443","2020-04-05T20:00:00Z",44,328,45300,45300,45300,47,1,17,3597,312,3909
"3016",20200405,"TX",6812,64126,NA,827,NA,NA,NA,NA,NA,38,"A","4/5/2020 13:00","0c7a1ac735749982cf8155115b0e1d0b5fc35cae","2020-04-05T20:00:00Z",127,NA,70938,70938,70938,48,22,0,6485,702,7187
"3017",20200405,"UT",1605,29287,NA,NA,124,NA,NA,NA,NA,NA,"A","4/5/2020 15:00","92701951b7360a1ebfd40fd03655b177f1944eb0","2020-04-05T20:00:00Z",8,124,30892,30892,30892,49,0,7,2672,177,2849
"3018",20200405,"VA",2637,21034,NA,NA,431,NA,145,NA,108,NA,"A","4/4/2020 17:00","d1adecfa81bbb881fc4b2761f4ebab174950ee4b","2020-04-05T20:00:00Z",51,431,23671,23671,23671,51,-1,41,1889,230,2119
"3019",20200405,"VI",42,206,18,NA,NA,NA,NA,NA,NA,34,"","4/5/2020 00:00","713c3d9b4b25ffef5bb78fc3d3167a2372754463","2020-04-05T20:00:00Z",1,NA,266,248,248,78,1,0,22,2,24
"3020",20200405,"VT",543,5830,NA,29,45,NA,NA,NA,NA,15,"A","4/5/2020 00:00","036eb86a19b934df459f25b015b7757749f803b8","2020-04-05T20:00:00Z",22,45,6373,6373,6373,50,2,0,588,31,619
"3021",20200405,"WA",8544,95545,NA,581,NA,178,NA,NA,NA,NA,"A","4/5/2020 00:00","e71c137d4bfbbe2e0820febb94b61f7cf3c25a79","2020-04-05T20:00:00Z",386,NA,104089,104089,104089,53,21,0,1773,169,1942
"3022",20200405,"WI",2267,25169,NA,NA,624,NA,175,NA,NA,NA,"A","4/5/2020 16:00","8c5e9e4c10fbe30521bcc06625b3c5ebdfe5686c","2020-04-05T20:00:00Z",68,624,27436,27436,27436,55,12,36,1310,155,1465
"3023",20200405,"WV",324,8514,NA,NA,NA,NA,NA,NA,NA,NA,"B","4/5/2020 10:00","b6619d2ae56c78fd75baf1748d95d966d3e788bb","2020-04-05T20:00:00Z",3,NA,8838,8838,8838,54,1,0,1110,42,1152
"3024",20200405,"WY",197,3040,NA,NA,23,NA,NA,NA,NA,50,"A","4/5/2020 09:23","9a55b993326e4149d008ffc45bc94c18b5694d6c","2020-04-05T20:00:00Z",0,23,3237,3237,3237,56,0,0,95,10,105
"3025",20200404,"AK",171,5869,NA,NA,16,NA,NA,NA,NA,NA,"A","4/4/2020 16:00","2fcf0831cbdf13c8779ec705f71fe6d542a8af32","2020-04-04T20:00:00Z",5,16,6040,6040,6040,2,2,1,10,14,24
"3026",20200404,"AL",1580,9273,NA,NA,212,NA,NA,NA,NA,NA,"B","4/4/2020 00:00","b19623c0085a8df2a8ca6be43ff684eb7763c5bc","2020-04-04T20:00:00Z",43,212,10853,10853,10853,1,8,212,1086,148,1234
"3027",20200404,"AR",743,9627,NA,72,106,NA,NA,23,39,79,"A","4/4/2020 00:00","8b51e9f2de31a851f9a0beb6414538d2fe02642f","2020-04-04T20:00:00Z",14,106,10370,10370,10370,5,2,1,632,39,671
"3028",20200404,"AS",0,3,2,NA,NA,NA,NA,NA,NA,NA,"","3/30/2020 23:00","23715a252794aa55540465d1adb7e8d12c7c5bf1","2020-04-04T20:00:00Z",0,NA,5,3,3,60,0,0,0,0,0
"3029",20200404,"AZ",2019,25141,NA,NA,NA,NA,NA,NA,NA,NA,"B","4/4/2020 00:00","426476f2eb837c277c6f625f39dc0dd52185891c","2020-04-04T20:00:00Z",52,NA,27160,27160,27160,4,11,0,2237,250,2487
"3030",20200404,"CA",12026,101674,13000,2300,NA,1008,NA,NA,NA,NA,"B","4/2/2020 00:00","ef58df43c29fb15fc944d7abae9ea74bedced0ca","2020-04-04T20:00:00Z",276,NA,126700,113700,113700,6,39,0,77075,1325,78400
"3031",20200404,"CO",4173,17898,NA,777,823,NA,NA,NA,NA,NA,"A","4/2/2020 00:00","214ea446bf0175e88bf8234cae5c0f55f2abd012","2020-04-04T20:00:00Z",111,823,22071,22071,22071,8,14,113,1215,445,1660
"3032",20200404,"CT",5276,16753,NA,1033,NA,NA,NA,NA,NA,NA,"A","4/4/2020 13:00","db90667d46b5457a45587d7301969e6a1ebb7191","2020-04-04T20:00:00Z",165,NA,22029,22029,22029,9,34,0,1652,362,2014
"3033",20200404,"DC",902,5536,NA,NA,NA,NA,NA,NA,NA,235,"A","4/3/2020 00:00","1cecf51c6b90945f6178c4382f5a68ec9566e7bb","2020-04-04T20:00:00Z",21,NA,6438,6438,6438,11,6,0,709,145,854
"3034",20200404,"DE",593,5874,NA,95,NA,NA,NA,NA,NA,71,"C","4/4/2020 13:45","0349eca21ca46acc00498c682deea2a0765edffa","2020-04-04T20:00:00Z",14,NA,6467,6467,6467,10,0,0,879,143,1022
"3035",20200404,"FL",11111,90956,1281,NA,1462,NA,NA,NA,NA,NA,"A","4/4/2020 09:51","b84817ac9891b258253609ad6be67ba90cee1c6b","2020-04-04T20:00:00Z",191,1462,103348,102067,102067,12,28,175,8819,1526,10345
"3036",20200404,"GA",6160,20134,NA,NA,1239,NA,NA,NA,NA,NA,"A","4/4/2020 11:27","860fecdfc9fa22c91ad11d6ade5d551839d485f6","2020-04-04T20:00:00Z",201,1239,26294,26294,26294,13,17,81,700,329,1029
"3037",20200404,"GU",93,472,NA,20,NA,2,NA,NA,NA,20,"","4/4/2020 06:45","eafc8cb15907ffd70c8a97e4a391622c66d30bcb","2020-04-04T20:00:00Z",4,NA,565,565,565,66,0,0,13,9,22
"3038",20200404,"HI",319,11959,NA,NA,18,NA,6,NA,NA,78,"A","4/3/2020 18:00","fb720a96e2e02a222c24655b877b4cec7fc85193","2020-04-04T20:00:00Z",3,18,12278,12278,12278,15,1,3,1753,34,1787
"3039",20200404,"IA",786,9454,NA,85,153,NA,NA,NA,NA,188,"C","4/4/2020 00:00","9e73cf5d729a0ea7d684c8562b7c73038b0dd231","2020-04-04T20:00:00Z",14,153,10240,10240,10240,19,3,15,700,87,787
"3040",20200404,"ID",1013,7857,NA,NA,62,NA,8,NA,NA,NA,"A","4/3/2020 19:00","50d8672be5e1ff6d54ccfb9287693da63aeee222","2020-04-04T20:00:00Z",10,62,8870,8870,8870,16,1,6,803,122,925
"3041",20200404,"IL",10357,43224,NA,NA,NA,NA,NA,NA,NA,NA,"A","4/4/2020 00:00","60c185422b926f6496b628a83b720ea412f3bdc1","2020-04-04T20:00:00Z",243,NA,53581,53581,53581,17,33,0,4080,1453,5533
"3042",20200404,"IN",3953,15847,NA,NA,NA,NA,NA,NA,NA,NA,"B","4/2/2020 23:59","86e3e30e7908025e25aae55ab89d40dcf3db47a2","2020-04-04T20:00:00Z",116,NA,19800,19800,19800,18,14,0,1449,516,1965
"3043",20200404,"KS",698,6880,NA,NA,172,NA,NA,NA,NA,NA,"B","4/4/2020 12:00","3b275ff593516712ccd9f2a28c8ca9c8ee4f7241","2020-04-04T20:00:00Z",21,172,7578,7578,7578,20,4,21,426,78,504
"3044",20200404,"KY",831,14741,NA,NA,NA,NA,NA,NA,NA,NA,"A","4/3/2020 17:00","a8414c3fb46a5d701098a89d0c0863581f1a9b35","2020-04-04T20:00:00Z",37,NA,15572,15572,15572,21,6,0,2707,61,2768
"3045",20200404,"LA",12496,46002,NA,1726,NA,NA,NA,571,NA,NA,"A","4/4/2020 13:40","b1edfeb206285d6beb8939a6da10362a48569840","2020-04-04T20:00:00Z",409,NA,58498,58498,58498,22,39,0,2654,2199,4853
"3046",20200404,"MA",11637,57191,NA,1370,1370,NA,NA,NA,NA,NA,"B","4/4/2020 12:30","242bb0edba7f49fb5fd75db15132da0e194f2caf","2020-04-04T20:00:00Z",304,1370,68828,68828,68828,25,39,404,4506,1334,5840
"3047",20200404,"MD",3125,22485,NA,NA,821,NA,NA,NA,NA,159,"A","4/4/2020 10:00","8d1b8af2cee45aee5c9345a9ce214ee490e64132","2020-04-04T20:00:00Z",53,821,25610,25610,25610,24,11,157,1553,367,1920
"3048",20200404,"ME",456,6088,NA,NA,83,NA,NA,NA,NA,140,"A","4/4/2020 11:00","9f093ebf0b8e2f58cb5b2e972b3812c042d4e908","2020-04-04T20:00:00Z",10,83,6544,6544,6544,23,1,8,0,24,24
"3049",20200404,"MI",16395,37405,NA,NA,NA,NA,NA,NA,NA,56,"B","4/4/2020 11:00","f9e3a7cf29b62ce26da69b0961418f4e4da4ce84","2020-04-04T20:00:00Z",540,NA,53800,53800,53800,26,61,0,3735,1143,4878
"3050",20200404,"MN",865,24558,NA,95,180,42,69,NA,NA,416,"A","4/4/2020 12:00","c7bfecaebdb500e540486ce50e70a2b17fb1a52d","2020-04-04T20:00:00Z",24,180,25423,25423,25423,27,2,24,1120,76,1196
"3051",20200404,"MO",2291,22614,NA,413,NA,NA,NA,NA,NA,NA,"C","4/4/2020 15:00","6f374ffbfb6ef05e73fc861e4f6486d7238c6188","2020-04-04T20:00:00Z",24,NA,24905,24905,24905,29,5,0,3257,178,3435
"3052",20200404,"MP",8,13,10,NA,NA,NA,NA,NA,NA,NA,"","4/3/2020 13:30","075b90a76bcee262f6294982935dc4d4e499332a","2020-04-04T20:00:00Z",1,NA,31,21,21,69,0,0,0,0,0
"3053",20200404,"MS",1455,5133,NA,NA,436,NA,NA,NA,NA,NA,"B","4/3/2020 19:00","97dcdcef09fe306252674d70c23bfce9a9ac23c8","2020-04-04T20:00:00Z",35,436,6588,6588,6588,28,6,16,380,97,477
"3054",20200404,"MT",265,5912,NA,NA,24,NA,NA,NA,NA,NA,"A","4/4/2020 10:00","044faefd306ec816c3d0436d152f916a19158566","2020-04-04T20:00:00Z",5,24,6177,6177,6177,30,0,0,579,22,601
"3055",20200404,"NC",2402,36371,NA,271,NA,NA,NA,NA,NA,NA,"A","4/4/2020 11:00","b87e0be3398cd0bdf787bebd5bb44da0752e3e2c","2020-04-04T20:00:00Z",24,NA,38773,38773,38773,37,5,0,6866,309,7175
"3056",20200404,"ND",186,6021,NA,NA,30,NA,NA,NA,NA,63,"B","4/4/2020 13:00","8da85757012c4347dbe4cd22c808710dbedd267c","2020-04-04T20:00:00Z",3,30,6207,6207,6207,38,0,1,396,13,409
"3057",20200404,"NE",321,5058,10,NA,NA,NA,NA,NA,NA,NA,"A","4/4/2020 14:05","2910274f7e3b512c3bea20ba90901dd0e687355c","2020-04-04T20:00:00Z",6,NA,5389,5379,5379,31,0,0,571,42,613
"3058",20200404,"NH",540,6965,94,NA,80,NA,NA,NA,NA,144,"B","4/3/2020 09:00","dd048a249ff2b83609756acb538158dcfbd6da93","2020-04-04T20:00:00Z",7,80,7599,7505,7505,33,2,7,390,61,451
"3059",20200404,"NJ",34124,41232,NA,4000,NA,NA,NA,NA,NA,NA,"A","4/4/2020 13:00","31a1d627377614822cefe4ead3b8258cdfc02f88","2020-04-04T20:00:00Z",846,NA,75356,75356,75356,34,200,0,3624,4229,7853
"3060",20200404,"NM",495,15137,NA,41,NA,NA,NA,18,NA,26,"A","4/3/2020 00:00","fa53c21b5e991e4bbb83336d4e548cccc74b8c65","2020-04-04T20:00:00Z",10,NA,15632,15632,15632,35,3,0,762,92,854
"3061",20200404,"NV",1742,14421,NA,NA,NA,NA,NA,NA,NA,NA,"A","4/4/2020 09:30","e4362847a1a965aa8c82c9037b88d938bffba591","2020-04-04T20:00:00Z",46,NA,16163,16163,16163,32,3,0,1403,228,1631
"3062",20200404,"NY",113704,169917,NA,15905,26383,4126,NA,NA,NA,10478,"A","4/3/2020 11:00","529325eba58201a58de23fa068761d435b790b0b","2020-04-04T20:00:00Z",3565,26383,283621,283621,283621,36,630,2687,12260,10841,23101
"3063",20200404,"OH",3739,38132,NA,NA,1006,NA,326,NA,NA,NA,"B","4/4/2020 14:00","47c51d643a7ddf21a8b2cb82f67e5dea1cbe9106","2020-04-04T20:00:00Z",102,1006,41871,41871,41871,39,11,111,3069,427,3496
"3064",20200404,"OK",1159,1362,NA,NA,316,NA,NA,NA,NA,NA,"B","4/4/2020 08:00","391606bf115a79162ec47b905f42b59b76eba267","2020-04-04T20:00:00Z",42,316,2521,2521,2521,40,4,27,47,171,218
"3065",20200404,"OR",999,16535,NA,NA,239,NA,NA,38,NA,NA,"A","4/3/2020 12:00","6087d36677778a3083d557074042f7129b3240a1","2020-04-04T20:00:00Z",26,239,17534,17534,17534,41,4,35,0,100,100
"3066",20200404,"PA",10017,60013,NA,NA,1004,NA,NA,NA,NA,NA,"A","4/4/2020 12:00","77f373dd0f26ffa07c93d6df87ad442d2304a309","2020-04-04T20:00:00Z",136,1004,70030,70030,70030,42,34,152,6318,1597,7915
"3067",20200404,"PR",452,2605,1129,NA,NA,NA,NA,NA,NA,NA,"A","4/4/2020 07:00","763d733c37c66c62e524a942e7affd78d3fd6f32","2020-04-04T20:00:00Z",18,NA,4186,3057,3057,72,3,0,556,74,630
"3068",20200404,"RI",806,5584,NA,93,NA,31,NA,6,NA,35,"B","4/4/2020 00:00","c017a70ce9b7ff546280f48b68c65a2d4cc41cee","2020-04-04T20:00:00Z",17,NA,6390,6390,6390,44,3,0,727,97,824
"3069",20200404,"SC",1917,16397,NA,NA,241,NA,NA,NA,NA,NA,"B","4/4/2020 15:54","f77e7b39eabe76cf4167803caf243ccdfb46d4b5","2020-04-04T20:00:00Z",40,241,18314,18314,18314,45,9,0,10956,363,11319
"3070",20200404,"SD",212,5012,1,NA,19,NA,NA,NA,NA,76,"A","4/3/2020 18:00","764ec8fd92e7c32ef3aeb292288e68fab496d074","2020-04-04T20:00:00Z",2,19,5225,5224,5224,46,0,2,419,25,444
"3071",20200404,"TN",3321,38070,NA,NA,311,NA,NA,NA,NA,416,"A","4/4/2020 15:00","52a9b2c2646f588f2bf597067d54cab32b8203d0","2020-04-04T20:00:00Z",43,311,41391,41391,41391,47,6,18,3298,254,3552
"3072",20200404,"TX",6110,57641,NA,196,NA,NA,NA,NA,NA,38,"A","4/3/2020 21:00","711655dbce2d14b472a5a6d8a1585bc44df2b6d1","2020-04-04T20:00:00Z",105,NA,63751,63751,63751,48,15,0,7207,780,7987
"3073",20200404,"UT",1428,26615,NA,NA,117,NA,NA,NA,NA,NA,"A","4/4/2020 15:00","3f37cd78243dea5957484ea7bd96aa7e609c2095","2020-04-04T20:00:00Z",8,117,28043,28043,28043,49,1,11,3613,182,3795
"3074",20200404,"VA",2407,19145,NA,NA,390,NA,145,NA,108,NA,"A","4/3/2020 17:00","ea58eb5c5ad3b40cf5f21756c1a4811ae6a3aa34","2020-04-04T20:00:00Z",52,390,21552,21552,21552,51,6,78,2152,395,2547
"3075",20200404,"VI",40,184,42,NA,NA,NA,NA,NA,NA,34,"","4/3/2020 23:30","74ac2ec1cfafa3cf13ad3459533a021f61f1627e","2020-04-04T20:00:00Z",NA,NA,266,224,224,78,0,0,30,2,32
"3076",20200404,"VT",512,5242,NA,29,45,NA,NA,NA,NA,15,"A","4/4/2020 00:00","e25046a63b0467fca95d5f308e2ec7ef4a71bd80","2020-04-04T20:00:00Z",20,45,5754,5754,5754,50,3,0,377,52,429
"3077",20200404,"WA",8375,93772,NA,574,NA,174,NA,NA,NA,NA,"A","4/4/2020 00:00","91a49b9044b38b55e83274ded4925c567234712d","2020-04-04T20:00:00Z",365,NA,102147,102147,102147,53,27,0,2374,208,2582
"3078",20200404,"WI",2112,23859,NA,NA,588,NA,NA,NA,NA,NA,"A","4/4/2020 04:00","71878794afe1c385d43ec1e5588085c7a090510c","2020-04-04T20:00:00Z",56,588,25971,25971,25971,55,19,101,1482,200,1682
"3079",20200404,"WV",282,7404,NA,NA,NA,NA,NA,NA,NA,NA,"B","4/4/2020 10:00","fe9add69424023b10603eaf7a98d186073d4af2c","2020-04-04T20:00:00Z",2,NA,7686,7686,7686,54,0,0,1274,45,1319
"3080",20200404,"WY",187,2945,NA,NA,23,NA,NA,NA,NA,49,"A","4/4/2020 09:49","d10d136eb59f137cd10cc1c3eeb7cfd73849db79","2020-04-04T20:00:00Z",0,23,3132,3132,3132,56,0,2,241,25,266
"3081",20200403,"AK",157,5859,NA,NA,15,NA,NA,NA,NA,NA,"A","4/3/2020 16:00","17423669083906c2d217b4cf484d4aa817be4bdd","2020-04-03T20:00:00Z",3,15,6016,6016,6016,2,0,6,980,14,994
"3082",20200403,"AL",1432,8187,NA,NA,NA,NA,NA,NA,NA,NA,"B","4/3/2020 00:00","76aea56de3f6416171223dfa66dff22097912053","2020-04-03T20:00:00Z",35,NA,9619,9619,9619,1,3,0,684,199,883
"3083",20200403,"AR",704,8995,NA,71,105,NA,NA,26,39,60,"A","4/3/2020 16:21","cc6edd41b1349527e6d2c7499972656627f69c60","2020-04-03T20:00:00Z",12,105,9699,9699,9699,5,0,5,1115,61,1176
"3084",20200403,"AS",0,3,2,NA,NA,NA,NA,NA,NA,NA,"","3/30/2020 23:00","b56b53719ad6111ea1982c73cb83f6c0d8855de8","2020-04-03T20:00:00Z",0,NA,5,3,3,60,0,0,0,0,0
"3085",20200403,"AZ",1769,22904,NA,NA,NA,NA,NA,NA,NA,NA,"B","4/3/2020 00:00","940378aae1e23963f9be186131b3c99c0409e0a7","2020-04-03T20:00:00Z",41,NA,24673,24673,24673,4,9,0,1793,171,1964
"3086",20200403,"CA",10701,24599,59500,2188,NA,901,NA,NA,NA,NA,"B","4/2/2020 00:00","70e3b5dd58bca1b77891541196c6d761509b1406","2020-04-03T20:00:00Z",237,NA,94800,35300,35300,6,34,0,790,1510,2300
"3087",20200403,"CO",3728,16683,NA,739,710,NA,NA,NA,NA,NA,"A","4/1/2020 00:00","4c46eda2816a543c6eef637cf32cda8a4c6ca32e","2020-04-03T20:00:00Z",97,710,20411,20411,20411,8,17,90,1380,386,1766
"3088",20200403,"CT",4914,15101,NA,909,NA,NA,NA,NA,NA,NA,"A","4/3/2020 15:30","70a55e453264d436d54fb9a2e343f88f9b6acf36","2020-04-03T20:00:00Z",131,NA,20015,20015,20015,9,19,0,625,1090,1715
"3089",20200403,"DC",757,4827,NA,NA,NA,NA,NA,NA,NA,206,"A","4/3/2020 00:00","3ea285daa9eae202872a1d444f0983e2db2bc4ff","2020-04-03T20:00:00Z",15,NA,5584,5584,5584,11,3,0,410,104,514
"3090",20200403,"DE",450,4995,NA,63,NA,NA,NA,NA,NA,71,"C","4/3/2020 00:00","cb4dfe887862d01431f4cd7bf253c77deb0cc681","2020-04-03T20:00:00Z",14,NA,5445,5445,5445,10,2,0,429,57,486
"3091",20200403,"FL",9585,82137,1225,NA,1287,NA,NA,NA,NA,NA,"A","4/3/2020 11:30","2907c9d11f9d860cd58f5efdab07fdd3d930c23a","2020-04-03T20:00:00Z",163,1287,92947,91722,91722,12,35,164,12851,1575,14426
"3092",20200403,"GA",5831,19434,NA,NA,1158,NA,NA,NA,NA,NA,"A","4/3/2020 11:28","10a2b225c2047201ac723e2f8eb885ea11427862","2020-04-03T20:00:00Z",184,1158,25265,25265,25265,13,21,102,1825,483,2308
"3093",20200403,"GU",84,459,NA,19,NA,2,NA,NA,NA,14,"","4/3/2020 09:45","25c323e727114df3e52243dc57256fd73114f9c7","2020-04-03T20:00:00Z",4,NA,543,543,543,66,1,0,17,2,19
"3094",20200403,"HI",285,10206,NA,NA,15,NA,6,NA,NA,72,"A","4/2/2020 18:00","9fa30a00486ab35051c1c4c1eed762fe877c1015","2020-04-03T20:00:00Z",2,15,10491,10491,10491,15,1,0,0,27,27
"3095",20200403,"IA",699,8754,NA,80,138,NA,NA,NA,NA,188,"C","4/3/2020 16:30","7ec6ebd16a1010f320439420def9566ab267c7c6","2020-04-03T20:00:00Z",11,138,9453,9453,9453,19,0,18,700,85,785
"3096",20200403,"ID",891,7054,NA,NA,56,NA,7,NA,NA,NA,"A","4/2/2020 19:00","e7da8ab9143c8c3161be6301ae79d8f4ef1e2836","2020-04-03T20:00:00Z",9,56,7945,7945,7945,16,0,7,441,222,663
"3097",20200403,"IL",8904,39144,NA,NA,NA,NA,NA,NA,NA,NA,"A","4/3/2020 00:00","0b2cef0dd78d22ac1c8abca15a1b4820f376ab10","2020-04-03T20:00:00Z",210,NA,48048,48048,48048,17,53,0,3183,1209,4392
"3098",20200403,"IN",3437,14398,NA,NA,NA,NA,NA,NA,NA,NA,"B","4/2/2020 23:59","d1821aafae6dc70b91598705334f57816e852905","2020-04-03T20:00:00Z",102,NA,17835,17835,17835,18,24,0,1152,398,1550
"3099",20200403,"KS",620,6454,NA,NA,151,NA,NA,NA,NA,NA,"B","4/3/2020 12:00","9a79bab996650d6230588741c888a7123ae9e692","2020-04-03T20:00:00Z",17,151,7074,7074,7074,20,4,13,395,68,463
"3100",20200403,"KY",770,12034,NA,NA,NA,NA,NA,NA,NA,NA,"A","4/2/2020 17:00","71360df79d4183efe78dbbf74b7f08d20e563df7","2020-04-03T20:00:00Z",31,NA,12804,12804,12804,21,11,0,4814,90,4904
"3101",20200403,"LA",10297,43348,NA,1707,NA,NA,NA,535,NA,NA,"A","4/3/2020 13:00","91fb339619b9cebe5ad540b64030f50d18ed6008","2020-04-03T20:00:00Z",370,NA,53645,53645,53645,22,60,0,1412,1147,2559
"3102",20200403,"MA",10303,52685,NA,NA,966,NA,NA,NA,NA,NA,"B","4/3/2020 12:30","00f02e532d9b4e61f24a257d33891b5c3275589b","2020-04-03T20:00:00Z",265,966,62988,62988,62988,25,36,153,4918,1436,6354
"3103",20200403,"MD",2758,20932,NA,NA,664,NA,NA,NA,NA,159,"A","4/3/2020 10:00","1f1ec05c4dd356e3a5c5f05128171f4edc6668aa","2020-04-03T20:00:00Z",42,664,23690,23690,23690,24,6,82,2042,427,2469
"3104",20200403,"ME",432,6088,NA,NA,75,NA,NA,NA,NA,113,"A","4/3/2020 12:00","ff7ce1cb02ed3bf2b85c24bc2c7f8b6bc59edcd8","2020-04-03T20:00:00Z",9,75,6520,6520,6520,23,2,7,0,56,56
"3105",20200403,"MI",15252,33670,NA,NA,NA,NA,NA,NA,NA,56,"B","4/3/2020 11:00","c166ae553d8969b34d5da144e5365b43525739e7","2020-04-03T20:00:00Z",479,NA,48922,48922,48922,26,62,0,3302,1135,4437
"3106",20200403,"MN",789,23438,NA,86,156,40,40,NA,NA,NA,"A","4/2/2020 17:00","e85961bd1e98dbd903c152397ee2815f260dfcb4","2020-04-03T20:00:00Z",22,156,24227,24227,24227,27,4,18,1786,47,1833
"3107",20200403,"MO",2113,19357,NA,NA,NA,NA,NA,NA,NA,NA,"C","4/3/2020 15:00","24e19de34286327f54180e306b39fc8c56f1ee3e","2020-04-03T20:00:00Z",19,NA,21470,21470,21470,29,0,0,1508,279,1787
"3108",20200403,"MP",8,13,10,NA,NA,NA,NA,NA,NA,NA,"","4/2/2020 18:30","af45c500ab63a0a790b1a8843da8df48052d76cd","2020-04-03T20:00:00Z",1,NA,31,21,21,69,0,0,0,0,0
"3109",20200403,"MS",1358,4753,NA,NA,420,NA,NA,NA,NA,NA,"B","4/2/2020 19:00","ef6d6250f891f2f7b9579b146fce35d95d4adba4","2020-04-03T20:00:00Z",29,420,6111,6111,6111,28,3,60,0,181,181
"3110",20200403,"MT",243,5333,NA,NA,24,NA,NA,NA,NA,NA,"A","4/3/2020 10:00","b74aa36eedee733ed53a9a8a430d7cbc7b8c09be","2020-04-03T20:00:00Z",5,24,5576,5576,5576,30,0,4,240,16,256
"3111",20200403,"NC",2093,29505,NA,184,NA,NA,NA,NA,NA,NA,"A","4/3/2020 13:55","93d44ae84523393ea79d247c465de8d38588b236","2020-04-03T20:00:00Z",19,NA,31598,31598,31598,37,3,0,2683,236,2919
"3112",20200403,"ND",173,5625,NA,NA,29,NA,NA,NA,NA,55,"B","4/3/2020 13:50","c617c2d3b8b1812d6033b1ca56ebbbaed5d4af38","2020-04-03T20:00:00Z",3,29,5798,5798,5798,38,0,1,804,14,818
"3113",20200403,"NE",279,4487,11,NA,NA,NA,NA,NA,NA,NA,"A","4/3/2020 13:50","3e6c4ef3a306e2c09bd10d96400a042076db7c9b","2020-04-03T20:00:00Z",6,NA,4777,4766,4766,31,1,0,509,33,542
"3114",20200403,"NH",479,6575,114,NA,73,NA,NA,NA,NA,101,"B","4/2/2020 09:00","725ffa5c67f3e07c88d4c45f277990868020edd4","2020-04-03T20:00:00Z",5,73,7168,7054,7054,33,1,15,497,64,561
"3115",20200403,"NJ",29895,37608,NA,3016,NA,NA,NA,NA,NA,NA,"A","4/3/2020 13:00","00547937bc069f28878b1304cf91068be67752a3","2020-04-03T20:00:00Z",646,NA,67503,67503,67503,34,109,0,4088,4305,8393
"3116",20200403,"NM",403,14375,NA,31,NA,NA,NA,NA,NA,26,"A","4/2/2020 00:00","4480f4d342f609ad33838dc3d0e03fcf70d15c08","2020-04-03T20:00:00Z",7,NA,14778,14778,14778,35,1,0,727,40,767
"3117",20200403,"NV",1514,13018,NA,NA,NA,NA,NA,NA,NA,NA,"A","4/3/2020 09:30","e7f36731071c8e0ba8e0fc36209cc709f384cb1c","2020-04-03T20:00:00Z",43,NA,14532,14532,14532,32,5,0,430,56,486
"3118",20200403,"NY",102863,157657,NA,14810,23696,3731,NA,NA,NA,8886,"A","4/3/2020 11:00","f6cddb01ff600916147dbbb6fe35cfd9c22409d1","2020-04-03T20:00:00Z",2935,23696,260520,260520,260520,36,562,2879,11073,10482,21555
"3119",20200403,"OH",3312,35063,NA,NA,895,NA,288,NA,NA,NA,"B","4/3/2020 14:00","ea2bf2d723b66735545196a364c30165eee97d02","2020-04-03T20:00:00Z",91,895,38375,38375,38375,39,10,93,3047,410,3457
"3120",20200403,"OK",988,1315,NA,171,289,123,NA,NA,NA,383,"B","4/3/2020 08:00","4481825db7c63f757ee00835b2c09f076307d233","2020-04-03T20:00:00Z",38,289,2303,2303,2303,40,4,32,50,109,159
"3121",20200403,"OR",899,16535,NA,188,204,NA,NA,38,NA,NA,"A","4/2/2020 11:00","34d839252b2282b116ff49e00d7eb13c4060177d","2020-04-03T20:00:00Z",22,204,17434,17434,17434,41,1,16,1276,73,1349
"3122",20200403,"PA",8420,53695,NA,NA,852,NA,NA,NA,NA,NA,"A","4/3/2020 12:00","a87c583c1d2866402e86cb8f73bb2374359a6405","2020-04-03T20:00:00Z",102,852,62115,62115,62115,42,12,122,5997,1404,7401
"3123",20200403,"PR",378,2049,1055,NA,NA,NA,NA,NA,NA,NA,"A","4/3/2020 07:00","555f417361ab7c27ef5ec784794386a274013bdc","2020-04-03T20:00:00Z",15,NA,3482,2427,2427,72,3,0,445,62,507
"3124",20200403,"RI",709,4857,NA,77,NA,14,NA,6,NA,35,"B","4/3/2020 00:00","409a564b5aa4780b7d370f68c953eeb062d20e17","2020-04-03T20:00:00Z",14,NA,5566,5566,5566,44,2,0,445,52,497
"3125",20200403,"SC",1554,5441,NA,NA,241,NA,NA,NA,NA,NA,"B","4/2/2020 16:04","c18630a791c321f250b23352788afcea760d128c","2020-04-03T20:00:00Z",31,241,6995,6995,6995,45,0,0,0,0,0
"3126",20200403,"SD",187,4593,3,NA,17,NA,NA,NA,NA,69,"A","4/3/2020 13:21","2bf2b04a61596cfe07afd86eeaf0d8a43e9f51ad","2020-04-03T20:00:00Z",2,17,4783,4780,4780,46,0,0,376,22,398
"3127",20200403,"TN",3067,34772,NA,NA,293,NA,NA,NA,NA,248,"A","4/3/2020 15:00","39a4b9e9df186bdfeb4584f465c3f08adcac8a33","2020-04-03T20:00:00Z",37,293,37839,37839,37839,47,5,30,3006,222,3228
"3128",20200403,"TX",5330,50434,NA,196,NA,NA,NA,NA,NA,38,"A","4/2/2020 21:00","f87fe9a1e7e04e6840c7f1e73155acf02fb15641","2020-04-03T20:00:00Z",90,NA,55764,55764,55764,48,20,0,4424,661,5085
"3129",20200403,"UT",1246,23002,NA,NA,106,NA,NA,NA,NA,NA,"A","4/3/2020 15:00","63718cc39c1d610a71612f7c5268dc0dff45c303","2020-04-03T20:00:00Z",7,106,24248,24248,24248,49,0,6,2847,172,3019
"3130",20200403,"VA",2012,16993,NA,NA,312,NA,145,NA,108,NA,"A","4/3/2020 09:00","cebef7f2e5854ef18f29e34e8334e3c7c5b70bb3","2020-04-03T20:00:00Z",46,312,19005,19005,19005,51,5,7,1110,306,1416
"3131",20200403,"VI",38,154,56,NA,NA,NA,NA,NA,NA,29,"","4/3/2020 14:30","5248eed22be0ebaa00fd5240915ef781ea4fab0d","2020-04-03T20:00:00Z",NA,NA,248,192,192,78,0,0,5,5,10
"3132",20200403,"VT",460,4865,NA,29,45,NA,NA,NA,NA,15,"A","4/3/2020 00:00","fa9604efa4096144b5fca392dd331240bee73b64","2020-04-03T20:00:00Z",17,45,5325,5325,5325,50,0,0,481,70,551
"3133",20200403,"WA",8167,91398,NA,NA,NA,NA,NA,NA,NA,NA,"A","4/3/2020 00:00","fd1653e8804fbd37a992967f6eb06ad4b79cf576","2020-04-03T20:00:00Z",338,NA,99565,99565,99565,53,28,0,4361,409,4770
"3134",20200403,"WI",1912,22377,NA,NA,487,NA,NA,NA,NA,NA,"A","4/3/2020 04:00","528a51f36f9758064adfb4e3157dd3d26afdee45","2020-04-03T20:00:00Z",37,487,24289,24289,24289,55,6,26,2060,182,2242
"3135",20200403,"WV",237,6130,NA,NA,1,NA,NA,NA,NA,NA,"B","4/3/2020 10:00","04a4990baf9d1384f71c86e4fb6b56e27fab5d1c","2020-04-03T20:00:00Z",2,1,6367,6367,6367,54,0,0,854,20,874
"3136",20200403,"WY",162,2704,NA,NA,21,NA,NA,NA,NA,37,"A","4/3/2020 10:42","1bbecda6c7080afe8943746787c0f2a296071fd9","2020-04-03T20:00:00Z",0,21,2866,2866,2866,56,0,2,265,12,277
"3137",20200402,"AK",143,4879,NA,NA,9,NA,NA,NA,NA,NA,"A","4/1/2020 21:00","3f21e74fd58b00709088e8f3ebda6e59b11fc8e2","2020-04-02T20:00:00Z",3,9,5022,5022,5022,2,0,0,409,10,419
"3138",20200402,"AL",1233,7503,NA,NA,NA,NA,NA,NA,NA,NA,"B","4/2/2020 00:00","3b7e06a8f363841e0c01239ec822fb61543caa33","2020-04-02T20:00:00Z",32,NA,8736,8736,8736,1,6,0,806,156,962
"3139",20200402,"AR",643,7880,NA,66,100,NA,NA,23,32,47,"A","4/2/2020 14:45","d331f5f5e770b8b51a1388a4dd4b261bbbf02a01","2020-04-02T20:00:00Z",12,100,8523,8523,8523,5,2,10,526,59,585
"3140",20200402,"AS",0,3,2,NA,NA,NA,NA,NA,NA,NA,"","3/30/2020 23:00","4a0b54b6fd75224215a0745b907cf10bf0420566","2020-04-02T20:00:00Z",0,NA,5,3,3,60,0,0,0,0,0
"3141",20200402,"AZ",1598,21111,NA,NA,NA,NA,NA,NA,NA,NA,"B","4/2/2020 00:00","a443098b8ef46df52b605793abe87f6ad32e447f","2020-04-02T20:00:00Z",32,NA,22709,22709,22709,4,3,0,1466,185,1651
"3142",20200402,"CA",9191,23809,59500,1922,NA,816,NA,NA,NA,NA,"B","4/2/2020 00:00","e32c6484d57e7ce980f2b142c2f09bac97c8c3f4","2020-04-02T20:00:00Z",203,NA,92500,33000,33000,6,32,0,2037,1036,3073
"3143",20200402,"CO",3342,15303,NA,698,620,NA,NA,NA,NA,NA,"A","3/31/2020 00:00","89d4228ab9a9581fc072c8b3966f2f5be9605a19","2020-04-02T20:00:00Z",80,620,18645,18645,18645,8,11,111,1420,376,1796
"3144",20200402,"CT",3824,14476,NA,827,NA,NA,NA,NA,NA,NA,"A","4/2/2020 15:30","29e52fee167c28a28673ac46c91b95269c6c068e","2020-04-02T20:00:00Z",112,NA,18300,18300,18300,9,27,0,1433,267,1700
"3145",20200402,"DC",653,4417,NA,NA,NA,NA,NA,NA,NA,173,"A","4/2/2020 09:00","d846ba02f109239c2e826e9af339d1de139b9890","2020-04-02T20:00:00Z",12,NA,5070,5070,5070,11,1,0,1155,67,1222
"3146",20200402,"DE",393,4566,NA,56,NA,NA,NA,NA,NA,49,"C","4/2/2020 16:45","4eecaba5f7d492c15722e254d4a46aa30407e645","2020-04-02T20:00:00Z",12,NA,4959,4959,4959,10,1,0,551,25,576
"3147",20200402,"FL",8010,69286,1285,NA,1123,NA,NA,NA,NA,NA,"A","4/2/2020 11:01","fbe2876a05e4aef34393ca2bd0cb28205b2f00b4","2020-04-02T20:00:00Z",128,1123,78581,77296,77296,12,41,174,9757,1055,10812
"3148",20200402,"GA",5348,17609,NA,NA,1056,NA,NA,NA,NA,NA,"A","4/2/2020 11:28","9f53d712173ccf962160a10135bf4e8a093f07b5","2020-04-02T20:00:00Z",163,1056,22957,22957,22957,13,24,104,1921,710,2631
"3149",20200402,"GU",82,442,NA,19,NA,2,NA,NA,NA,12,"","4/2/2020 08:30","7ddc2bd518463a6e94555e447d144d3ad4078bc4","2020-04-02T20:00:00Z",3,NA,524,524,524,66,0,0,36,5,41
"3150",20200402,"HI",258,10206,NA,NA,15,NA,6,NA,NA,69,"A","4/1/2020 18:00","064f2535c7eac6f34e7463f011a9259e2ad9ae7b","2020-04-02T20:00:00Z",1,15,10464,10464,10464,15,0,2,1485,50,1535
"3151",20200402,"IA",614,8054,NA,74,120,NA,NA,NA,NA,46,"C","4/2/2020 00:00","171800a2c36f1b97fb3c6bda5d89bde27e047b80","2020-04-02T20:00:00Z",11,120,8668,8668,8668,19,2,21,750,65,815
"3152",20200402,"ID",669,6613,NA,NA,49,NA,7,NA,NA,NA,"A","4/1/2020 19:00","d76518f393192a28bb5bf7b3bc02107669ab7597","2020-04-02T20:00:00Z",9,49,7282,7282,7282,16,0,3,537,144,681
"3153",20200402,"IL",7695,35961,NA,NA,NA,NA,NA,NA,NA,NA,"A","4/2/2020 00:00","7bfa50c82e9cadbd97ea93ad51ac207aeae11b5c","2020-04-02T20:00:00Z",157,NA,43656,43656,43656,17,16,0,2557,715,3272
"3154",20200402,"IN",3039,13246,NA,NA,NA,NA,NA,NA,NA,NA,"B","4/1/2020 23:59","859cdd019fe61ad8a48a9cb5208227e707f34bef","2020-04-02T20:00:00Z",78,NA,16285,16285,16285,18,13,0,1436,474,1910
"3155",20200402,"KS",552,6059,NA,NA,138,NA,NA,NA,NA,NA,"B","4/2/2020 12:00","05c6523583718e789d65e9d7b19ee251b9145bf2","2020-04-02T20:00:00Z",13,138,6611,6611,6611,20,3,24,648,70,718
"3156",20200402,"KY",680,7220,NA,NA,NA,NA,NA,NA,NA,NA,"A","4/1/2020 17:00","f64f6dc1cd1cc7cb81f8585de7351d08722c2113","2020-04-02T20:00:00Z",20,NA,7900,7900,7900,21,3,0,255,89,344
"3157",20200402,"LA",9150,41936,NA,1639,NA,NA,NA,507,NA,NA,"A","4/2/2020 13:00","072fc59f253ae1d4d41cc04ef94727dc761b6edd","2020-04-02T20:00:00Z",310,NA,51086,51086,51086,22,37,0,2584,2726,5310
"3158",20200402,"MA",8867,47767,NA,NA,813,NA,NA,NA,NA,NA,"B","4/2/2020 16:00","52a48fa52d46911b39824b7e5ecc002cdfcd83b5","2020-04-02T20:00:00Z",229,813,56634,56634,56634,25,42,131,3642,1228,4870
"3159",20200402,"MD",2331,18890,NA,NA,582,NA,NA,NA,NA,81,"A","4/2/2020 10:00","39f8d4438aafec71e5a2fcc8660fc310d7f29a16","2020-04-02T20:00:00Z",36,582,21221,21221,21221,24,5,60,1657,346,2003
"3160",20200402,"ME",376,6088,NA,NA,68,NA,NA,NA,NA,94,"A","4/2/2020 10:00","2122936ed43bb34b5d6514923716d4e6b7a3608e","2020-04-02T20:00:00Z",7,68,6464,6464,6464,23,0,5,0,32,32
"3161",20200402,"MI",14117,30368,NA,NA,NA,NA,NA,NA,NA,NA,"B","4/2/2020 11:00","f0064a3912bc78f616a0e7cabf175ad52168fe60","2020-04-02T20:00:00Z",417,NA,44485,44485,44485,26,80,0,3131,1229,4360
"3162",20200402,"MN",742,21652,NA,75,138,38,38,NA,NA,NA,"A","4/2/2020 12:00","bfcb97db7faf170c44a2dc19c18d62bfe3ac9924","2020-04-02T20:00:00Z",18,138,22394,22394,22394,27,1,16,1150,53,1203
"3163",20200402,"MO",1834,17849,NA,NA,NA,NA,NA,NA,NA,NA,"C","4/2/2020 15:00","9b46daae56bf71b2388a694c6f38371cd9539e66","2020-04-02T20:00:00Z",19,NA,19683,19683,19683,29,1,0,2003,253,2256
"3164",20200402,"MP",8,13,12,NA,NA,NA,NA,NA,NA,NA,"","4/2/2020 03:00","d262dee2db5a69a5af72b3e987d1b6d7d3a68dbb","2020-04-02T20:00:00Z",1,NA,33,21,21,69,1,0,13,2,15
"3165",20200402,"MS",1177,4753,NA,NA,360,NA,NA,NA,NA,NA,"B","4/1/2020 19:00","c9ea4548a472a931f7884718a7d20712be4a668d","2020-04-02T20:00:00Z",26,360,5930,5930,5930,28,4,28,1041,104,1145
"3166",20200402,"MT",227,5093,NA,NA,20,NA,NA,NA,NA,NA,"A","4/2/2020 10:00","7310cab2ca40b5c5f4095ba313ef3e1d84afd3f9","2020-04-02T20:00:00Z",5,20,5320,5320,5320,30,0,3,383,19,402
"3167",20200402,"NC",1857,26822,NA,184,NA,NA,NA,NA,NA,NA,"A","4/2/2020 14:00","43f561371ad0486d793604e795e7ae264c086ac3","2020-04-02T20:00:00Z",16,NA,28679,28679,28679,37,6,0,2163,273,2436
"3168",20200402,"ND",159,4821,NA,NA,28,NA,NA,NA,NA,43,"B","4/2/2020 12:56","ab24e7c794ddd424ba7f7ac8552c2bedfa5fe693","2020-04-02T20:00:00Z",3,28,4980,4980,4980,38,0,5,470,17,487
"3169",20200402,"NE",246,3978,11,NA,NA,NA,NA,NA,NA,NA,"A","4/2/2020 14:00","7425b5da1252c2d80bbfbcac3918ca2f56b69b7c","2020-04-02T20:00:00Z",5,NA,4235,4224,4224,31,1,0,503,36,539
"3170",20200402,"NH",415,6078,126,NA,58,NA,NA,NA,NA,91,"B","4/1/2020 09:00","7ff4d43b0df330efc4a0a1156547889052412ff0","2020-04-02T20:00:00Z",4,58,6619,6493,6493,33,0,2,93,0,93
"3171",20200402,"NJ",25590,33520,NA,2000,NA,NA,NA,NA,NA,NA,"A","4/2/2020 13:00","7505425d3c40f9b2cbcb2463390ea5f85f2d3ef1","2020-04-02T20:00:00Z",537,NA,59110,59110,59110,34,182,0,3133,3335,6468
"3172",20200402,"NM",363,13648,NA,31,NA,NA,NA,NA,NA,26,"A","4/1/2020 00:00","79c008380ad9de38f806cf5517f7d9ae025e387c","2020-04-02T20:00:00Z",6,NA,14011,14011,14011,35,1,0,723,48,771
"3173",20200402,"NV",1458,12588,NA,NA,NA,NA,NA,NA,NA,NA,"A","4/2/2020 09:30","724e9318ff31af91a700769aaf3bb738503e33f0","2020-04-02T20:00:00Z",38,NA,14046,14046,14046,32,12,0,1069,179,1248
"3174",20200402,"NY",92381,146584,NA,13383,20817,3396,NA,NA,NA,7434,"A","4/2/2020 11:45","775f76625647df1623092ee21c45edb479690b22","2020-04-02T20:00:00Z",2373,20817,238965,238965,238965,36,432,2449,9416,8669,18085
"3175",20200402,"OH",2902,32016,NA,NA,802,NA,260,NA,NA,NA,"B","4/2/2020 14:00","7e843cc7d061c4b7e7fedf31a9175b49230e4aea","2020-04-02T20:00:00Z",81,802,34918,34918,34918,39,16,123,5024,355,5379
"3176",20200402,"OK",879,1265,NA,182,257,144,NA,NA,NA,NA,"B","4/1/2020 08:00","3b06c6184cccbf4b151c5e9ba233d24116cb11a1","2020-04-02T20:00:00Z",34,257,2144,2144,2144,40,4,38,17,160,177
"3177",20200402,"OR",826,15259,NA,134,188,NA,NA,38,NA,NA,"A","4/1/2020 11:00","594e3d6e968a4203f472ba01f13a1cbb4dd1008d","2020-04-02T20:00:00Z",21,188,16085,16085,16085,41,3,34,2123,90,2213
"3178",20200402,"PA",7016,47698,NA,NA,730,NA,NA,NA,NA,NA,"A","4/2/2020 12:00","6db8179f31ce01e09fe60c7f9e80e26a41a12e15","2020-04-02T20:00:00Z",90,730,54714,54714,54714,42,16,110,5271,1211,6482
"3179",20200402,"PR",316,1604,1119,NA,NA,NA,NA,NA,NA,NA,"A","4/2/2020 07:00","7151e39f7c099534614525db075cfcb1503885be","2020-04-02T20:00:00Z",12,NA,3039,1920,1920,72,1,0,195,30,225
"3180",20200402,"RI",657,4412,NA,72,NA,14,NA,6,NA,35,"B","4/2/2020 00:00","179ed889c9888cfb4e7bbddfc538a9e29954e420","2020-04-02T20:00:00Z",12,NA,5069,5069,5069,44,2,0,581,91,672
"3181",20200402,"SC",1554,5441,NA,NA,241,NA,NA,NA,NA,NA,"B","4/2/2020 16:04","a2ada36eced02ef0f45b0577176f8b9b9e8c8c1b","2020-04-02T20:00:00Z",31,241,6995,6995,6995,45,5,139,408,261,669
"3182",20200402,"SD",165,4217,0,NA,17,NA,NA,NA,NA,57,"A","4/1/2020 18:00","4be9dfc1b6a6df08ee4bfefd338de9d939470c30","2020-04-02T20:00:00Z",2,17,4382,4382,4382,46,0,5,314,36,350
"3183",20200402,"TN",2845,31766,NA,NA,263,NA,NA,NA,NA,220,"A","4/2/2020 15:00","298d2f4a6c07d4bdf93bab1c86f3354ac8a38023","2020-04-02T20:00:00Z",32,263,34611,34611,34611,47,8,63,1997,162,2159
"3184",20200402,"TX",4669,46010,NA,196,NA,NA,NA,NA,NA,38,"A","4/1/2020 21:00","f456c71263d60aed1ff80f3a4195def2693e258b","2020-04-02T20:00:00Z",70,NA,50679,50679,50679,48,12,0,2150,672,2822
"3185",20200402,"UT",1074,20155,NA,NA,100,NA,NA,NA,NA,NA,"A","4/2/2020 15:00","705e740bf7ad80fd5b0e38fe7cbf65ff486df0fd","2020-04-02T20:00:00Z",7,100,21229,21229,21229,49,0,9,0,62,62
"3186",20200402,"VA",1706,15883,NA,246,305,NA,145,NA,108,NA,"A","4/2/2020 09:00","ff13ca0c32dc298e552fa7eee8a27cf0bf129da7","2020-04-02T20:00:00Z",41,305,17589,17589,17589,51,7,0,2023,222,2245
"3187",20200402,"VI",33,149,42,NA,NA,NA,NA,NA,NA,25,"","4/2/2020 09:30","f1c9599204060635e564aa0a73e78f885de792ec","2020-04-02T20:00:00Z",NA,NA,224,182,182,78,0,0,23,3,26
"3188",20200402,"VT",390,4384,NA,29,45,NA,NA,NA,NA,15,"A","4/2/2020 00:00","f6d171f53ff3ce590818f5166c3fa507dce2bcf5","2020-04-02T20:00:00Z",17,45,4774,4774,4774,50,1,0,222,31,253
"3189",20200402,"WA",7758,87037,NA,NA,NA,NA,NA,NA,NA,NA,"A","4/2/2020 00:00","57c30052f5949b5a4d65369ee5c37140ffa62ae9","2020-04-02T20:00:00Z",310,NA,94795,94795,94795,53,28,0,4422,404,4826
"3190",20200402,"WI",1730,20317,NA,NA,461,NA,NA,NA,NA,NA,"A","4/2/2020 16:00","1bc4bf65120357c73e5c47ed1139a762a2c523af","2020-04-02T20:00:00Z",31,461,22047,22047,22047,55,7,63,1498,180,1678
"3191",20200402,"WV",217,5276,NA,NA,1,NA,NA,NA,NA,NA,"B","4/2/2020 00:17","3a14cf4894fb724bf552dbd5c57fb026ba1a2a4b","2020-04-02T20:00:00Z",2,1,5493,5493,5493,54,1,0,892,26,918
"3192",20200402,"WY",150,2439,NA,NA,19,NA,NA,NA,NA,31,"A","4/2/2020 10:30","7da49893b68f8346d922f1789daa6867adbf0e45","2020-04-02T20:00:00Z",0,19,2589,2589,2589,56,0,1,221,20,241
"3193",20200401,"AK",133,4470,NA,NA,9,NA,NA,NA,NA,NA,"A","3/31/2020 19:00","d31552858f80a7eaa2bad29d9289576c3ca106a8","2020-04-01T20:00:00Z",3,9,4603,4603,4603,2,0,2,876,14,890
"3194",20200401,"AL",1077,6697,NA,NA,NA,NA,NA,NA,NA,NA,"B","4/1/2020 00:00","9380594fd805d6915d7c8ff8f1fb8d0ebcad8338","2020-04-01T20:00:00Z",26,NA,7774,7774,7774,1,13,0,399,96,495
"3195",20200401,"AR",584,7354,NA,56,90,NA,NA,25,32,42,"A","4/1/2020 13:26","96ad1681cf748791eec1cdf89ef5358887582295","2020-04-01T20:00:00Z",10,90,7938,7938,7938,5,2,90,1395,61,1456
"3196",20200401,"AS",0,3,2,NA,NA,NA,NA,NA,NA,NA,"","3/30/2020 23:00","e36331f6d7284d24e1d06bf8f91f76e577ac99bd","2020-04-01T20:00:00Z",0,NA,5,3,3,60,0,0,0,0,0
"3197",20200401,"AZ",1413,19645,NA,NA,NA,NA,NA,NA,NA,NA,"B","4/1/2020 00:00","743ac005342b7e9097fa953cc61bb7318432e3ca","2020-04-01T20:00:00Z",29,NA,21058,21058,21058,4,5,0,1563,124,1687
"3198",20200401,"CA",8155,21772,57400,1855,NA,774,NA,NA,NA,NA,"B","3/31/2020 00:00","880b8d3b4dd1ca8075dd9dc3b2add9938935d595","2020-04-01T20:00:00Z",171,NA,87327,29927,29927,6,18,0,0,673,673
"3199",20200401,"CO",2966,13883,NA,574,509,NA,NA,NA,NA,NA,"A","3/30/2020 00:00","f99c45d719631d1b12609e085b6e4675acb60616","2020-04-01T20:00:00Z",69,509,16849,16849,16849,8,18,95,1146,339,1485
"3200",20200401,"CT",3557,13043,NA,766,NA,NA,NA,NA,NA,NA,"A","4/1/2020 13:30","152ce443f66c465aa76d50e3315db2993a91f9bb","2020-04-01T20:00:00Z",85,NA,16600,16600,16600,9,16,0,14,429,443
"3201",20200401,"DC",586,3262,2,NA,NA,NA,NA,NA,NA,142,"A","3/31/2020 21:24","50151cafe100c69ce4ccbe31924f268747a1191c","2020-04-01T20:00:00Z",11,NA,3850,3848,3848,11,2,0,0,91,91
"3202",20200401,"DE",368,4015,NA,51,NA,NA,NA,NA,NA,49,"C","4/1/2020 12:30","482d0d703ed3a489c47a2b0c1ec23b05ab5cc346","2020-04-01T20:00:00Z",11,NA,4383,4383,4383,10,1,0,319,49,368
"3203",20200401,"FL",6955,59529,1235,NA,949,NA,NA,NA,NA,NA,"A","4/1/2020 11:30","c0c3c4480b268bc84e4ff54821b2ea1bb475fc64","2020-04-01T20:00:00Z",87,949,67719,66484,66484,12,10,126,5244,617,5861
"3204",20200401,"GA",4638,15688,NA,NA,952,NA,NA,NA,NA,NA,"A","4/1/2020 11:28","564b00e162245b1ca203aaf4cbf881ca89d8d3a0","2020-04-01T20:00:00Z",139,952,20326,20326,20326,13,28,119,3436,709,4145
"3205",20200401,"GU",77,406,NA,19,NA,2,NA,NA,NA,9,"","4/1/2020 08:30","ec5d82975cf501c674c2b0f945d76fcf22d57f2d","2020-04-01T20:00:00Z",3,NA,483,483,483,66,1,0,35,8,43
"3206",20200401,"HI",208,8721,NA,NA,13,NA,6,NA,NA,58,"A","3/31/2020 18:00","14a35e53864a84ba0531e35f19147ff09691cf8a","2020-04-01T20:00:00Z",1,13,8929,8929,8929,15,1,1,250,4,254
"3207",20200401,"IA",549,7304,NA,63,99,NA,NA,NA,NA,118,"C","4/1/2020 14:40","8828795bcc8edb2b650530734afbf76dedd9b73f","2020-04-01T20:00:00Z",9,99,7853,7853,7853,19,2,5,416,52,468
"3208",20200401,"ID",525,6076,NA,NA,46,NA,7,NA,NA,NA,"A","3/31/2020 19:00","1856fc33d76ed1fe3bbd2b2aa00f1d9fe145a77c","2020-04-01T20:00:00Z",9,46,6601,6601,6601,16,2,1,779,110,889
"3209",20200401,"IL",6980,33404,NA,NA,NA,NA,NA,NA,NA,NA,"A","4/1/2020 02:00","c9425c7ede2a3fc33ef303093f389025e28f80f2","2020-04-01T20:00:00Z",141,NA,40384,40384,40384,17,42,0,4173,986,5159
"3210",20200401,"IN",2565,11810,NA,NA,NA,NA,NA,NA,NA,NA,"B","4/1/2020 00:59","0d32c4eb618bf0bf80237541f05df7ee301bcfd2","2020-04-01T20:00:00Z",65,NA,14375,14375,14375,18,16,0,596,406,1002
"3211",20200401,"KS",482,5411,NA,NA,114,NA,NA,NA,NA,NA,"B","4/1/2020 11:00","61319fe7179d606c6e16191ab239be098d78602f","2020-04-01T20:00:00Z",10,114,5893,5893,5893,20,1,35,415,54,469
"3212",20200401,"KY",591,6965,NA,NA,NA,NA,NA,NA,NA,NA,"A","3/31/2020 17:00","1a5cb88298d45c1fa2b5ba405b4f50a7a4af73db","2020-04-01T20:00:00Z",17,NA,7556,7556,7556,21,6,0,635,111,746
"3213",20200401,"LA",6424,39352,NA,1498,NA,NA,NA,490,NA,NA,"A","4/1/2020 13:00","58885ad06e0c1bb6f19199017d5f0524a1d61b65","2020-04-01T20:00:00Z",273,NA,45776,45776,45776,22,34,0,5622,1187,6809
"3214",20200401,"MA",7639,44125,NA,NA,682,NA,NA,NA,NA,NA,"B","3/31/2020 12:30","384d6254ade5e885ae52455cef3d91bacc5f3cc4","2020-04-01T20:00:00Z",187,682,51764,51764,51764,25,34,120,3685,1118,4803
"3215",20200401,"MD",1985,17233,NA,NA,522,NA,NA,NA,NA,NA,"A","4/1/2020 10:00","f7b80ecc2acfbe61289a29d1a603fbe418c5fe86","2020-04-01T20:00:00Z",31,522,19218,19218,19218,24,13,93,2365,325,2690
"3216",20200401,"ME",344,6088,NA,NA,63,NA,NA,NA,NA,80,"A","4/1/2020 11:00","8d983aa0d19decc3071a7a7ded16ea055f21dc54","2020-04-01T20:00:00Z",7,63,6432,6432,6432,23,2,6,0,41,41
"3217",20200401,"MI",12888,27237,NA,NA,NA,NA,NA,NA,NA,NA,"B","4/1/2020 16:00","f110081a6ddcde598a9b05cfb01140510f89b119","2020-04-01T20:00:00Z",337,NA,40125,40125,40125,26,78,0,3258,1013,4271
"3218",20200401,"MN",689,20502,NA,54,122,27,27,NA,NA,NA,"A","4/1/2020 12:00","d3f794797d9b10bbf91740a7fbfca3beb9575a65","2020-04-01T20:00:00Z",17,122,21191,21191,21191,27,5,10,1351,60,1411
"3219",20200401,"MO",1581,15846,NA,NA,NA,NA,NA,NA,NA,NA,"C","4/1/2020 15:00","eb21c196ff9fdf675f025aea2567d53c1c2fbc28","2020-04-01T20:00:00Z",18,NA,17427,17427,17427,29,4,0,1232,254,1486
"3220",20200401,"MP",6,NA,NA,NA,NA,NA,NA,NA,NA,NA,"","3/31/2020 21:50","f77ac94600fd74b12b7e1a4ce1960f81653e78a3","2020-04-01T20:00:00Z",NA,NA,6,6,6,69,0,0,0,4,4
"3221",20200401,"MS",1073,3712,NA,NA,332,NA,NA,NA,NA,NA,"B","3/31/2020 19:00","a983393e324c3f0954e1a1039ddfa386071e7cdb","2020-04-01T20:00:00Z",22,332,4785,4785,4785,28,2,121,175,136,311
"3222",20200401,"MT",208,4710,NA,NA,17,NA,NA,NA,NA,NA,"A","4/1/2020 10:00","12ce187899e98d0eb42158307b5267d3aaaf216f","2020-04-01T20:00:00Z",5,17,4918,4918,4918,30,1,3,476,24,500
"3223",20200401,"NC",1584,24659,NA,204,NA,NA,NA,NA,NA,NA,"A","4/1/2020 11:00","8ddbb88d02bcd0607b48747e1c9a3401d53bd1e7","2020-04-01T20:00:00Z",10,NA,26243,26243,26243,37,2,0,3051,86,3137
"3224",20200401,"ND",142,4351,NA,NA,23,NA,NA,NA,NA,34,"B","4/1/2020 12:00","d18580f006b6df087def17405e2268718e5b9510","2020-04-01T20:00:00Z",3,23,4493,4493,4493,38,0,2,220,16,236
"3225",20200401,"NE",210,3475,8,NA,NA,NA,NA,NA,NA,NA,"A","4/1/2020 14:00","95c1465715bea3b1968ac22d6f4e09781a3fe918","2020-04-01T20:00:00Z",4,NA,3693,3685,3685,31,1,0,544,38,582
"3226",20200401,"NH",415,5985,97,NA,56,NA,NA,NA,NA,56,"B","4/1/2020 09:00","d1e7d5f30caf6f06247c95ff7c698dfb3c229562","2020-04-01T20:00:00Z",4,56,6497,6400,6400,33,1,11,572,101,673
"3227",20200401,"NJ",22255,30387,NA,2000,NA,NA,NA,NA,NA,NA,"A","4/1/2020 13:00","ac961a85b57ce49697bca058ea777a1aefc800d7","2020-04-01T20:00:00Z",355,NA,52642,52642,52642,34,88,0,3310,3559,6869
"3228",20200401,"NM",315,12925,NA,24,NA,NA,NA,NA,NA,26,"A","3/31/2020 22:22","63a7ec036420ea2cd077deae2589ca9460a755b6","2020-04-01T20:00:00Z",5,NA,13240,13240,13240,35,1,0,679,34,713
"3229",20200401,"NV",1279,11519,NA,NA,NA,NA,NA,NA,NA,NA,"A","4/1/2020 09:30","c055b4acec7a822c5d9cd244cd79dde729bbdfba","2020-04-01T20:00:00Z",26,NA,12798,12798,12798,32,9,0,838,166,1004
"3230",20200401,"NY",83712,137168,NA,12226,18368,3022,NA,NA,NA,6142,"A","4/1/2020 12:00","1d614a1bcdaa1c82f46f20e84886028b578bdf1d","2020-04-01T20:00:00Z",1941,18368,220880,220880,220880,36,391,2464,7777,7917,15694
"3231",20200401,"OH",2547,26992,NA,NA,679,NA,222,NA,NA,NA,"B","4/1/2020 14:00","2bbe08e56a0239bac5b3ae9941c7ba8dd312e27d","2020-04-01T20:00:00Z",65,679,29539,29539,29539,39,10,94,0,348,348
"3232",20200401,"OK",719,1248,NA,174,219,98,NA,NA,NA,NA,"B","4/1/2020 08:00","be1b8240ff4bbf03606e07d6d6b9576352b5a6c1","2020-04-01T20:00:00Z",30,219,1967,1967,1967,40,7,42,19,154,173
"3233",20200401,"OR",736,13136,NA,132,154,NA,NA,40,NA,NA,"A","3/31/2020 11:00","2607d640e6726f51c2bc905697b3cf934a0ffdf2","2020-04-01T20:00:00Z",18,154,13872,13872,13872,41,0,0,0,46,46
"3234",20200401,"PA",5805,42427,NA,NA,620,NA,NA,NA,NA,NA,"A","4/1/2020 12:00","084361b60c663b53f4e397baf3e1333964a6ec16","2020-04-01T20:00:00Z",74,620,48232,48232,48232,42,11,106,4782,962,5744
"3235",20200401,"PR",286,1409,897,NA,NA,NA,NA,NA,NA,NA,"A","4/1/2020 07:00","c4e269fb6e3a057d674fb76b7dd3a7407e505323","2020-04-01T20:00:00Z",11,NA,2592,1695,1695,72,3,0,214,47,261
"3236",20200401,"RI",566,3831,NA,60,NA,14,NA,6,NA,35,"B","4/1/2020 00:00","7cfe4838ffdd06a9cc439893c127496570023d1f","2020-04-01T20:00:00Z",10,NA,4397,4397,4397,44,2,0,355,77,432
"3237",20200401,"SC",1293,5033,NA,NA,102,NA,NA,NA,NA,NA,"B","4/1/2020 15:55","e68c77efe106b2d20baaea8a64b05aabec2e92f4","2020-04-01T20:00:00Z",26,102,6326,6326,6326,45,4,0,417,210,627
"3238",20200401,"SD",129,3903,0,NA,12,NA,NA,NA,NA,51,"A","4/1/2020 12:30","c2ac95f21992ae965926e02375bef99f46c2309a","2020-04-01T20:00:00Z",2,12,4032,4032,4032,46,1,0,294,21,315
"3239",20200401,"TN",2683,29769,NA,NA,200,NA,NA,NA,NA,137,"A","4/1/2020 15:00","13b42a28c4d8451ddd5df60f57662cb411584544","2020-04-01T20:00:00Z",24,200,32452,32452,32452,47,1,25,4648,444,5092
"3240",20200401,"TX",3997,43860,NA,196,NA,NA,NA,NA,NA,38,"A","3/31/2020 21:00","b46e747cecd02ee1955bde8adb6bfa7edc1a27f2","2020-04-01T20:00:00Z",58,NA,47857,47857,47857,48,17,0,4134,731,4865
"3241",20200401,"UT",1012,20155,NA,NA,91,NA,NA,NA,NA,NA,"A","4/1/2020 15:00","e652fbc718c08c3bb23838503e3ca82a77e41e4c","2020-04-01T20:00:00Z",7,91,21167,21167,21167,49,2,18,2529,125,2654
"3242",20200401,"VA",1484,13860,NA,NA,305,NA,145,NA,108,NA,"A","4/1/2020 13:00","7cb5ae2ffb827a8b27a70a781555ff288f941c89","2020-04-01T20:00:00Z",34,305,15344,15344,15344,51,7,140,1709,234,1943
"3243",20200401,"VI",30,126,24,NA,NA,NA,NA,NA,NA,21,"","3/31/2020 17:00","004e568ad1624976962830fabce284332646b9c7","2020-04-01T20:00:00Z",NA,NA,180,156,156,78,0,0,0,0,0
"3244",20200401,"VT",359,4162,NA,30,45,NA,NA,NA,NA,15,"A","4/1/2020 00:00","87a7bfbb4b0ed7f6b444638bf15843dc5f35ae73","2020-04-01T20:00:00Z",16,45,4521,4521,4521,50,3,9,213,39,252
"3245",20200401,"WA",7354,82615,NA,NA,NA,NA,NA,NA,NA,NA,"A","4/1/2020 00:00","94fb160fdd3bb67520d37a3e4b5f26fd9936bd6b","2020-04-01T20:00:00Z",282,NA,89969,89969,89969,53,20,0,4212,446,4658
"3246",20200401,"WI",1550,18819,NA,NA,398,NA,NA,NA,NA,NA,"A","4/1/2020 16:00","51a4ffd9eb9f755766d3a34839257cd4d23cc3cd","2020-04-01T20:00:00Z",24,398,20369,20369,20369,55,8,61,1444,199,1643
"3247",20200401,"WV",191,4384,NA,NA,1,NA,NA,NA,NA,NA,"B","4/1/2020 13:11","114b348f77f4070d9731a449e9129e5663cdd6a7","2020-04-01T20:00:00Z",1,1,4575,4575,4575,54,0,0,403,29,432
"3248",20200401,"WY",130,2218,NA,NA,18,NA,NA,NA,NA,31,"A","3/31/2020 19:44","35ae6b5bde17334962bd3069e1e6a412ce1c1caa","2020-04-01T20:00:00Z",0,18,2348,2348,2348,56,0,1,219,21,240
"3249",20200331,"AK",119,3594,NA,NA,7,NA,NA,NA,NA,NA,"A","3/30/2020 19:00","7daee4dd19e0e2f9d6a9fa2fe3297f4a56715af9","2020-03-31T20:00:00Z",3,7,3713,3713,3713,2,0,0,54,5,59
"3250",20200331,"AL",981,6298,NA,NA,NA,NA,NA,NA,NA,NA,"B","3/31/2020 00:00","30c813a827ef8ec2067774691b104583fe4eeb7e","2020-03-31T20:00:00Z",13,NA,7279,7279,7279,1,7,0,604,122,726
"3251",20200331,"AR",523,5959,NA,64,NA,NA,NA,23,NA,35,"A","3/31/2020 14:59","8da1e200b8ef0e36b1eed41e19413ed797b8a1f5","2020-03-31T20:00:00Z",8,NA,6482,6482,6482,5,1,0,697,50,747
"3252",20200331,"AS",0,3,2,NA,NA,NA,NA,NA,NA,NA,"","3/30/2020 00:00","d51f96f4643dcd20ea4f5b3b8699a432148d3ca9","2020-03-31T20:00:00Z",0,NA,5,3,3,60,0,0,3,0,3
"3253",20200331,"AZ",1289,18082,NA,NA,NA,NA,NA,NA,NA,NA,"B","3/31/2020 00:00","dceda3bc8b2eb4d2c91bd29b689a375dd007ff5e","2020-03-31T20:00:00Z",24,NA,19371,19371,19371,4,4,0,2480,132,2612
"3254",20200331,"CA",7482,21772,57400,1617,NA,657,NA,NA,NA,NA,"B","3/31/2020 16:00","432ba727836dd611654632d51e2eaa336d9ae700","2020-03-31T20:00:00Z",153,NA,86654,29254,29254,6,20,0,1223,1035,2258
"3255",20200331,"CO",2627,12737,NA,503,414,NA,NA,NA,NA,NA,"A","3/29/2020 00:00","5755c58f75b3f913127bfebf35561cc22fe32810","2020-03-31T20:00:00Z",51,414,15364,15364,15364,8,0,0,0,0,0
"3256",20200331,"CT",3128,13029,NA,608,NA,NA,NA,NA,NA,NA,"A","3/31/2020 13:30","a87ccf0dd90a8e024cb2b44eca9e6cd362040ce8","2020-03-31T20:00:00Z",69,NA,16157,16157,16157,9,33,0,1000,557,1557
"3257",20200331,"DC",495,3262,2,NA,NA,NA,NA,NA,NA,121,"A","3/30/2020 00:00","0852340a3cc4a0923087fc4044b82510ca2fa60e","2020-03-31T20:00:00Z",9,NA,3759,3757,3757,11,0,0,580,94,674
"3258",20200331,"DE",319,3696,NA,57,NA,NA,NA,NA,NA,22,"C","3/31/2020 16:00","964cc6c0a40a3ff44802708f4573c87c3009cbb8","2020-03-31T20:00:00Z",10,NA,4015,4015,4015,10,4,0,1480,55,1535
"3259",20200331,"FL",6338,54285,1163,NA,823,NA,NA,NA,NA,NA,"A","3/31/2020 11:30","527ce8bfff16b746857e20a04b640bf49f614260","2020-03-31T20:00:00Z",77,823,61786,60623,60623,12,14,171,6060,865,6925
"3260",20200331,"GA",3929,12252,NA,NA,833,NA,NA,NA,NA,NA,"A","3/31/2020 12:57","2287eaa2a6ba5129843ee31dbec44e14e2b9f64e","2020-03-31T20:00:00Z",111,833,16181,16181,16181,13,24,126,2337,1120,3457
"3261",20200331,"GU",69,371,NA,19,NA,2,NA,NA,NA,7,"","3/31/2020 07:55","1186f41c915d1b8590ebf03ac77758d9c401faf7","2020-03-31T20:00:00Z",2,NA,440,440,440,66,1,0,19,11,30
"3262",20200331,"HI",204,8471,NA,NA,12,NA,6,NA,NA,49,"A","3/30/2020 18:00","8b549fa0eb0389ea7b9e2193c2d9b26e32692123","2020-03-31T20:00:00Z",NA,12,8675,8675,8675,15,0,0,646,29,675
"3263",20200331,"IA",497,6888,NA,61,94,NA,NA,NA,NA,33,"C","3/31/2020 00:00","a80def6f7fd7bd1c4f8529f823843c4728454f45","2020-03-31T20:00:00Z",7,94,7385,7385,7385,19,1,20,726,73,799
"3264",20200331,"ID",415,5297,NA,NA,45,NA,6,NA,NA,NA,"A","3/30/2020 19:00","8a91d5ffd1f96930af621b6d103f7e0c65a52f5f","2020-03-31T20:00:00Z",7,45,5712,5712,5712,16,1,6,901,105,1006
"3265",20200331,"IL",5994,29231,NA,NA,NA,NA,NA,NA,NA,NA,"A","3/31/2020 00:00","0699600b1755c7ce2d31f68d6cc25931fe74f7a4","2020-03-31T20:00:00Z",99,NA,35225,35225,35225,17,26,0,3842,937,4779
"3266",20200331,"IN",2159,11214,NA,NA,NA,NA,NA,NA,NA,NA,"B","3/30/2020 12:59","8c03f75821efb2250e80e618c0b6f2089a6f1b20","2020-03-31T20:00:00Z",49,NA,13373,13373,13373,18,14,0,1342,373,1715
"3267",20200331,"KS",428,4996,NA,NA,79,NA,NA,NA,NA,NA,"B","3/31/2020 11:00","19ab0642e85c4dd0be80c550de159788b609879f","2020-03-31T20:00:00Z",9,79,5424,5424,5424,20,1,13,442,60,502
"3268",20200331,"KY",480,6330,NA,NA,NA,NA,NA,NA,NA,NA,"A","3/30/2020 17:00","3afbeaab5adaddec917c047424b022e408bf7e63","2020-03-31T20:00:00Z",11,NA,6810,6810,6810,21,2,0,751,41,792
"3269",20200331,"LA",5237,33730,NA,1355,NA,NA,NA,438,NA,NA,"A","3/31/2020 13:00","c5012f4a5317a6c370013bc1c889f61ecf9c121a","2020-03-31T20:00:00Z",239,NA,38967,38967,38967,22,54,0,3722,1212,4934
"3270",20200331,"MA",6521,40440,NA,NA,562,NA,NA,NA,NA,NA,"B","3/31/2020 12:30","7ca3714b678bc6d0480f26e49a2db37a5b4d931d","2020-03-31T20:00:00Z",153,562,46961,46961,46961,25,29,109,3274,868,4142
"3271",20200331,"MD",1660,14868,NA,NA,429,NA,NA,NA,NA,NA,"A","3/31/2020 10:00","56cb4a94c7ee61348b7deaa5940859954769e4e2","2020-03-31T20:00:00Z",18,429,16528,16528,16528,24,3,76,1552,247,1799
"3272",20200331,"ME",303,6088,NA,NA,57,NA,NA,NA,NA,68,"A","3/31/2020 10:30","7b83fb27f5e65bb8d50f63302166dc420b7d212f","2020-03-31T20:00:00Z",5,57,6391,6391,6391,23,2,8,2694,28,2722
"3273",20200331,"MI",11875,23979,NA,NA,NA,NA,NA,NA,NA,NA,"B","3/31/2020 11:00","0f74896b5aabf6b4e9c043d6948c587964af0a05","2020-03-31T20:00:00Z",259,NA,35854,35854,35854,26,75,0,2796,974,3770
"3274",20200331,"MN",629,19151,NA,56,112,26,26,NA,NA,NA,"A","3/31/2020 00:00","79fcf14bafe6ac3a80bcbeb722f90e5d93a9eacc","2020-03-31T20:00:00Z",12,112,19780,19780,19780,27,2,20,905,53,958
"3275",20200331,"MO",1327,14614,NA,NA,NA,NA,NA,NA,NA,NA,"C","3/31/2020 15:00","f6f3d884d544c7a73c03431474f776dd1730c40f","2020-03-31T20:00:00Z",14,NA,15941,15941,15941,29,1,0,1410,296,1706
"3276",20200331,"MP",2,NA,NA,NA,NA,NA,NA,NA,NA,NA,"","3/30/2020 18:30","b908332c29b5a7283c5fc050c4ce488a2fe2d11f","2020-03-31T20:00:00Z",NA,NA,2,2,2,69,0,0,0,0,0
"3277",20200331,"MS",937,3537,NA,NA,211,NA,NA,NA,NA,NA,"B","3/30/2020 19:00","dee58e609dbbbc59e0c4818672de4ff2fcbe104c","2020-03-31T20:00:00Z",20,211,4474,4474,4474,28,4,16,548,90,638
"3278",20200331,"MT",184,4234,NA,NA,14,NA,NA,NA,NA,NA,"A","3/31/2020 10:00","4bf6d316b2bf2c832493840a54056f6a11089623","2020-03-31T20:00:00Z",4,14,4418,4418,4418,30,0,4,91,13,104
"3279",20200331,"NC",1498,21608,NA,157,NA,NA,NA,NA,NA,NA,"A","3/31/2020 09:05","db4ca42edb018a371ec5592b6fa1496568098b74","2020-03-31T20:00:00Z",8,NA,23106,23106,23106,37,2,0,2051,191,2242
"3280",20200331,"ND",126,4131,NA,NA,21,NA,NA,NA,NA,30,"B","3/31/2020 18:00","ad73cee72b0fe747752fe68e23cb3bc61f407bd4","2020-03-31T20:00:00Z",3,21,4257,4257,4257,38,1,2,403,17,420
"3281",20200331,"NE",172,2931,8,NA,NA,NA,NA,NA,NA,NA,"A","3/31/2020 14:00","8dc42c9146d0e75f4ed9f3239129e6c5565ac62e","2020-03-31T20:00:00Z",3,NA,3111,3103,3103,31,1,0,347,27,374
"3282",20200331,"NH",314,5413,65,NA,45,NA,NA,NA,NA,NA,"B","3/30/2020 09:00","2b6586a4ca9166c26542de28ae993908bb0897db","2020-03-31T20:00:00Z",3,45,5792,5727,5727,33,0,0,27,0,27
"3283",20200331,"NJ",18696,27077,NA,2000,NA,NA,NA,NA,NA,NA,"A","3/31/2020 13:00","5f9d37eeaab7850e322a91cb627cf80ed4b64f33","2020-03-31T20:00:00Z",267,NA,45773,45773,45773,34,69,0,1853,2060,3913
"3284",20200331,"NM",281,12246,NA,22,NA,NA,NA,NA,NA,26,"A","3/31/2020 00:00","d6bde9fec632e1838dab5129d9b18d6fe371eb18","2020-03-31T20:00:00Z",4,NA,12527,12527,12527,35,2,0,1304,44,1348
"3285",20200331,"NV",1113,10681,NA,NA,NA,NA,NA,NA,NA,NA,"A","3/31/2020 09:30","a79040d71c1d16eb812290d356c2bcf14445f7ac","2020-03-31T20:00:00Z",17,NA,11794,11794,11794,32,2,0,474,105,579
"3286",20200331,"NY",75795,129391,NA,10929,15904,2710,NA,NA,NA,4975,"A","3/29/2020 09:16","f5f32b6d7890a1239c97ff4eedef1e4368eb11e5","2020-03-31T20:00:00Z",1550,15904,205186,205186,205186,36,332,2183,9420,9298,18718
"3287",20200331,"OH",2199,26992,NA,NA,585,NA,198,NA,NA,NA,"B","3/31/2020 14:00","fba82bf909acefb31066b64770e0e143211cb723","2020-03-31T20:00:00Z",55,585,29191,29191,29191,39,16,110,1650,266,1916
"3288",20200331,"OK",565,1229,NA,NA,177,83,NA,NA,NA,NA,"B","3/31/2020 08:00","84f4f01bc184f2a541bd5d4a1fac1b9101ef3858","2020-03-31T20:00:00Z",23,177,1794,1794,1794,40,6,24,22,84,106
"3289",20200331,"OR",690,13136,NA,132,154,NA,NA,40,NA,NA,"A","3/31/2020 11:00","73866d674cb80020557b0e84a477c7ffd864151a","2020-03-31T20:00:00Z",18,154,13826,13826,13826,41,2,14,859,84,943
"3290",20200331,"PA",4843,37645,NA,NA,514,NA,NA,NA,NA,NA,"A","3/31/2020 12:00","4da96641b4571610eb81ebb1f5bb13e131eb881d","2020-03-31T20:00:00Z",63,514,42488,42488,42488,42,14,128,3868,756,4624
"3291",20200331,"PR",239,1195,854,NA,NA,NA,NA,NA,NA,NA,"A","3/30/2020 07:00","2e469a2e2aed91ca0d53b02ee614b9e56d183e69","2020-03-31T20:00:00Z",8,NA,2288,1434,1434,72,2,0,264,65,329
"3292",20200331,"RI",489,3476,NA,59,NA,9,NA,6,NA,35,"B","3/31/2020 00:00","670726ceb8f633e51bf5607fad1e9264a97dfdba","2020-03-31T20:00:00Z",8,NA,3965,3965,3965,44,4,0,289,87,376
"3293",20200331,"SC",1083,4616,NA,NA,102,NA,NA,NA,NA,NA,"B","3/31/2020 16:31","4a46cca0e478a5bdffafa980b85d48b03fb95d3e","2020-03-31T20:00:00Z",22,102,5699,5699,5699,45,4,0,456,158,614
"3294",20200331,"SD",108,3609,0,NA,12,NA,NA,NA,NA,44,"A","3/31/2020 12:30","1e2ec75b2221a16cc97f33315aef29472f2d5125","2020-03-31T20:00:00Z",1,12,3717,3717,3717,46,0,12,131,7,138
"3295",20200331,"TN",2239,25121,NA,NA,175,NA,NA,NA,NA,121,"A","3/31/2020 15:00","7b0db1f93750479d021b16de82ec4072e1ad98ed","2020-03-31T20:00:00Z",23,175,27360,27360,27360,47,10,27,3651,405,4056
"3296",20200331,"TX",3266,39726,NA,196,NA,NA,NA,NA,NA,38,"A","3/31/2020 13:45","35dc801ba2cef6824b0c9a97c5a2f57f3bb52804","2020-03-31T20:00:00Z",41,NA,42992,42992,42992,48,7,0,6723,389,7112
"3297",20200331,"UT",887,17626,NA,NA,73,NA,NA,NA,NA,NA,"A","3/31/2020 15:00","a31fdb3429ef7247cb3c582e6228faea57b8bc73","2020-03-31T20:00:00Z",5,73,18513,18513,18513,49,1,73,2429,81,2510
"3298",20200331,"VA",1250,12151,NA,NA,165,NA,NA,NA,NA,NA,"A","3/31/2020 00:00","efa2161fbf28bff9cc339e05dff758e51a7de03b","2020-03-31T20:00:00Z",27,165,13401,13401,13401,51,2,29,1133,230,1363
"3299",20200331,"VI",30,126,24,NA,NA,NA,NA,NA,NA,21,"","3/30/2020 17:00","03d876a233dc584b5c483efb680e5f271ab90008","2020-03-31T20:00:00Z",NA,NA,180,156,156,78,0,0,0,0,0
"3300",20200331,"VT",320,3949,NA,21,36,NA,NA,NA,NA,15,"A","3/31/2020 00:00","4c80d594f978da7a9dff901ebef5d2efe70959c1","2020-03-31T20:00:00Z",13,36,4269,4269,4269,50,1,18,231,27,258
"3301",20200331,"WA",6908,78403,NA,NA,NA,NA,NA,NA,NA,NA,"A","3/31/2020 00:00","8922bc63abc7e6fdbf606419e0076b96b38a6305","2020-03-31T20:00:00Z",262,NA,85311,85311,85311,53,14,0,4158,467,4625
"3302",20200331,"WI",1351,17375,NA,NA,337,NA,NA,NA,NA,NA,"A","3/31/2020 16:00","50a2ad2d05de101552f3992401741d144bb42949","2020-03-31T20:00:00Z",16,337,18726,18726,18726,55,2,337,1519,130,1649
"3303",20200331,"WV",162,3981,NA,NA,1,NA,NA,NA,NA,NA,"B","3/31/2020 00:00","4d5500eb299c45b7b5f33f1836e171f208d9410a","2020-03-31T20:00:00Z",1,1,4143,4143,4143,54,0,0,997,36,1033
"3304",20200331,"WY",109,1999,NA,NA,17,NA,NA,NA,NA,26,"A","3/31/2020 10:37","ed67c54ca4d4eeec8456526e2b96d66b79a79405","2020-03-31T20:00:00Z",0,17,2108,2108,2108,56,0,0,159,15,174
"3305",20200330,"AK",114,3540,NA,NA,7,NA,NA,NA,NA,NA,"A","3/29/2020 19:00","bd793c54a5c308dd75c908245d900e79a3c89812","2020-03-30T20:00:00Z",3,7,3654,3654,3654,2,1,1,308,12,320
"3306",20200330,"AL",859,5694,NA,NA,NA,NA,NA,NA,NA,NA,"B","3/29/2020 00:00","609df05ff169b971fb34dcb3a6b2b1602bc9ddc6","2020-03-30T20:00:00Z",6,NA,6553,6553,6553,1,2,0,1510,53,1563
"3307",20200330,"AR",473,5262,NA,62,NA,NA,NA,21,NA,29,"A","3/30/2020 15:42","347f936bd853834b4b7f1c0c198c00de8f193e57","2020-03-30T20:00:00Z",7,NA,5735,5735,5735,5,1,0,2235,47,2282
"3308",20200330,"AS",NA,NA,NA,NA,NA,NA,NA,NA,NA,NA,"","3/30/2020 00:00","d36fc9801ec42649c071c0cd228bbb708eea7665","2020-03-30T20:00:00Z",0,NA,0,0,0,60,0,0,0,0,0
"3309",20200330,"AZ",1157,15602,NA,NA,NA,NA,NA,NA,NA,NA,"B","3/30/2020 00:00","116c9429446cf9ff2c92cf015421a255722a8aa8","2020-03-30T20:00:00Z",20,NA,16759,16759,16759,4,3,0,2649,238,2887
"3310",20200330,"CA",6447,20549,64400,1432,NA,597,NA,NA,NA,NA,"B","3/30/2020 00:00","939374d27265e16a2e10aa30b5286d65fc15c714","2020-03-30T20:00:00Z",133,NA,91396,26996,26996,6,10,0,0,739,739
"3311",20200330,"CO",2627,12737,NA,358,414,NA,NA,NA,NA,NA,"A","3/28/2020 00:00","9eab6983e1dc1233fa2e77077253568457f713b1","2020-03-30T20:00:00Z",51,414,15364,15364,15364,8,7,140,1522,566,2088
"3312",20200330,"CT",2571,12029,NA,517,NA,NA,NA,NA,NA,NA,"A","3/30/2020 11:30","125e70f9e4041de5cb4c1018f3ef41ac1cadc9c1","2020-03-30T20:00:00Z",36,NA,14600,14600,14600,9,2,0,2122,578,2700
"3313",20200330,"DC",401,2682,2,NA,NA,NA,NA,NA,NA,106,"A","3/29/2020 20:45","661a50f92783e254bddd9c89c98ca33a518b5b82","2020-03-30T20:00:00Z",9,NA,3085,3083,3083,11,4,0,213,59,272
"3314",20200330,"DE",264,2216,NA,45,NA,NA,NA,NA,NA,9,"C","3/30/2020 00:00","695794e04761630f5a5644975930fa6089b985bf","2020-03-30T20:00:00Z",6,NA,2480,2480,2480,10,0,0,2180,32,2212
"3315",20200330,"FL",5473,48225,NA,NA,652,NA,NA,NA,NA,NA,"A","3/30/2020 11:30","3345e2b7b5f5331b0cc101429e95e264d3df8934","2020-03-30T20:00:00Z",63,652,53698,53698,53698,12,7,58,9155,1227,10382
"3316",20200330,"GA",2809,9915,NA,NA,707,NA,NA,NA,NA,NA,"A","3/30/2020 11:28","a7dea476a300ae3a7f5867e16e68d873131b4643","2020-03-30T20:00:00Z",87,707,12724,12724,12724,13,7,41,2,158,160
"3317",20200330,"GU",58,352,NA,19,NA,2,NA,NA,NA,7,"","3/30/2020 04:30","3931565edb4f17d79e9c546dea97a32c5dc72390","2020-03-30T20:00:00Z",1,NA,410,410,410,66,0,0,18,2,20
"3318",20200330,"HI",175,7825,NA,NA,12,NA,NA,NA,NA,NA,"A","3/29/2020 18:00","8b37e1a6e24372990d030e5ddf8482be93951286","2020-03-30T20:00:00Z",NA,12,8000,8000,8000,15,0,0,976,24,1000
"3319",20200330,"IA",424,6162,NA,51,74,NA,NA,NA,NA,23,"C","3/30/2020 00:00","a4a03d7ee6ef0f6a9f7fc0bd77f00cecbdcf520f","2020-03-30T20:00:00Z",6,74,6586,6586,6586,19,2,6,1149,88,1237
"3320",20200330,"ID",310,4396,NA,NA,39,NA,NA,NA,NA,NA,"A","3/29/2020 19:00","946c7de6b5770de9fe203ab625bafee0cd3e007c","2020-03-30T20:00:00Z",6,39,4706,4706,4706,16,1,3,375,49,424
"3321",20200330,"IL",5057,25389,NA,NA,NA,NA,NA,NA,NA,NA,"A","3/29/2020 00:00","533312dff1b1b4ab9d07280d569bbfd767bb905e","2020-03-30T20:00:00Z",73,NA,30446,30446,30446,17,8,0,2223,461,2684
"3322",20200330,"IN",1786,9872,NA,NA,NA,NA,NA,NA,NA,NA,"B","3/29/2020 12:59","cbacb6f7b0af11baca016b7fb9f8c7a72da91514","2020-03-30T20:00:00Z",35,NA,11658,11658,11658,18,3,0,1556,272,1828
"3323",20200330,"KS",368,4554,NA,NA,66,NA,NA,NA,NA,NA,"B","3/30/2020 11:00","fc76449fa64fa0b03b402fdd31a81a03dcdabff9","2020-03-30T20:00:00Z",8,66,4922,4922,4922,20,2,11,360,49,409
"3324",20200330,"KY",439,5579,NA,NA,NA,NA,NA,NA,NA,NA,"A","3/29/2020 17:00","1de77fadf0bad9b5749f921331973b5e3885a66f","2020-03-30T20:00:00Z",9,NA,6018,6018,6018,21,0,0,432,45,477
"3325",20200330,"LA",4025,30008,NA,1185,NA,NA,NA,385,NA,NA,"A","3/30/2020 13:00","02d2ff35a0a030bb1450d4f793b11e2ff5dfdacb","2020-03-30T20:00:00Z",185,NA,34033,34033,34033,22,34,0,5677,485,6162
"3326",20200330,"MA",5653,37166,NA,NA,453,NA,NA,NA,NA,NA,"B","3/30/2020 16:15","1675e1a01a3ffc64db3a6a4c2e9de93e56a05537","2020-03-30T20:00:00Z",124,453,42819,42819,42819,25,25,54,2932,797,3729
"3327",20200330,"MD",1413,13316,NA,NA,353,NA,NA,NA,NA,NA,"A","3/30/2020 10:00","3d4508879a35831793fcb0ee01c73efc83c42ac9","2020-03-30T20:00:00Z",15,353,14729,14729,14729,24,5,76,962,174,1136
"3328",20200330,"ME",275,3394,NA,NA,49,NA,NA,NA,NA,41,"A","3/30/2020 12:00","8cf8924ae332ffd044eef8d08a77199b2f9df5a6","2020-03-30T20:00:00Z",3,49,3669,3669,3669,23,0,49,0,22,22
"3329",20200330,"MI",10901,21183,NA,NA,NA,NA,NA,NA,NA,NA,"B","3/30/2020 16:00","6cd1832421e9bdafaafd48c6c58535a3db77b1a5","2020-03-30T20:00:00Z",184,NA,32084,32084,32084,26,52,0,5507,891,6398
"3330",20200330,"MN",576,18246,NA,56,92,24,24,NA,NA,NA,"A","3/30/2020 00:00","8e1254ef51d0b04f0d5c9a7a1198dc6c6f3ca70e","2020-03-30T20:00:00Z",10,92,18822,18822,18822,27,1,17,1092,73,1165
"3331",20200330,"MO",1031,13204,NA,NA,NA,NA,NA,NA,NA,NA,"C","3/30/2020 16:00","8ea65a46d8becbfdabbcc06090486ba98c3f6ec8","2020-03-30T20:00:00Z",13,NA,14235,14235,14235,29,3,0,1657,193,1850
"3332",20200330,"MP",2,NA,NA,NA,NA,NA,NA,NA,NA,NA,"","3/30/2020 01:30","65a7c55492404c9fc5ed3760913620db776ad92a","2020-03-30T20:00:00Z",NA,NA,2,2,2,69,0,0,0,0,0
"3333",20200330,"MS",847,2989,NA,NA,195,NA,NA,NA,NA,NA,"B","3/29/2020 19:00","6db2730eab948a4b333bf3e9d735fe0400dfc18d","2020-03-30T20:00:00Z",16,195,3836,3836,3836,28,2,-40,429,89,518
"3334",20200330,"MT",171,4143,NA,NA,10,NA,NA,NA,NA,NA,"A","3/30/2020 10:00","4e4e5ee3bbfdbaf870bf5239190a9bfabde24cdd","2020-03-30T20:00:00Z",4,10,4314,4314,4314,30,3,2,0,17,17
"3335",20200330,"NC",1307,19557,NA,137,NA,NA,NA,NA,NA,NA,"A","3/30/2020 11:00","d18f7d1fd85e2fa6a7f41ff59952b0710dad0b38","2020-03-30T20:00:00Z",6,NA,20864,20864,20864,37,2,0,1652,267,1919
"3336",20200330,"ND",109,3728,NA,NA,19,NA,NA,NA,NA,19,"B","3/30/2020 12:00","01942159e87fca9128166b49bbcabafe5ce49ced","2020-03-30T20:00:00Z",2,19,3837,3837,3837,38,1,2,373,11,384
"3337",20200330,"NE",145,2584,5,NA,NA,NA,NA,NA,NA,NA,"A","3/30/2020 14:30","8b0022e5ce7647a99ac436ccb7ad1d2e60839af1","2020-03-30T20:00:00Z",2,NA,2734,2729,2729,31,0,0,616,37,653
"3338",20200330,"NH",314,5386,144,NA,45,NA,NA,NA,NA,NA,"B","3/29/2020 09:00","1293fb2ff90924a69fa734118a678c09650ed6e2","2020-03-30T20:00:00Z",3,45,5844,5700,5700,33,1,12,862,100,962
"3339",20200330,"NJ",16636,25224,NA,2000,NA,NA,NA,NA,NA,NA,"A","3/29/2020 13:30","29d4f15d846d4ab8a298129007f2262d790ea56d","2020-03-30T20:00:00Z",198,NA,41860,41860,41860,34,37,0,3008,3250,6258
"3340",20200330,"NM",237,10942,NA,22,NA,NA,NA,NA,NA,26,"A","3/29/2020 00:00","8dba4eeacb51f7881523c0f0a85197f59103dec0","2020-03-30T20:00:00Z",2,NA,11179,11179,11179,35,0,0,173,0,173
"3341",20200330,"NV",1008,10207,NA,NA,NA,NA,NA,NA,NA,NA,"A","3/30/2020 12:00","7ad871bcff059484f3ca768fa10946b3a51e5183","2020-03-30T20:00:00Z",15,NA,11215,11215,11215,32,1,0,1795,270,2065
"3342",20200330,"NY",66497,119971,NA,9517,13721,2352,NA,NA,NA,4204,"A","3/29/2020 09:16","3ce0f66b4b2a93caf488dd34387462396ba5aa3b","2020-03-30T20:00:00Z",1218,13721,186468,186468,186468,36,253,1646,7124,6984,14108
"3343",20200330,"OH",1933,25342,NA,NA,475,NA,163,NA,NA,NA,"B","3/30/2020 14:00","3fe8c1314fb7c76928d0e7dfe795138cdee7e5f7","2020-03-30T20:00:00Z",39,475,27275,27275,27275,39,10,72,6330,280,6610
"3344",20200330,"OK",481,1207,NA,NA,153,103,NA,NA,NA,NA,"B","3/30/2020 08:00","e2418d3a97a6f8979756913a3b919c31faaf5a02","2020-03-30T20:00:00Z",17,153,1688,1688,1688,40,1,13,2,52,54
"3345",20200330,"OR",606,12277,NA,132,140,NA,NA,39,NA,NA,"A","3/30/2020 11:00","578b5a17463612dee29eb2a9217e4734a7f735c2","2020-03-30T20:00:00Z",16,140,12883,12883,12883,41,3,11,1399,58,1457
"3346",20200330,"PA",4087,33777,NA,NA,386,NA,NA,NA,NA,NA,"A","3/30/2020 12:00","8e2e57fbf0afac11f430e8935a84dffed485bb77","2020-03-30T20:00:00Z",49,386,37864,37864,37864,42,11,33,3716,693,4409
"3347",20200330,"PR",174,931,794,NA,NA,NA,NA,NA,NA,NA,"A","3/30/2020 07:00","ce2a0e01ccd1c7df80ce054a8001da2fcad73bf3","2020-03-30T20:00:00Z",6,NA,1899,1105,1105,72,1,0,90,47,137
"3348",20200330,"RI",402,3187,NA,41,NA,9,NA,6,NA,NA,"B","3/30/2020 00:00","cb8295d645f0e77cb2c67157bb541d77ba4f2e29","2020-03-30T20:00:00Z",4,NA,3589,3589,3589,44,1,0,347,108,455
"3349",20200330,"SC",925,4160,NA,NA,102,NA,NA,NA,NA,NA,"B","3/30/2020 16:00","d8306542c145bebb90f285d10ac766b8776dbb59","2020-03-30T20:00:00Z",18,102,5085,5085,5085,45,2,0,1145,151,1296
"3350",20200330,"SD",101,3478,0,NA,NA,NA,NA,NA,NA,34,"A","3/30/2020 12:30","061d41786f81b3a3e18f1796a84254ddf938f719","2020-03-30T20:00:00Z",1,NA,3579,3579,3579,46,0,0,351,11,362
"3351",20200330,"TN",1834,21470,NA,NA,148,NA,NA,NA,NA,NA,"A","3/30/2020 15:00","983fd57e027980ab90d8b15da66c9283a74b3d4f","2020-03-30T20:00:00Z",13,148,23304,23304,23304,47,6,15,2433,297,2730
"3352",20200330,"TX",2877,33003,NA,NA,NA,NA,NA,NA,NA,38,"A","3/30/2020 12:45","c921c88eb1bf2827b20f8a533ec778d959a89d1a","2020-03-30T20:00:00Z",34,NA,35880,35880,35880,48,0,0,9795,325,10120
"3353",20200330,"UT",806,15197,NA,NA,NA,NA,NA,NA,NA,NA,"A","3/30/2020 15:00","de0019eaa1a86c8613c0b594d40b89364cb47b33","2020-03-30T20:00:00Z",4,NA,16003,16003,16003,49,2,0,1923,87,2010
"3354",20200330,"VA",1020,11018,NA,NA,136,NA,NA,NA,NA,NA,"A","3/30/2020 00:00","9609601318aad4108952831e350080fc07df5d7f","2020-03-30T20:00:00Z",25,136,12038,12038,12038,51,3,24,1299,130,1429
"3355",20200330,"VI",30,126,24,NA,NA,NA,NA,NA,NA,NA,"","3/30/2020 11:00","2205e06f30b183b1016faa0689c5c5e51eca9089","2020-03-30T20:00:00Z",NA,NA,180,156,156,78,0,0,3,7,10
"3356",20200330,"VT",293,3718,NA,NA,18,NA,NA,NA,NA,NA,"A","3/30/2020 00:00","11ad03da620d314f1b64e8db10f1452d72ccc3c5","2020-03-30T20:00:00Z",12,18,4011,4011,4011,50,0,0,235,37,272
"3357",20200330,"WA",6441,74245,NA,NA,NA,NA,NA,NA,NA,NA,"A","3/30/2020 00:00","441b3f93bca9cc16fca75ba0e30243fde08107a8","2020-03-30T20:00:00Z",248,NA,80686,80686,80686,53,11,0,4495,561,5056
"3358",20200330,"WI",1221,15856,NA,NA,NA,NA,NA,NA,NA,NA,"A","3/30/2020 16:00","1276a1e98e3946935676a311321d0c402fb5a8fc","2020-03-30T20:00:00Z",14,NA,17077,17077,17077,55,1,0,-694,109,-585
"3359",20200330,"WV",126,2984,0,NA,1,NA,NA,NA,NA,NA,"B","3/30/2020 14:10","49e651081b432b9b134ef88e97c1cf0e539aefbf","2020-03-30T20:00:00Z",1,1,3110,3110,3110,54,1,0,279,13,292
"3360",20200330,"WY",94,1840,NA,NA,17,NA,NA,NA,NA,24,"A","3/30/2020 00:00","e20b003a55869a28cfaf1a2e40de1438641432af","2020-03-30T20:00:00Z",0,17,1934,1934,1934,56,0,2,286,8,294
"3361",20200329,"AK",102,3232,NA,NA,6,NA,NA,NA,NA,NA,"A","3/28/2020 19:00","c2ee8258d18576b80e5c15f9e8460dfd173fe98d","2020-03-29T20:00:00Z",2,6,3334,3334,3334,2,0,1,396,17,413
"3362",20200329,"AL",806,4184,NA,NA,NA,NA,NA,NA,NA,NA,"B","3/29/2020 00:00","b7381e0229039e088e4e9720ae700caff4e4a93b","2020-03-29T20:00:00Z",4,NA,4990,4990,4990,1,1,0,0,110,110
"3363",20200329,"AR",426,3027,NA,43,NA,NA,NA,16,NA,28,"A","3/29/2020 11:10","fa441a6cda9d4b048e148882290f9b683ba9f1c6","2020-03-29T20:00:00Z",6,NA,3453,3453,3453,5,1,0,89,22,111
"3364",20200329,"AS",NA,NA,NA,NA,NA,NA,NA,NA,NA,NA,"","3/27/2020 00:00","d5b5d5aefbc904e3d5ad69850e8d634e712c55f7","2020-03-29T20:00:00Z",0,NA,0,0,0,60,0,0,0,0,0
"3365",20200329,"AZ",919,12953,NA,NA,NA,NA,NA,NA,NA,NA,"B","3/29/2020 00:00","f6e326b82a5be8bbb1de4e284a20120de67e0d46","2020-03-29T20:00:00Z",17,NA,13872,13872,13872,4,2,0,5498,46,5544
"3366",20200329,"CA",5708,20549,64400,1034,NA,410,NA,NA,NA,NA,"B","3/29/2020 14:18","e4c08bdfb682124f99f532d43ae08b7e927b1b80","2020-03-29T20:00:00Z",123,NA,90657,26257,26257,6,22,0,0,1065,1065
"3367",20200329,"CO",2061,11215,NA,332,274,NA,NA,NA,NA,NA,"A","3/28/2020 18:00","36cea5686ee181cc0f1f0b0bf9a92f9601a7b4ee","2020-03-29T20:00:00Z",44,274,13276,13276,13276,8,13,35,1273,327,1600
"3368",20200329,"CT",1993,9907,NA,404,NA,NA,NA,NA,NA,NA,"A","3/29/2020 12:30","c3d1ad1b3ac83496d0c1e50b50a612b47b4900c1","2020-03-29T20:00:00Z",34,NA,11900,11900,11900,9,7,0,2798,702,3500
"3369",20200329,"DC",342,2469,1,NA,NA,NA,NA,NA,NA,66,"A","3/28/2020 19:45","55b292c6c573e2706648ee56921e3de7acd9ede6","2020-03-29T20:00:00Z",5,NA,2812,2811,2811,11,1,0,258,38,296
"3370",20200329,"DE",232,36,NA,33,NA,NA,NA,NA,NA,9,"C","3/29/2020 00:00","397d21bc186abbc9d3aef382a30e43976ee5aeaa","2020-03-29T20:00:00Z",6,NA,268,268,268,10,3,0,0,18,18
"3371",20200329,"FL",4246,39070,NA,NA,594,NA,NA,NA,NA,NA,"A","3/29/2020 11:30","429fdb15a44ce0414665027e06429b8f76df79d0","2020-03-29T20:00:00Z",56,594,43316,43316,43316,12,2,68,3704,483,4187
"3372",20200329,"GA",2651,9913,NA,NA,666,NA,NA,NA,NA,NA,"A","3/28/2020 18:27","93795a74a7a0fe90c9f7b38a8e5570ebff1cc41e","2020-03-29T20:00:00Z",80,666,12564,12564,12564,13,11,49,1228,285,1513
"3373",20200329,"GU",56,334,NA,15,NA,NA,NA,NA,NA,7,"","3/29/2020 04:00","20f7a7e7e0cde6b168c12051aab9cf7c0d2eb312","2020-03-29T20:00:00Z",1,NA,390,390,390,66,0,0,35,1,36
"3374",20200329,"HI",151,6849,NA,NA,12,NA,NA,NA,NA,NA,"A","3/28/2020 18:00","a80f9852d5130845b1a0b23bb91fb25ac504a710","2020-03-29T20:00:00Z",NA,12,7000,7000,7000,15,0,4,2492,31,2523
"3375",20200329,"IA",336,5013,NA,51,68,NA,NA,NA,NA,17,"C","3/29/2020 00:00","7891f598849e034ea2835f838dc6d346fd6f078a","2020-03-29T20:00:00Z",4,68,5349,5349,5349,19,1,7,638,38,676
"3376",20200329,"ID",261,4021,NA,NA,36,NA,NA,NA,NA,NA,"A","3/28/2020 18:55","93565675f15476c00ae5575b1dc7e8c1c3ef3b21","2020-03-29T20:00:00Z",5,36,4282,4282,4282,16,1,11,679,31,710
"3377",20200329,"IL",4596,23166,NA,NA,NA,NA,NA,NA,NA,NA,"A","3/29/2020 00:00","ea483cbd69cb69672cd09f1020ab4c0bf5ad93cc","2020-03-29T20:00:00Z",65,NA,27762,27762,27762,17,18,0,1166,1105,2271
"3378",20200329,"IN",1514,8316,NA,NA,NA,NA,NA,NA,NA,NA,"B","3/29/2020 11:00","8ea6695b7b6d36fe098cab4c5d12ee05e53ffbfc","2020-03-29T20:00:00Z",32,NA,9830,9830,9830,18,1,0,1141,282,1423
"3379",20200329,"KS",319,4194,NA,NA,55,NA,NA,NA,NA,NA,"B","3/29/2020 11:00","629d35ed2e28a968ee69512aec9fb1d6cf4dbe26","2020-03-29T20:00:00Z",6,55,4513,4513,4513,20,1,28,523,58,581
"3380",20200329,"KY",394,5147,NA,NA,NA,NA,NA,NA,NA,NA,"A","3/28/2020 17:00","edfbd9732693ab5d92b1477532c3cc7b9780906d","2020-03-29T20:00:00Z",9,NA,5541,5541,5541,21,1,0,326,92,418
"3381",20200329,"LA",3540,24331,NA,1127,NA,NA,NA,380,NA,NA,"A","3/29/2020 13:00","dbd60b673d986516d0c1a847bd26436776bc189f","2020-03-29T20:00:00Z",151,NA,27871,27871,27871,22,14,0,2485,225,2710
"3382",20200329,"MA",4856,34234,NA,NA,399,NA,NA,NA,NA,NA,"B","3/28/2020 12:30","53e238ddcbea39356aec1b6db641b79d81fdaea1","2020-03-29T20:00:00Z",99,399,39090,39090,39090,25,27,49,3319,698,4017
"3383",20200329,"MD",1239,12354,NA,NA,277,NA,NA,NA,NA,NA,"D","3/29/2020 10:00","ac864b4f8e67b679db6077d9402b8eb13b55bc7e","2020-03-29T20:00:00Z",10,277,13593,13593,13593,24,5,51,838,247,1085
"3384",20200329,"ME",253,3394,NA,NA,NA,NA,NA,NA,NA,41,"A","3/29/2020 14:20","ae7854e5bb58c8a8e3eb00a6b9f3810cbe0ed996","2020-03-29T20:00:00Z",3,NA,3647,3647,3647,23,2,0,0,42,42
"3385",20200329,"MI",10010,15676,NA,NA,NA,NA,NA,NA,NA,NA,"B","3/28/2020 14:00","e6b8203963f99feb0d8d0d107900ae9899e3e0c3","2020-03-29T20:00:00Z",132,NA,25686,25686,25686,26,40,0,1493,723,2216
"3386",20200329,"MN",503,17154,NA,39,75,NA,17,NA,NA,243,"A","3/29/2020 00:00","bbadc23b5563ba7518bc34e0457f53aa0f982460","2020-03-29T20:00:00Z",9,75,17657,17657,17657,27,4,18,1466,62,1528
"3387",20200329,"MO",838,11547,NA,NA,NA,NA,NA,NA,NA,NA,"C","3/28/2020 15:00","af59b95a77defc26a4d1ba166541a0d3b8d8fe3c","2020-03-29T20:00:00Z",10,NA,12385,12385,12385,29,0,0,1465,0,1465
"3388",20200329,"MP",2,NA,NA,NA,NA,NA,NA,NA,NA,NA,"","3/29/2020 01:30","1ccb8e609dd54b9c60a16e9d24925609277e4eba","2020-03-29T20:00:00Z",NA,NA,2,2,2,69,0,0,0,0,0
"3389",20200329,"MS",758,2560,NA,NA,235,NA,NA,NA,NA,NA,"B","3/28/2020 19:00","0b0ada4710a1a1c63c048e4b05fa77f0b49ad3b9","2020-03-29T20:00:00Z",14,235,3318,3318,3318,28,1,16,0,95,95
"3390",20200329,"MT",154,4143,NA,NA,8,NA,NA,NA,NA,NA,"A","3/29/2020 10:00","2e61c6e39be677d15dedc9642f600646457bcec0","2020-03-29T20:00:00Z",1,8,4297,4297,4297,30,0,1,887,25,912
"3391",20200329,"NC",1040,17905,NA,91,NA,NA,NA,NA,NA,NA,"A","3/29/2020 10:35","2575ab34fa9d1bb24a7cd56cd2b2cec2cd79b613","2020-03-29T20:00:00Z",4,NA,18945,18945,18945,37,0,0,1313,105,1418
"3392",20200329,"ND",98,3355,NA,NA,17,NA,NA,NA,NA,18,"B","3/29/2020 12:00","49f6f8cab5562696e21d0f7ff4385a48c44b3625","2020-03-29T20:00:00Z",1,17,3453,3453,3453,38,0,1,546,15,561
"3393",20200329,"NE",108,1968,4,NA,NA,NA,NA,NA,NA,NA,"A","3/28/2020 20:05","8c016329bbd223e1e338865542978888caf255b9","2020-03-29T20:00:00Z",2,NA,2080,2076,2076,31,0,0,64,12,76
"3394",20200329,"NH",214,4524,285,NA,33,NA,NA,NA,NA,NA,"B","3/28/2020 09:00","305991cd49b7babf90ab32f93c417859d7db68c6","2020-03-29T20:00:00Z",2,33,5023,4738,4738,33,0,3,868,27,895
"3395",20200329,"NJ",13386,22216,NA,2000,NA,NA,NA,NA,NA,NA,"A","3/29/2020 13:30","0c7d90e6676635dcca262e36a335a738a5561e5d","2020-03-29T20:00:00Z",161,NA,35602,35602,35602,34,21,0,2830,2262,5092
"3396",20200329,"NM",237,10769,NA,19,NA,NA,NA,NA,NA,2,"A","3/29/2020 00:00","d8416cab16d6a68157435a738507e920ff044d31","2020-03-29T20:00:00Z",2,NA,11006,11006,11006,35,1,0,1573,46,1619
"3397",20200329,"NV",738,8412,NA,NA,NA,NA,NA,NA,NA,NA,"A","3/28/2020 21:00","51e3f4ea112e31e89409fadbcb1ec1c9068f767e","2020-03-29T20:00:00Z",14,NA,9150,9150,9150,32,4,0,511,117,628
"3398",20200329,"NY",59513,112847,NA,8503,12075,2037,NA,NA,NA,3572,"A","3/29/2020 09:16","14ad04a515955b3a813189e392106a29b0a7cf21","2020-03-29T20:00:00Z",965,12075,172360,172360,172360,36,237,2021,9231,7195,16426
"3399",20200329,"OH",1653,19012,NA,NA,403,NA,139,NA,NA,NA,"B","3/29/2020 14:00","2b46c53a1aab6ea45028152a0c0de6ca22780e74","2020-03-29T20:00:00Z",29,403,20665,20665,20665,39,4,59,0,247,247
"3400",20200329,"OK",429,1205,NA,NA,140,NA,NA,NA,NA,NA,"A","3/29/2020 08:00","f617ab40afbe93b563b4390bd071f78a64df9e7f","2020-03-29T20:00:00Z",16,140,1634,1634,1634,40,1,14,25,52,77
"3401",20200329,"OR",548,10878,NA,107,129,NA,NA,37,NA,NA,"A","3/29/2020 11:00","5b79bed66cfbd1165fde8784cd8ea80c2c3c0c4b","2020-03-29T20:00:00Z",13,129,11426,11426,11426,41,0,12,1185,69,1254
"3402",20200329,"PA",3394,30061,NA,NA,353,NA,NA,NA,NA,NA,"A","3/29/2020 12:00","7e6e957b76a508e202f01599190a76dc1606a77b","2020-03-29T20:00:00Z",38,353,33455,33455,33455,42,4,37,4807,643,5450
"3403",20200329,"PR",127,841,817,NA,NA,NA,NA,NA,NA,NA,"A","3/29/2020 07:00","9e41f7d73480fae0fc2e4c540e7c15762e8b4b79","2020-03-29T20:00:00Z",5,NA,1785,968,968,72,2,0,102,27,129
"3404",20200329,"RI",294,2840,NA,35,NA,9,NA,6,NA,NA,"B","3/29/2020 00:00","71d13605a1210c926ab466823b0429de165a178f","2020-03-29T20:00:00Z",3,NA,3134,3134,3134,44,3,0,299,55,354
"3405",20200329,"SC",774,3015,NA,NA,102,NA,NA,NA,NA,NA,"B","3/29/2020 15:30","b02d5040ce2e06462fa13c0decaa934ab6217b68","2020-03-29T20:00:00Z",16,102,3789,3789,3789,45,3,0,607,235,842
"3406",20200329,"SD",90,3127,1,NA,NA,NA,NA,NA,NA,29,"A","3/29/2020 12:30","ed77b16ec6a346cb571d26e807b59fe2eee3d6ec","2020-03-29T20:00:00Z",1,NA,3218,3217,3217,46,0,0,535,22,557
"3407",20200329,"TN",1537,19037,NA,NA,133,NA,NA,NA,NA,NA,"A","3/29/2020 15:00","6678f072bcffc66aa6fc663a6ffa9279be7846a7","2020-03-29T20:00:00Z",7,133,20574,20574,20574,47,1,15,2072,164,2236
"3408",20200329,"TX",2552,23208,NA,NA,NA,NA,NA,NA,NA,NA,"A","3/29/2020 13:45","67244c50e7a878fd67c221dc8ab7fe1d4e50835c","2020-03-29T20:00:00Z",34,NA,25760,25760,25760,48,7,0,0,500,500
"3409",20200329,"UT",719,13274,NA,NA,NA,NA,NA,NA,NA,NA,"A","3/29/2020 15:00","5cd0c166459f47793b02a4b0fef2fa2b90057bfa","2020-03-29T20:00:00Z",2,NA,13993,13993,13993,49,0,0,2564,117,2681
"3410",20200329,"VA",890,9719,NA,NA,112,NA,NA,NA,NA,NA,"A","3/29/2020 00:00","4d96b72d635ba6365148deef41a4be2959f876cb","2020-03-29T20:00:00Z",22,112,10609,10609,10609,51,5,13,1292,151,1443
"3411",20200329,"VI",23,123,37,NA,NA,NA,NA,NA,NA,NA,"","3/28/2020 19:00","ff424ffda9185606b757298d86bcfff15238ae4b","2020-03-29T20:00:00Z",NA,NA,183,146,146,78,0,0,17,1,18
"3412",20200329,"VT",256,3483,NA,NA,18,NA,NA,NA,NA,NA,"A","3/29/2020 00:00","bd50d0146fe70c9ca2f35da9bc358476e532f278","2020-03-29T20:00:00Z",12,18,3739,3739,3739,50,0,0,291,22,313
"3413",20200329,"WA",5880,69750,NA,NA,NA,NA,NA,NA,NA,NA,"A","3/29/2020 00:00","2b0168f3a93c5c31b0e61f607ed6b5731a51ad28","2020-03-29T20:00:00Z",237,NA,75630,75630,75630,53,17,0,1587,238,1825
"3414",20200329,"WI",1112,16550,NA,NA,NA,NA,NA,NA,NA,NA,"A","3/29/2020 16:00","a519521d30ddaa45265c5172310d004d9bd8e435","2020-03-29T20:00:00Z",13,NA,17662,17662,17662,55,0,0,1318,123,1441
"3415",20200329,"WV",113,2705,0,NA,1,NA,NA,NA,NA,NA,"B","3/28/2020 00:00","965187a3d9eef471765e6b996c8a377967afcc9c","2020-03-29T20:00:00Z",0,1,2818,2818,2818,54,0,0,374,17,391
"3416",20200329,"WY",86,1554,NA,NA,15,NA,NA,NA,NA,20,"A","3/29/2020 00:00","c9a0184032cc9ea691df42284d50e00aab23b5c5","2020-03-29T20:00:00Z",0,15,1640,1640,1640,56,0,1,79,4,83
"3417",20200328,"AK",85,2836,NA,NA,5,NA,NA,NA,NA,NA,"A","3/27/2020 19:00","d2f152b139741e68736faaa776275a1d5b4dac32","2020-03-28T20:00:00Z",2,5,2921,2921,2921,2,1,2,517,16,533
"3418",20200328,"AL",696,4184,NA,NA,NA,NA,NA,NA,NA,NA,"B","3/28/2020 00:00","c479369642941b671287824db858134d4f692d0b","2020-03-28T20:00:00Z",3,NA,4880,4880,4880,1,0,0,0,109,109
"3419",20200328,"AR",404,2938,NA,48,NA,NA,NA,17,NA,24,"A","3/28/2020 00:00","9383166629559b1cd3a48b41542cb7ed54a31bd6","2020-03-28T20:00:00Z",5,NA,3342,3342,3342,5,2,0,1393,23,1416
"3420",20200328,"AS",NA,NA,NA,NA,NA,NA,NA,NA,NA,NA,"","3/27/2020 00:00","81a9b7b545c10784c42e19bf4803c5e16c280ac2","2020-03-28T20:00:00Z",0,NA,0,0,0,60,0,0,0,0,0
"3421",20200328,"AZ",873,7455,21,NA,NA,NA,NA,NA,NA,NA,"B","3/28/2020 00:00","7aad1fe086909db243854a673a430135538814a6","2020-03-28T20:00:00Z",15,NA,8349,8328,8328,4,2,0,0,137,137
"3422",20200328,"CA",4643,20549,64400,1034,NA,410,NA,NA,NA,NA,"B","3/27/2020 17:00","3d91bd2db74f60f3a373e4b6fcf70ea61f24340b","2020-03-28T20:00:00Z",101,NA,89592,25192,25192,6,23,0,3169,764,3933
"3423",20200328,"CO",1734,9942,NA,307,239,NA,NA,NA,NA,NA,"A","3/27/2020 18:00","c27c3e0d4bd02cfb215e0ffe34a05e1a9168b79b","2020-03-28T20:00:00Z",31,239,11676,11676,11676,8,7,55,1250,304,1554
"3424",20200328,"CT",1291,7109,NA,173,NA,NA,NA,NA,NA,NA,"A","3/27/2020 13:30","f1cbe70ac4cea0537b27a0c4396d26ed1bd3716b","2020-03-28T20:00:00Z",27,NA,8400,8400,8400,9,0,0,0,0,0
"3425",20200328,"DC",304,2211,1,NA,NA,NA,NA,NA,NA,51,"A","3/27/2020 20:30","583309f7da10d82a52456e0208cdd7cbbb293b33","2020-03-28T20:00:00Z",4,NA,2516,2515,2515,11,1,0,314,37,351
"3426",20200328,"DE",214,36,NA,31,NA,NA,NA,NA,NA,9,"C","3/28/2020 00:00","0e1c0964ea659bba8085baf08b362d965ff2eb55","2020-03-28T20:00:00Z",3,NA,250,250,250,10,1,0,0,51,51
"3427",20200328,"FL",3763,35366,NA,NA,526,NA,NA,NA,NA,NA,"A","3/28/2020 12:00","f5ece735644659af97b65e84b000fa10a21412b8","2020-03-28T20:00:00Z",54,526,39129,39129,39129,12,20,70,7180,998,8178
"3428",20200328,"GA",2366,8685,NA,NA,617,NA,NA,NA,NA,NA,"A","3/28/2020 11:27","92bb29f067ebca817697dad7557927fbccb6ac70","2020-03-28T20:00:00Z",69,617,11051,11051,11051,13,5,51,821,365,1186
"3429",20200328,"GU",55,299,NA,15,NA,NA,NA,NA,NA,7,"","3/28/2020 03:00","7c31242bf654a89c625c070db8d505aea8848a55","2020-03-28T20:00:00Z",1,NA,354,354,354,66,0,0,0,4,4
"3430",20200328,"HI",120,4357,NA,NA,8,NA,NA,NA,NA,NA,"A","3/27/2020 18:00","12e93aab6c2c73c92742b380a0839ba7c398c9f0","2020-03-28T20:00:00Z",NA,8,4477,4477,4477,15,0,1,0,14,14
"3431",20200328,"IA",298,4375,NA,46,61,NA,NA,NA,NA,15,"C","3/28/2020 00:00","cd492d18d3b66967de51c42ac470bc472a02c1b8","2020-03-28T20:00:00Z",3,61,4673,4673,4673,19,0,11,635,63,698
"3432",20200328,"ID",230,3342,NA,NA,25,NA,NA,NA,NA,NA,"A","3/27/2020 19:00","03a1a0caa26ef4558a1de4a8c132387c3decd5f4","2020-03-28T20:00:00Z",4,25,3572,3572,3572,16,1,25,674,41,715
"3433",20200328,"IL",3491,22000,NA,NA,NA,NA,NA,NA,NA,NA,"A","3/28/2020 00:00","abc3b5d80839604051ee462a292ea27ab704230b","2020-03-28T20:00:00Z",47,NA,25491,25491,25491,17,13,0,3484,465,3949
"3434",20200328,"IN",1232,7175,NA,NA,NA,NA,NA,NA,NA,NA,"B","3/28/2020 11:00","c306ca198a535318ad7ec3cbb2db0675472168ef","2020-03-28T20:00:00Z",31,NA,8407,8407,8407,18,7,0,1220,251,1471
"3435",20200328,"KS",261,3671,NA,NA,27,NA,NA,NA,NA,NA,"B","3/27/2020 09:00","ae5e094172ef3ff8bea1761ff4bc02b671d18e37","2020-03-28T20:00:00Z",5,27,3932,3932,3932,20,1,0,442,59,501
"3436",20200328,"KY",302,4821,NA,NA,NA,NA,NA,NA,NA,NA,"A","3/27/2020 17:00","8039941271343acc82676fc4fce0ee428a8666dd","2020-03-28T20:00:00Z",8,NA,5123,5123,5123,21,2,0,1053,54,1107
"3437",20200328,"LA",3315,21846,NA,927,NA,NA,NA,336,NA,NA,"A","3/28/2020 13:00","3ae95b27a3fa47fe754a21a5bc2b0eedacb50153","2020-03-28T20:00:00Z",137,NA,25161,25161,25161,22,18,0,3233,569,3802
"3438",20200328,"MA",4158,30915,NA,NA,350,NA,NA,NA,NA,NA,"B","3/27/2020 12:30","c5661444338774ff0dd1106cdd745a9ef7d8f88f","2020-03-28T20:00:00Z",72,350,35073,35073,35073,25,15,131,4671,1007,5678
"3439",20200328,"MD",992,11516,NA,NA,226,NA,NA,NA,NA,NA,"D","3/28/2020 10:00","6b10ef68ac2045c0ae255bac0540aff4be8cefc6","2020-03-28T20:00:00Z",5,226,12508,12508,12508,24,0,53,11422,218,11640
"3440",20200328,"ME",211,3394,NA,NA,NA,NA,NA,NA,NA,36,"A","3/28/2020 10:30","0836dc21f397994016d08fef22c52f0070e36917","2020-03-28T20:00:00Z",1,NA,3605,3605,3605,23,0,0,0,43,43
"3441",20200328,"MI",9287,14183,NA,NA,NA,NA,NA,NA,NA,NA,"B","3/27/2020 16:00","6d73c5bc2e0a867a1844e2bf0fb14ebaf9bb3046","2020-03-28T20:00:00Z",92,NA,23470,23470,23470,26,0,0,1544,628,2172
"3442",20200328,"MN",441,15688,NA,30,57,NA,17,NA,NA,215,"A","3/28/2020 00:00","4739496d35bfef611bf4d3707a52c34537d4e1d7","2020-03-28T20:00:00Z",5,57,16129,16129,16129,27,1,6,2083,43,2126
"3443",20200328,"MO",838,10082,NA,NA,NA,NA,NA,NA,NA,NA,"C","3/28/2020 15:00","4309c8eddc27e0747325fc9ff0c5bb9b5f95b504","2020-03-28T20:00:00Z",10,NA,10920,10920,10920,29,2,0,9713,169,9882
"3444",20200328,"MP",2,NA,NA,NA,NA,NA,NA,NA,NA,NA,"","3/28/2020 04:30","5bcad74fdf307c34a5d48407e2fd96b0c2772fbc","2020-03-28T20:00:00Z",NA,NA,2,2,2,69,0,0,0,2,2
"3445",20200328,"MS",663,2560,NA,NA,219,NA,NA,NA,NA,NA,"B","3/28/2020 00:00","be3b6c992b20af4c366a4651675355813f62dddc","2020-03-28T20:00:00Z",13,219,3223,3223,3223,28,5,34,0,84,84
"3446",20200328,"MT",129,3256,NA,NA,7,NA,NA,NA,NA,NA,"A","3/28/2020 12:30","a550cf68190ead3c7bc61cd1531b6ac153504f3a","2020-03-28T20:00:00Z",1,7,3385,3385,3385,30,1,0,666,21,687
"3447",20200328,"NC",935,16592,NA,87,NA,NA,NA,NA,NA,NA,"A","3/28/2020 10:55","1c756c6fe9bc72219d425a091fe36b19e1989dd2","2020-03-28T20:00:00Z",4,NA,17527,17527,17527,37,1,0,2219,172,2391
"3448",20200328,"ND",83,2809,NA,NA,16,NA,NA,NA,NA,16,"B","3/28/2020 12:00","2740776204678ac4243b5fb70a7901c184231b86","2020-03-28T20:00:00Z",1,16,2892,2892,2892,38,1,3,382,18,400
"3449",20200328,"NE",96,1904,NA,NA,NA,NA,NA,NA,NA,NA,"A","3/28/2020 14:40","8e68e3e432ab8be0e8e28c340074fd9cc5c737dd","2020-03-28T20:00:00Z",2,NA,2000,2000,2000,31,2,0,143,11,154
"3450",20200328,"NH",187,3656,296,NA,30,NA,NA,NA,NA,NA,"B","3/27/2020 09:00","cc255564acefd16e47601e8119d7ce5d98c47c39","2020-03-28T20:00:00Z",2,30,4139,3843,3843,33,1,5,261,29,290
"3451",20200328,"NJ",11124,19386,NA,2000,NA,NA,NA,NA,NA,NA,"A","3/28/2020 13:30","3e3076748751e57a62347a7d715cbc49b7191b96","2020-03-28T20:00:00Z",140,NA,30510,30510,30510,34,32,0,2839,2299,5138
"3452",20200328,"NM",191,9196,NA,17,NA,NA,NA,NA,NA,NA,"A","3/27/2020 00:00","43ca4cfa205a6717286ff3aac99fbacc8cf11d35","2020-03-28T20:00:00Z",1,NA,9387,9387,9387,35,0,0,819,55,874
"3453",20200328,"NV",621,7901,NA,NA,NA,NA,NA,NA,NA,NA,"A","3/27/2020 22:00","c87395fc2578b283567472f39b42b356599c61ec","2020-03-28T20:00:00Z",10,NA,8522,8522,8522,32,0,0,1740,86,1826
"3454",20200328,"NY",52318,103616,NA,7328,10054,1755,NA,NA,NA,2726,"A","3/28/2020 13:15","bff2cfbfc7d59b136600e875ae44039201658e70","2020-03-28T20:00:00Z",728,10054,155934,155934,155934,36,209,1528,2498,7683,10181
"3455",20200328,"OH",1406,19012,NA,NA,344,NA,123,NA,NA,NA,"B","3/28/2020 14:00","35df4a243590edcaf24b08b55c221bcdcd6fbb33","2020-03-28T20:00:00Z",25,344,20418,20418,20418,39,6,68,0,269,269
"3456",20200328,"OK",377,1180,NA,NA,126,NA,NA,NA,NA,NA,"A","3/27/2020 08:00","18e4518b4be3a9be844fc1846bfdc8c85c3daa04","2020-03-28T20:00:00Z",15,126,1557,1557,1557,40,7,21,96,55,151
"3457",20200328,"OR",479,9693,NA,107,117,NA,NA,31,NA,NA,"A","3/27/2020 12:30","c970796fd85155f49624be3e4e2b897b73d71ff9","2020-03-28T20:00:00Z",13,117,10172,10172,10172,41,1,15,1183,65,1248
"3458",20200328,"PA",2751,25254,NA,NA,316,NA,NA,NA,NA,NA,"A","3/28/2020 12:00","762b39d33cb6cbee04a3f1a38220ff5b1adadf2d","2020-03-28T20:00:00Z",34,316,28005,28005,28005,42,12,75,4238,533,4771
"3459",20200328,"PR",100,739,792,NA,NA,NA,NA,NA,NA,NA,"A","3/28/2020 07:00","95379ab6295b07559a06bc4bec99b223b4a1b825","2020-03-28T20:00:00Z",3,NA,1631,839,839,72,0,0,220,21,241
"3460",20200328,"RI",239,2541,138,29,NA,9,NA,6,NA,NA,"B","3/28/2020 00:00","5ef7dcf3ac4748ad926915221e7f4f96f9bcbd2b","2020-03-28T20:00:00Z",NA,NA,2918,2780,2780,44,0,0,235,36,271
"3461",20200328,"SC",539,2408,NA,NA,102,NA,NA,NA,NA,NA,"B","3/27/2020 16:32","e8d8dca5081e2e25edde42b643fe244eebc98f69","2020-03-28T20:00:00Z",13,102,2947,2947,2947,45,4,0,101,83,184
"3462",20200328,"SD",68,2592,0,NA,NA,NA,NA,NA,NA,26,"A","3/28/2020 12:30","4ef4b3b2fbed327be659f67c86ebb2984516d840","2020-03-28T20:00:00Z",1,NA,2660,2660,2660,46,0,0,205,10,215
"3463",20200328,"TN",1373,16965,NA,NA,118,NA,NA,NA,NA,NA,"A","3/27/2020 15:00","bd83a18dc39c8ee56326d83a590b8da9e19eb4b3","2020-03-28T20:00:00Z",6,118,18338,18338,18338,47,0,15,2077,170,2247
"3464",20200328,"TX",2052,23208,NA,NA,NA,NA,NA,NA,NA,NA,"A","3/28/2020 12:45","1731582d2f3336e58d58889c13bd45c05149c515","2020-03-28T20:00:00Z",27,NA,25260,25260,25260,48,4,0,1273,321,1594
"3465",20200328,"UT",602,10710,NA,NA,NA,NA,NA,NA,NA,NA,"A","3/28/2020 15:00","e7916d5722a5032b8d9634894175d1f0ef6d4e48","2020-03-28T20:00:00Z",2,NA,11312,11312,11312,49,0,0,1946,122,2068
"3466",20200328,"VA",739,8427,NA,NA,99,NA,NA,NA,NA,NA,"A","3/28/2020 00:00","8d0d09bf763747838e702297e46e1d9ef69db703","2020-03-28T20:00:00Z",17,99,9166,9166,9166,51,3,16,1694,135,1829
"3467",20200328,"VI",22,106,55,NA,NA,NA,NA,NA,NA,NA,"","3/28/2020 12:00","8c9447de54cee4e82bb8d22062fcfcfc0abe3612","2020-03-28T20:00:00Z",NA,NA,183,128,128,78,0,0,51,3,54
"3468",20200328,"VT",234,3192,NA,NA,18,NA,NA,NA,NA,NA,"A","3/28/2020 00:00","de3d13317809be1f0346e6307e17dd2f023f8107","2020-03-28T20:00:00Z",12,18,3426,3426,3426,50,2,0,324,21,345
"3469",20200328,"WA",5642,68163,NA,NA,NA,NA,NA,NA,NA,NA,"A","3/28/2020 00:00","d857badf616df70b93459334392c4895bbd19c56","2020-03-28T20:00:00Z",220,NA,73805,73805,73805,53,21,0,2319,283,2602
"3470",20200328,"WI",989,15232,NA,NA,NA,NA,NA,NA,NA,NA,"A","3/28/2020 16:00","c10a91baff002e0dd3bffc42bad493faba628f54","2020-03-28T20:00:00Z",13,NA,16221,16221,16221,55,0,0,2092,147,2239
"3471",20200328,"WV",96,2331,6,NA,1,NA,NA,NA,NA,NA,"B","3/27/2020 00:00","a0982c7c37f0d340cf2ab12ee2ecf3b6f8dccf04","2020-03-28T20:00:00Z",0,1,2433,2427,2427,54,0,0,552,20,572
"3472",20200328,"WY",82,1475,NA,NA,14,NA,NA,NA,NA,18,"A","3/28/2020 00:00","b52c1c6792b74d0be877ac6e352510f63d4cb697","2020-03-28T20:00:00Z",0,14,1557,1557,1557,56,0,3,264,12,276
"3473",20200327,"AK",69,2319,13,NA,3,NA,NA,NA,NA,NA,"A","3/26/2020 21:00","c4b13c790d9f110fcd6ea9bbe4323c80e4982d67","2020-03-27T20:00:00Z",1,3,2401,2388,2388,2,0,0,518,10,528
"3474",20200327,"AL",587,4184,NA,NA,NA,NA,NA,NA,NA,NA,"B","3/27/2020 00:00","445884024903deeb398494c03bb278e739dd8e79","2020-03-27T20:00:00Z",3,NA,4771,4771,4771,1,2,0,591,81,672
"3475",20200327,"AR",381,1545,NA,48,NA,NA,NA,17,NA,19,"A","3/27/2020 14:05","4867d4843328269469ae9001f9c70d6a95543816","2020-03-27T20:00:00Z",3,NA,1926,1926,1926,5,0,0,41,46,87
"3476",20200327,"AS",NA,NA,NA,NA,NA,NA,NA,NA,NA,NA,"","3/27/2020 00:00","3e82ec53ac8168f279ee98bed371e8462348ffda","2020-03-27T20:00:00Z",0,NA,0,0,0,60,0,0,0,0,0
"3477",20200327,"AZ",736,7455,30,NA,NA,NA,NA,NA,NA,NA,"B","3/27/2020 00:00","8db866af12c13df3a35779c20dbb4bdf9a938590","2020-03-27T20:00:00Z",13,NA,8221,8191,8191,4,5,0,7108,159,7267
"3478",20200327,"CA",3879,17380,57400,746,NA,200,NA,NA,NA,NA,"B","3/27/2020 00:00","676239d47a722c18fdd37bb6f259660cd5386e58","2020-03-27T20:00:00Z",78,NA,78659,21259,21259,6,13,0,0,873,873
"3479",20200327,"CO",1430,8692,NA,278,184,NA,NA,NA,NA,NA,"A","3/26/2020 18:00","91d09d3957251cb76ac5665f2ce281955d18dba4","2020-03-27T20:00:00Z",24,184,10122,10122,10122,8,5,36,1714,344,2058
"3480",20200327,"CT",1291,7109,NA,173,NA,NA,NA,NA,NA,NA,"A","3/27/2020 13:30","e99be91d6dd7a1fbae0109289970826733a6a719","2020-03-27T20:00:00Z",27,NA,8400,8400,8400,9,6,0,1484,279,1763
"3481",20200327,"DC",267,1897,2,NA,NA,NA,NA,NA,NA,49,"A","3/26/2020 19:00","0519eb45524ce070b353c39dd993bb9e1d8a5c27","2020-03-27T20:00:00Z",3,NA,2166,2164,2164,11,0,0,271,36,307
"3482",20200327,"DE",163,36,NA,15,NA,NA,NA,NA,NA,9,"C","3/27/2020 00:00","123c7675ec3fef70c48885d28552c7baa95a9fcc","2020-03-27T20:00:00Z",2,NA,199,199,199,10,1,0,0,33,33
"3483",20200327,"FL",2765,28186,1517,NA,456,NA,NA,NA,NA,NA,"A","3/27/2020 12:00","3e642ef8e8f4bff79615337e32cfc4f7fdf3bd06","2020-03-27T20:00:00Z",34,456,32468,30951,30951,12,6,50,4445,410,4855
"3484",20200327,"GA",2001,7864,NA,NA,566,NA,NA,NA,NA,NA,"A","3/27/2020 12:00","c9b52e3568e4b59c1ac1316a0d2c86a5659a329b","2020-03-27T20:00:00Z",64,566,9865,9865,9865,13,16,93,463,476,939
"3485",20200327,"GU",51,299,NA,13,NA,NA,NA,NA,NA,NA,"","3/27/2020 07:00","4b903f511047b26fb601ca612daa5ec82f78d952","2020-03-27T20:00:00Z",1,NA,350,350,350,66,0,0,36,6,42
"3486",20200327,"HI",106,4357,NA,NA,7,NA,NA,NA,NA,NA,"A","3/26/2020 18:00","6af67cadb0d5ef6cbd519f9c5ed1cbafff454766","2020-03-27T20:00:00Z",NA,7,4463,4463,4463,15,0,2,0,11,11
"3487",20200327,"IA",235,3740,NA,32,50,NA,NA,NA,NA,18,"C","3/27/2020 15:40","f4c7f099ccba4abc8467acd36d07f99583db9b2e","2020-03-27T20:00:00Z",3,50,3975,3975,3975,19,2,4,1162,56,1218
"3488",20200327,"ID",189,2668,NA,NA,NA,NA,NA,NA,NA,NA,"A","3/26/2020 20:00","206b099d81bd9c26b69ce9d1503f8c25d8c63788","2020-03-27T20:00:00Z",3,NA,2857,2857,2857,16,3,0,603,66,669
"3489",20200327,"IL",3026,18516,NA,NA,NA,NA,NA,NA,NA,NA,"A","3/27/2020 00:00","104044606552671318c98a6916f1fe32d3f19658","2020-03-27T20:00:00Z",34,NA,21542,21542,21542,17,8,0,4423,488,4911
"3490",20200327,"IN",981,5955,NA,NA,NA,NA,NA,NA,NA,NA,"B","3/26/2020 12:59","1b9a2fa2cecd59e5f22a41230f251f93537e05c6","2020-03-27T20:00:00Z",24,NA,6936,6936,6936,18,7,0,1949,336,2285
"3491",20200327,"KS",202,3229,NA,NA,27,NA,NA,NA,NA,NA,"B","3/27/2020 09:00","6c06b7270fa10695968029fa4a2a932ff4bd4455","2020-03-27T20:00:00Z",4,27,3431,3431,3431,20,1,27,360,34,394
"3492",20200327,"KY",248,3768,NA,NA,NA,NA,NA,NA,NA,NA,"A","3/26/2020 17:00","e4f10985eeb5da1b0d4cb5a35e440d601108a636","2020-03-27T20:00:00Z",6,NA,4016,4016,4016,21,2,0,666,50,716
"3493",20200327,"LA",2746,18613,NA,773,NA,NA,NA,270,NA,NA,"A","3/27/2020 13:00","2fc5c8ee702d72cebe9a33e26b958a8bf0adcb89","2020-03-27T20:00:00Z",119,NA,21359,21359,21359,22,36,0,2889,441,3330
"3494",20200327,"MA",3151,26244,NA,NA,219,NA,NA,NA,NA,NA,"B","3/27/2020 12:30","c42d64799a8cb6bd234becbe6cf9b33d9fafd5a0","2020-03-27T20:00:00Z",57,219,29395,29395,29395,25,15,0,4917,833,5750
"3495",20200327,"MD",774,94,NA,NA,173,NA,NA,NA,NA,25,"D","3/27/2020 10:00","733d24f89ec9db50d437f5ac4f6665fed4f95119","2020-03-27T20:00:00Z",5,173,868,868,868,24,1,41,0,194,194
"3496",20200327,"ME",168,3394,NA,NA,NA,NA,NA,NA,NA,24,"A","3/27/2020 11:30","dbeb268328393dc92180927617e14dcb6f056b64","2020-03-27T20:00:00Z",1,NA,3562,3562,3562,23,1,0,0,13,13
"3497",20200327,"MI",8659,12639,NA,NA,NA,NA,NA,NA,NA,NA,"B","3/27/2020 11:00","9e7ebd82e83a16519be4d26333e4d5cc101a4053","2020-03-27T20:00:00Z",92,NA,21298,21298,21298,26,32,0,2334,892,3226
"3498",20200327,"MN",398,13605,NA,34,51,NA,17,NA,NA,176,"A","3/27/2020 00:00","5aa8bd4a31ed5254969ece08d285695f5910befc","2020-03-27T20:00:00Z",4,51,14003,14003,14003,27,2,10,1001,52,1053
"3499",20200327,"MO",669,369,NA,NA,NA,NA,NA,NA,NA,NA,"C","3/27/2020 00:00","deb09d39dfad307c9285bd2dfc3282abd166f644","2020-03-27T20:00:00Z",8,NA,1038,1038,1038,29,0,0,0,167,167
"3500",20200327,"MP",0,NA,NA,NA,NA,NA,NA,NA,NA,NA,"","3/26/2020 13:30","721770b120e4ef791be79ddd8f3e616e480529da","2020-03-27T20:00:00Z",0,NA,0,0,0,69,0,0,0,0,0
"3501",20200327,"MS",579,2560,NA,NA,185,NA,NA,NA,NA,NA,"B","3/26/2020 19:00","023e0e2c67538edb60ca3c9bbe2ec122b137d070","2020-03-27T20:00:00Z",8,185,3139,3139,3139,28,2,35,269,94,363
"3502",20200327,"MT",108,2590,NA,NA,7,NA,NA,NA,NA,NA,"A","3/27/2020 10:00","dd6c46ddd24878dac57fdbfe1370e1ca2527ca60","2020-03-27T20:00:00Z",NA,7,2698,2698,2698,30,0,6,462,37,499
"3503",20200327,"NC",763,14373,NA,77,NA,NA,NA,NA,NA,NA,"A","3/27/2020 11:40","48bb94361fd0567d187af19d12522fb895e78ca8","2020-03-27T20:00:00Z",3,NA,15136,15136,15136,37,1,0,2099,127,2226
"3504",20200327,"ND",65,2427,NA,NA,13,NA,NA,NA,NA,15,"B","3/27/2020 11:31","448213f30a90ca4508be99c8a14b790d8f6ab387","2020-03-27T20:00:00Z",0,13,2492,2492,2492,38,0,3,388,13,401
"3505",20200327,"NE",85,1761,NA,NA,NA,NA,NA,NA,NA,NA,"A","3/27/2020 14:30","761bcd32966118d4da256c994e84d23b3909c082","2020-03-27T20:00:00Z",0,NA,1846,1846,1846,31,0,0,177,12,189
"3506",20200327,"NH",158,3395,592,NA,25,NA,NA,NA,NA,NA,"B","3/26/2020 09:00","edf015ae3e4a7b9cfddb8811bf3a2ef0b6c9e277","2020-03-27T20:00:00Z",1,25,4145,3553,3553,33,0,6,394,21,415
"3507",20200327,"NJ",8825,16547,NA,2000,NA,NA,NA,NA,NA,NA,"A","3/27/2020 13:30","72f99280fdc8565fd36094eb44e33cf380762661","2020-03-27T20:00:00Z",108,NA,25372,25372,25372,34,27,0,2886,1949,4835
"3508",20200327,"NM",136,8377,NA,NA,NA,NA,NA,NA,NA,NA,"A","3/26/2020 00:00","ce48027c706375b3c6fcf6eb3d870e42c7be711f","2020-03-27T20:00:00Z",1,NA,8513,8513,8513,35,0,0,696,24,720
"3509",20200327,"NV",535,6161,NA,NA,NA,NA,NA,NA,NA,NA,"A","3/26/2020 23:00","6f16190cf940aa38fc2cac838757b7380a511d77","2020-03-27T20:00:00Z",10,NA,6696,6696,6696,32,0,0,1464,115,1579
"3510",20200327,"NY",44635,101118,NA,6481,8526,1583,NA,NA,NA,2045,"A","3/27/2020 11:15","04fc13195c2f6f99023c2a165488143fa7011847","2020-03-27T20:00:00Z",519,8526,145753,145753,145753,36,134,1682,16272,7377,23649
"3511",20200327,"OH",1137,19012,NA,NA,276,NA,107,NA,NA,NA,"B","3/27/2020 14:00","5656910a8b68eeca7a22cf8e07f319832903644f","2020-03-27T20:00:00Z",19,276,20149,20149,20149,39,4,53,2563,270,2833
"3512",20200327,"OK",322,1084,NA,NA,105,NA,NA,NA,NA,NA,"A","3/27/2020 08:00","b2b43d843fb3376f921c6c760abd9bde9bf3dfae","2020-03-27T20:00:00Z",8,105,1406,1406,1406,40,1,19,126,74,200
"3513",20200327,"OR",414,8510,NA,91,102,NA,NA,31,NA,NA,"A","3/27/2020 12:30","299ca9adc81eee959f3c78a5381e5c03fd190141","2020-03-27T20:00:00Z",12,102,8924,8924,8924,41,1,12,1557,87,1644
"3514",20200327,"PA",2218,21016,NA,NA,241,NA,NA,NA,NA,NA,"A","3/27/2020 12:00","0a5a43609288cd2b196423b8b07edbdac1b7060a","2020-03-27T20:00:00Z",22,241,23234,23234,23234,42,6,241,4575,531,5106
"3515",20200327,"PR",79,519,334,NA,NA,NA,NA,NA,NA,NA,"A","3/27/2020 07:00","630d4dab82f37bab3a5ffb6530808ae6f4889045","2020-03-27T20:00:00Z",3,NA,932,598,598,72,1,0,142,15,157
"3516",20200327,"RI",203,2306,138,28,NA,9,NA,6,NA,NA,"B","3/27/2020 00:00","b3c0dc2540ec70c82ee92675fcf62f35ef5221bb","2020-03-27T20:00:00Z",NA,NA,2647,2509,2509,44,0,0,1044,38,1082
"3517",20200327,"SC",456,2307,NA,NA,102,NA,NA,NA,NA,NA,"B","3/26/2020 16:35","5ca233424c9fbfb777a88f9ebe1b992470cc3b5c","2020-03-27T20:00:00Z",9,102,2763,2763,2763,45,0,0,0,0,0
"3518",20200327,"SD",58,2387,20,NA,NA,NA,NA,NA,NA,21,"A","3/27/2020 12:30","6bf399ee935fce63331434b46c95e49032de3b5d","2020-03-27T20:00:00Z",1,NA,2465,2445,2445,46,0,0,414,12,426
"3519",20200327,"TN",1203,14888,NA,NA,103,NA,NA,NA,NA,NA,"A","3/27/2020 15:00","748533ae139100c8a1181dc23662f47a07ff86c6","2020-03-27T20:00:00Z",6,103,16091,16091,16091,47,3,27,936,246,1182
"3520",20200327,"TX",1731,21935,NA,NA,NA,NA,NA,NA,NA,NA,"A","3/27/2020 13:00","2b18573393e9a459979c059753837f3f11e28995","2020-03-27T20:00:00Z",23,NA,23666,23666,23666,48,5,0,1907,335,2242
"3521",20200327,"UT",480,8764,NA,NA,NA,NA,NA,NA,NA,NA,"A","3/27/2020 15:00","1592f075130579f1ee7316b7caf4d8d99b1c84ee","2020-03-27T20:00:00Z",2,NA,9244,9244,9244,49,1,0,1456,78,1534
"3522",20200327,"VA",604,6733,NA,NA,83,NA,NA,NA,NA,NA,"A","3/27/2020 00:00","a62c95c2410d72fa761c9da414f16bfd6af7ecdc","2020-03-27T20:00:00Z",14,83,7337,7337,7337,51,1,18,1004,144,1148
"3523",20200327,"VI",19,55,2,NA,NA,NA,NA,NA,NA,NA,"","3/27/2020 14:00","550db378244deb6005d46d173c73474345da65fa","2020-03-27T20:00:00Z",NA,NA,76,74,74,78,0,0,0,2,2
"3524",20200327,"VT",213,2868,NA,NA,18,NA,NA,NA,NA,NA,"A","3/27/2020 00:00","0081e4f430b051d684787e389b9dbcda0f466277","2020-03-27T20:00:00Z",10,18,3081,3081,3081,50,1,18,124,28,152
"3525",20200327,"WA",5359,65844,NA,NA,NA,NA,NA,NA,NA,NA,"A","3/27/2020 00:00","ff5aca50fae41fc1ce8f11be46833c730a58a32a","2020-03-27T20:00:00Z",199,NA,71203,71203,71203,53,16,0,3900,450,4350
"3526",20200327,"WI",842,13140,NA,NA,NA,NA,NA,NA,NA,NA,"A","3/27/2020 16:00","3e3b99d24e052578788d6ac777cc0d5c327fd5ec","2020-03-27T20:00:00Z",13,NA,13982,13982,13982,55,5,0,1557,135,1692
"3527",20200327,"WV",76,1779,43,NA,1,NA,NA,NA,NA,NA,"B","3/26/2020 00:00","0ca57409c9d750ac08f280083c784b65d205ce6e","2020-03-27T20:00:00Z",0,1,1898,1855,1855,54,0,0,748,25,773
"3528",20200327,"WY",70,1211,NA,NA,11,NA,NA,NA,NA,17,"A","3/27/2020 12:50","6371cc01439e958e78ae680dd04a3c0178df4cd4","2020-03-27T20:00:00Z",0,11,1281,1281,1281,56,0,11,159,17,176
"3529",20200326,"AK",59,1801,NA,NA,3,NA,NA,NA,NA,NA,"A","3/25/2020 21:00","ec77c3bf1ed295816f9ba1bc2eb33ca18cb1916b","2020-03-26T20:00:00Z",1,3,1860,1860,1860,2,0,2,152,17,169
"3530",20200326,"AL",506,3593,NA,NA,NA,NA,NA,NA,NA,NA,"C","3/26/2020 00:00","dcc7f8f7cc56486858d5ca441e0c7a9e1c0a099e","2020-03-26T20:00:00Z",1,NA,4099,4099,4099,1,1,0,1064,223,1287
"3531",20200326,"AR",335,1504,NA,41,NA,NA,NA,13,NA,13,"A","3/26/2020 00:00","26c2705c0be18308e63e954f81708110e6ab2ef8","2020-03-26T20:00:00Z",3,NA,1839,1839,1839,5,1,0,67,55,122
"3532",20200326,"AS",NA,NA,NA,NA,NA,NA,NA,NA,NA,NA,"","3/25/2020 00:00","939714a5f3b2e4c355e41e763f36bce165dfa516","2020-03-26T20:00:00Z",0,NA,0,0,0,60,0,0,0,0,0
"3533",20200326,"AZ",577,347,33,NA,NA,NA,NA,NA,NA,NA,"B","3/26/2020 00:00","461dcf19cf752479ab7e31412282cea80d3cc180","2020-03-26T20:00:00Z",8,NA,957,924,924,4,2,0,24,127,151
"3534",20200326,"CA",3006,17380,57400,NA,NA,NA,NA,NA,NA,NA,"B","3/25/2020 17:00","a4865c9629fade015b8a5721dbf3007ffcaad4f1","2020-03-26T20:00:00Z",65,NA,77786,20386,20386,6,12,0,1459,651,2110
"3535",20200326,"CO",1086,6978,NA,230,148,NA,NA,NA,NA,NA,"A","3/25/2020 18:00","e4e8ad1dcccde254b9ac0d200e8217eb39bf195c","2020-03-26T20:00:00Z",19,148,8064,8064,8064,8,8,64,189,174,363
"3536",20200326,"CT",1012,5625,NA,125,NA,NA,NA,NA,NA,NA,"A","3/26/2020 16:00","69fc57de33c6c0f8e09701fd1c30b1187b6d47c0","2020-03-26T20:00:00Z",21,NA,6637,6637,6637,9,2,0,602,137,739
"3537",20200326,"DC",231,1626,1,NA,NA,NA,NA,NA,NA,21,"A","3/25/2020 00:00","daa3053c2a3d02b80b307802675f382ec440b16d","2020-03-26T20:00:00Z",3,NA,1858,1857,1857,11,1,0,203,48,251
"3538",20200326,"DE",130,36,NA,13,NA,NA,NA,NA,NA,4,"C","3/26/2020 00:00","f046e233388cec5b88729d387119c9300958b221","2020-03-26T20:00:00Z",1,NA,166,166,166,10,1,0,0,15,15
"3539",20200326,"FL",2355,23741,1443,NA,406,NA,NA,NA,NA,NA,"A","3/26/2020 11:00","2384ad95631a8298024b4c58c99e39a949eb4671","2020-03-26T20:00:00Z",28,406,27539,26096,26096,12,6,90,8367,673,9040
"3540",20200326,"GA",1525,7401,NA,NA,473,NA,NA,NA,NA,NA,"A","3/26/2020 12:00","6d473e147321df8bbcb1fe2d4d5166c6ea4f7f75","2020-03-26T20:00:00Z",48,473,8926,8926,8926,13,8,79,2469,278,2747
"3541",20200326,"GU",45,263,NA,11,NA,NA,NA,NA,NA,NA,"","3/26/2020 06:30","16d69f171db00c3b643008e226c0e95ac1f2809c","2020-03-26T20:00:00Z",1,NA,308,308,308,66,0,0,30,8,38
"3542",20200326,"HI",95,4357,NA,NA,5,NA,NA,NA,NA,NA,"A","3/25/2020 18:00","eb01e93536cf15994a479f8ae4addd0cc96b3b9c","2020-03-26T20:00:00Z",NA,5,4452,4452,4452,15,0,-1,0,5,5
"3543",20200326,"IA",179,2578,NA,31,46,NA,NA,NA,NA,15,"C","3/26/2020 00:00","41561df8d2bce6fab97bbb1858c3c2282ac3e7cd","2020-03-26T20:00:00Z",1,46,2757,2757,2757,19,0,10,0,34,34
"3544",20200326,"ID",123,2065,NA,NA,NA,NA,NA,NA,NA,NA,"A","3/25/2020 19:00","ac731d0baf23e0b87aed73fb1a03bb2a966c0cad","2020-03-26T20:00:00Z",0,NA,2188,2188,2188,16,0,0,178,50,228
"3545",20200326,"IL",2538,14093,NA,NA,NA,NA,NA,NA,NA,NA,"A","3/26/2020 00:00","e73689a554afd38adb1fcbb70fb98ee446b712f7","2020-03-26T20:00:00Z",26,NA,16631,16631,16631,17,7,0,1749,673,2422
"3546",20200326,"IN",645,4006,NA,NA,NA,NA,NA,NA,NA,NA,"B","3/25/2020 12:59","ada1e86902090d8e67fd3d8d8bb727718d514c36","2020-03-26T20:00:00Z",17,NA,4651,4651,4651,18,3,0,1127,168,1295
"3547",20200326,"KS",168,2869,NA,NA,NA,NA,NA,NA,NA,NA,"B","3/26/2020 12:00","1d94d92e3b84173f37d2c5291f6c3489e4bacb0b","2020-03-26T20:00:00Z",3,NA,3037,3037,3037,20,0,0,509,42,551
"3548",20200326,"KY",198,3102,NA,NA,NA,NA,NA,NA,NA,NA,"A","3/25/2020 17:00","c04eee9e8fdbd29f42975e04031170f7b3ef5eb8","2020-03-26T20:00:00Z",4,NA,3300,3300,3300,21,0,0,237,41,278
"3549",20200326,"LA",2305,15724,NA,676,NA,NA,NA,239,NA,NA,"A","3/26/2020 15:00","bddced6e06c416818a74177202b7bd46cd1efeea","2020-03-26T20:00:00Z",83,NA,18029,18029,18029,22,18,0,6068,510,6578
"3550",20200326,"MA",2318,21327,NA,NA,219,NA,NA,NA,NA,NA,"B","3/26/2020 12:30","08d76813a076b49074eb6af95db1c792035ab0b6","2020-03-26T20:00:00Z",42,219,23645,23645,23645,25,9,116,3248,579,3827
"3551",20200326,"MD",580,94,NA,NA,132,NA,NA,NA,NA,NA,"D","3/26/2020 10:00","1d5357ae89d708bab091026700f814cc4923632d","2020-03-26T20:00:00Z",4,132,674,674,674,24,0,132,0,157,157
"3552",20200326,"ME",155,3394,NA,NA,NA,NA,NA,NA,NA,16,"A","3/26/2020 11:00","0dff50b7860a38e97521d2795e7df0adec7354a7","2020-03-26T20:00:00Z",NA,NA,3549,3549,3549,23,0,0,217,6,223
"3553",20200326,"MI",7767,10305,NA,NA,NA,NA,NA,NA,NA,NA,"D","3/26/2020 11:00","a300d070c2cd56bf617afea3c1efbb6ef2254387","2020-03-26T20:00:00Z",60,NA,18072,18072,18072,26,17,0,2768,707,3475
"3554",20200326,"MN",346,12604,NA,31,41,NA,NA,NA,NA,NA,"A","3/26/2020 13:15","6aad9324340b3006e5c50b07aafedd156f830b77","2020-03-26T20:00:00Z",2,41,12950,12950,12950,27,1,6,1416,59,1475
"3555",20200326,"MO",502,369,NA,NA,NA,NA,NA,NA,NA,NA,"C","3/26/2020 15:00","2b8690ad06bec833d05800cf511ab76690b4e9ab","2020-03-26T20:00:00Z",8,NA,871,871,871,29,0,0,0,146,146
"3556",20200326,"MP",0,NA,NA,NA,NA,NA,NA,NA,NA,NA,"","3/26/2020 01:30","aa3edb7e40429d19b9ad9f42423783b4c739df13","2020-03-26T20:00:00Z",0,NA,0,0,0,69,0,0,0,0,0
"3557",20200326,"MS",485,2291,NA,NA,150,NA,NA,NA,NA,NA,"B","3/26/2020 00:00","1235b6a0cd406d77cdfc6801ecd2c10315cb94b0","2020-03-26T20:00:00Z",6,150,2776,2776,2776,28,4,33,725,108,833
"3558",20200326,"MT",71,2128,NA,NA,1,NA,NA,NA,NA,NA,"C","3/26/2020 10:00","8b718f1b0e83974f2df3f4d58e19504275854026","2020-03-26T20:00:00Z",NA,1,2199,2199,2199,30,0,1,180,18,198
"3559",20200326,"NC",636,12274,NA,29,NA,NA,NA,NA,NA,NA,"A","3/26/2020 12:36","54c14b8a4b8682a4e195b22c49876da5d2cedf3b","2020-03-26T20:00:00Z",2,NA,12910,12910,12910,37,1,0,2289,132,2421
"3560",20200326,"ND",52,2039,NA,NA,10,NA,NA,NA,NA,NA,"B","3/26/2020 11:37","99d4afdbfd84b3272c93abf3574e54cc5db0b625","2020-03-26T20:00:00Z",0,10,2091,2091,2091,38,0,2,305,13,318
"3561",20200326,"NE",73,1584,NA,NA,NA,NA,NA,NA,NA,NA,"A","3/26/2020 14:00","32db2a0581e793197ce51e654af4bcdfa07dc9fd","2020-03-26T20:00:00Z",0,NA,1657,1657,1657,31,0,0,280,12,292
"3562",20200326,"NH",137,3001,712,NA,19,NA,NA,NA,NA,NA,"B","3/25/2020 09:00","67da08b83cbbecbc0e2cd7dabb6acf399db558cc","2020-03-26T20:00:00Z",1,19,3850,3138,3138,33,0,6,645,29,674
"3563",20200326,"NJ",6876,13661,NA,1080,NA,NA,NA,NA,NA,NA,"B","3/25/2020 14:00","05d4fd1931db94a24de6cd3951c4ff9b3812dab5","2020-03-26T20:00:00Z",81,NA,20537,20537,20537,34,19,0,3209,2474,5683
"3564",20200326,"NM",112,7681,NA,NA,NA,NA,NA,NA,NA,NA,"A","3/25/2020 00:00","6c73f9df44f085bc31b888ed0a7f9dccfc66c479","2020-03-26T20:00:00Z",1,NA,7793,7793,7793,35,0,0,939,12,951
"3565",20200326,"NV",420,4697,NA,NA,NA,NA,NA,NA,NA,NA,"A","3/26/2020 11:00","624cd3f656d1a06af370ea5f21d2eecfd1984f5e","2020-03-26T20:00:00Z",10,NA,5117,5117,5117,32,4,0,446,99,545
"3566",20200326,"NY",37258,84846,NA,5327,6844,1290,NA,NA,NA,NA,"B","3/26/2020 16:59","19363ab62d6ce0eea5e7c372af2d1c5c9c301cb3","2020-03-26T20:00:00Z",385,6844,122104,122104,122104,36,100,3039,12178,6447,18625
"3567",20200326,"OH",867,16449,NA,NA,223,NA,91,NA,NA,NA,"B","3/26/2020 14:00","2b95bc867f64d6ac6d7af40ec6b45724a87125bd","2020-03-26T20:00:00Z",15,223,17316,17316,17316,39,5,41,2389,163,2552
"3568",20200326,"OK",248,958,NA,NA,86,NA,NA,NA,NA,NA,"A","3/26/2020 08:00","8cdb4330a4bd606b04409e2988b4e31d60348189","2020-03-26T20:00:00Z",7,86,1206,1206,1206,40,2,27,153,84,237
"3569",20200326,"OR",327,6953,NA,NA,90,NA,NA,NA,NA,NA,"A","3/26/2020 16:31","5e0bc42adf493acc46f4afe5d67e9ad62be2f1b9","2020-03-26T20:00:00Z",11,90,7280,7280,7280,41,3,29,2603,118,2721
"3570",20200326,"PA",1687,16441,NA,NA,NA,NA,NA,NA,NA,NA,"A","3/26/2020 12:00","9e01f2de1cc50ad13f3477fe1e4efe1e685d7e03","2020-03-26T20:00:00Z",16,NA,18128,18128,18128,42,5,0,5248,560,5808
"3571",20200326,"PR",64,377,335,NA,NA,NA,NA,NA,NA,NA,"A","3/26/2020 07:00","f7e3e0ebcf4d16bedcf305bd1cca17e0b823b961","2020-03-26T20:00:00Z",2,NA,776,441,441,72,0,0,60,13,73
"3572",20200326,"RI",165,1262,181,23,NA,9,NA,6,NA,NA,"B","3/26/2020 00:00","38aac2a020004d3037a1f9d1904e6b8a2bed8044","2020-03-26T20:00:00Z",NA,NA,1608,1427,1427,44,0,0,0,33,33
"3573",20200326,"SC",456,2307,NA,NA,102,NA,NA,NA,NA,NA,"B","3/26/2020 11:00","63219f8ce772781f68800817aa25c53aaa88e126","2020-03-26T20:00:00Z",9,102,2763,2763,2763,45,2,0,4,32,36
"3574",20200326,"SD",46,1973,125,NA,NA,NA,NA,NA,NA,16,"A","3/25/2020 13:00","45f68447ca72c5f5b4940bb67724e82d365c3996","2020-03-26T20:00:00Z",1,NA,2144,2019,2019,46,0,0,1154,5,1159
"3575",20200326,"TN",957,13952,NA,NA,76,NA,NA,NA,NA,NA,"A","3/26/2020 15:00","371de36b66b7f6ad704b72e3877b10162fb743b2","2020-03-26T20:00:00Z",3,76,14909,14909,14909,47,0,23,2940,173,3113
"3576",20200326,"TX",1396,20028,NA,NA,NA,NA,NA,NA,NA,NA,"A","3/26/2020 13:00","8d05dc79f19635cc610e7fd2ddc4788cd14b74da","2020-03-26T20:00:00Z",18,NA,21424,21424,21424,48,6,0,7508,422,7930
"3577",20200326,"UT",402,7308,NA,NA,NA,NA,NA,NA,NA,NA,"A","3/26/2020 15:00","23647ccc0fd8b16eb397b8868f1fdb1bb600895a","2020-03-26T20:00:00Z",1,NA,7710,7710,7710,49,0,0,817,56,873
"3578",20200326,"VA",460,5729,NA,NA,65,NA,NA,NA,NA,NA,"A","3/26/2020 00:00","bf943d1bd8cf8f64a0f890f2ff43fae00959809d","2020-03-26T20:00:00Z",13,65,6189,6189,6189,51,4,6,750,69,819
"3579",20200326,"VI",17,55,2,NA,NA,NA,NA,NA,NA,NA,"","3/25/2020 20:30","68df91126b73b1a1139b1542cf7367359b0e5794","2020-03-26T20:00:00Z",NA,NA,74,72,72,78,0,0,0,0,0
"3580",20200326,"VT",185,2744,NA,NA,NA,NA,NA,NA,NA,NA,"A","3/26/2020 00:00","aef315cc8fe82103b69decee28b5c14565ba8da0","2020-03-26T20:00:00Z",9,NA,2929,2929,2929,50,1,0,934,25,959
"3581",20200326,"WA",4909,61944,NA,NA,NA,NA,NA,NA,NA,NA,"A","3/26/2020 00:00","68fa2b0e531f1c16623545195ff00767ae1dfb90","2020-03-26T20:00:00Z",183,NA,66853,66853,66853,53,24,0,4047,432,4479
"3582",20200326,"WI",707,11583,NA,NA,NA,NA,NA,NA,NA,NA,"A","3/26/2020 16:00","49e2507289a69967ad0d2744866ecb5e5eb39e41","2020-03-26T20:00:00Z",8,NA,12290,12290,12290,55,1,0,1494,122,1616
"3583",20200326,"WV",51,1031,19,NA,1,NA,NA,NA,NA,NA,"B","3/25/2020 00:00","6015fb9f08b06f961b5ebf5d37461a49905e0651","2020-03-26T20:00:00Z",0,1,1101,1082,1082,54,0,0,272,12,284
"3584",20200326,"WY",53,1052,NA,NA,NA,NA,NA,NA,NA,12,"A","3/26/2020 00:00","44e5c4acd056b9e8f0d107500a3b855aaa444dbf","2020-03-26T20:00:00Z",NA,NA,1105,1105,1105,56,0,0,98,9,107
"3585",20200325,"AK",42,1649,NA,NA,1,NA,NA,NA,NA,NA,"A","3/24/2020 21:00","5f850377e1ff524049be1a2fa554484ee5ed1ebd","2020-03-25T20:00:00Z",1,1,1691,1691,1691,2,1,1,663,6,669
"3586",20200325,"AL",283,2529,NA,NA,NA,NA,NA,NA,NA,NA,"C","3/25/2020 11:30","3a28cb18d5e1f358152a5200f2e56e65ea7e2ea4","2020-03-25T20:00:00Z",0,NA,2812,2812,2812,1,0,0,423,68,491
"3587",20200325,"AR",280,1437,NA,22,NA,NA,NA,4,NA,11,"A","3/25/2020 09:19","5510294527d9935541228330f38083c6bc3dd7bf","2020-03-25T20:00:00Z",2,NA,1717,1717,1717,5,2,0,490,62,552
"3588",20200325,"AS",NA,NA,NA,NA,NA,NA,NA,NA,NA,NA,"","3/25/2020 00:00","c9662a3030e18c4d9f556f3e29cd71f4569ca3cc","2020-03-25T20:00:00Z",0,NA,0,0,0,60,0,0,0,0,0
"3589",20200325,"AZ",450,323,53,NA,NA,NA,NA,NA,NA,NA,"B","3/24/2020 00:00","1bd642e7e3ef5b23afd5bfc683849a62877bbc54","2020-03-25T20:00:00Z",6,NA,826,773,773,4,1,0,10,93,103
"3590",20200325,"CA",2355,15921,48600,NA,NA,NA,NA,NA,NA,NA,"B","3/24/2020 00:00","b78e80dc5536bbedc589b11fa46bfff7383e98a8","2020-03-25T20:00:00Z",53,NA,66876,18276,18276,6,13,0,2469,253,2722
"3591",20200325,"CO",912,6789,NA,152,84,NA,NA,NA,NA,NA,"A","3/24/2020 18:00","2bc56ea416f84ccae1e877b19ba6fa4ddd915bc2","2020-03-25T20:00:00Z",11,84,7701,7701,7701,8,4,12,1285,192,1477
"3592",20200325,"CT",875,5023,NA,113,NA,NA,NA,NA,NA,NA,"A","3/25/2020 16:00","8c0e546f0238f66edb87db4b10b3630f1e651c9b","2020-03-25T20:00:00Z",19,NA,5898,5898,5898,9,7,0,341,257,598
"3593",20200325,"DC",183,1423,3,NA,NA,NA,NA,NA,NA,NA,"A","3/24/2020 19:30","a7c72eaecc3c9556ed11e86afd8935bbd4c5a977","2020-03-25T20:00:00Z",2,NA,1609,1606,1606,11,0,0,228,46,274
"3594",20200325,"DE",115,36,NA,11,NA,NA,NA,NA,NA,NA,"C","3/25/2020 12:00","d845cd68ab8a8172a135e96bea866f76bf2be668","2020-03-25T20:00:00Z",0,NA,151,151,151,10,0,0,0,24,24
"3595",20200325,"FL",1682,15374,1233,NA,316,NA,NA,NA,NA,NA,"A","3/25/2020 11:00","af062c117aab7915981396dd17fe6f1b1f243478","2020-03-25T20:00:00Z",22,316,18289,17056,17056,12,4,57,2247,270,2517
"3596",20200325,"GA",1247,4932,NA,NA,394,NA,NA,NA,NA,NA,"A","3/25/2020 12:00","171931a034564c83922d49db522295ef8a13eca2","2020-03-25T20:00:00Z",40,394,6179,6179,6179,13,8,394,474,221,695
"3597",20200325,"GU",37,233,NA,10,NA,NA,NA,NA,NA,NA,"","3/25/2020 06:45","d8dd5f199cc8fd9926f1529eb1fff2c6a1db24cd","2020-03-25T20:00:00Z",1,NA,270,270,270,66,0,0,32,5,37
"3598",20200325,"HI",90,4357,NA,NA,6,NA,NA,NA,NA,NA,"A","3/24/2020 18:00","136c6c25162b2c85c7d303330732213d9da29d07","2020-03-25T20:00:00Z",NA,6,4447,4447,4447,15,0,2,768,13,781
"3599",20200325,"IA",145,2578,NA,23,36,NA,NA,NA,NA,NA,"C","3/25/2020 00:00","07987c41c62b24f6e43a640bfab9306982b22ae1","2020-03-25T20:00:00Z",1,36,2723,2723,2723,19,1,9,263,21,284
"3600",20200325,"ID",73,1887,NA,NA,NA,NA,NA,NA,NA,NA,"A","3/24/2020 19:00","7691a16607dbc40bec988af27fca68fb3c807328","2020-03-25T20:00:00Z",0,NA,1960,1960,1960,16,0,0,0,23,23
"3601",20200325,"IL",1865,12344,NA,NA,NA,NA,NA,NA,NA,NA,"A","3/25/2020 00:00","de7296dbcf66a21feb9d60b7d179967ba619f8a7","2020-03-25T20:00:00Z",19,NA,14209,14209,14209,17,3,0,2410,330,2740
"3602",20200325,"IN",477,2879,NA,NA,1,NA,NA,NA,NA,NA,"B","3/25/2020 00:59","e0514727a9c517b5e5e7c251eaec67648c834efc","2020-03-25T20:00:00Z",14,1,3356,3356,3356,18,2,0,313,112,425
"3603",20200325,"KS",126,2360,NA,NA,NA,NA,NA,NA,NA,NA,"B","3/25/2020 12:00","eff5ae2c80d18f37224e21751ae8abb04d582857","2020-03-25T20:00:00Z",3,NA,2486,2486,2486,20,1,0,274,28,302
"3604",20200325,"KY",157,2865,NA,NA,NA,NA,NA,NA,NA,NA,"A","3/24/2020 17:00","9e498b0e1f0b9065656aa85dceca3fec2935fad8","2020-03-25T20:00:00Z",4,NA,3022,3022,3022,21,0,0,1103,33,1136
"3605",20200325,"LA",1795,9656,NA,491,NA,NA,NA,163,NA,NA,"A","3/25/2020 13:00","8baff56a70fb107ca5d5bb21b467f249cc54aeab","2020-03-25T20:00:00Z",65,NA,11451,11451,11451,22,19,0,2441,407,2848
"3606",20200325,"MA",1739,18079,NA,NA,103,NA,NA,NA,NA,NA,"B","3/25/2020 16:00","8fc0b57aa2284fc9f533074786edff9096721eb1","2020-03-25T20:00:00Z",33,103,19818,19818,19818,25,7,9,5365,679,6044
"3607",20200325,"MD",423,94,NA,NA,NA,NA,NA,NA,NA,NA,"D","3/25/2020 10:00","6c0147642e1ae196ee36c3e0da51510e90183ebb","2020-03-25T20:00:00Z",4,NA,517,517,517,24,1,0,0,74,74
"3608",20200325,"ME",149,3177,NA,NA,NA,NA,NA,NA,NA,7,"A","3/25/2020 11:30","9ded9120137caeb97729277372b43f1a70ef8f4f","2020-03-25T20:00:00Z",NA,NA,3326,3326,3326,23,0,0,163,24,187
"3609",20200325,"MI",7060,7537,NA,NA,NA,NA,NA,NA,NA,NA,"D","3/25/2020 15:00","78552b7d4f9bc3b5419ef76d6c750b379272a3a2","2020-03-25T20:00:00Z",43,NA,14597,14597,14597,26,19,0,1741,619,2360
"3610",20200325,"MN",287,11188,NA,26,35,NA,NA,NA,NA,121,"A","3/25/2020 00:00","77859160f5bf758dc8739db9354797e941a58212","2020-03-25T20:00:00Z",1,35,11475,11475,11475,27,0,14,5638,25,5663
"3611",20200325,"MO",356,369,NA,NA,NA,NA,NA,NA,NA,NA,"C","3/24/2020 16:00","77c3e4bcd9a89c33db0b0c6bd872a79ed9efa6ea","2020-03-25T20:00:00Z",8,NA,725,725,725,29,5,0,0,173,173
"3612",20200325,"MP",0,NA,NA,NA,NA,NA,NA,NA,NA,NA,"","3/24/2020 18:30","2e31c4a48db2f02c03df645f1080fb2d62114660","2020-03-25T20:00:00Z",0,NA,0,0,0,69,0,0,0,0,0
"3613",20200325,"MS",377,1566,NA,NA,117,NA,NA,NA,NA,NA,"B","3/24/2020 20:00","7dfa4d9527fb84f5c29f853ed3707365541a247d","2020-03-25T20:00:00Z",2,117,1943,1943,1943,28,1,31,14,57,71
"3614",20200325,"MT",53,1948,NA,NA,NA,NA,NA,NA,NA,NA,"C","3/25/2020 10:00","8133dfd85159c45052a9b6bb0d24fea0080690d9","2020-03-25T20:00:00Z",NA,NA,2001,2001,2001,30,0,0,305,7,312
"3615",20200325,"NC",504,9985,NA,29,NA,NA,NA,NA,NA,NA,"A","3/25/2020 16:30","3177426b21c214c8a3f1902738013e2ad3022ad9","2020-03-25T20:00:00Z",1,NA,10489,10489,10489,37,1,0,1844,106,1950
"3616",20200325,"ND",39,1734,NA,NA,8,NA,NA,NA,NA,NA,"B","3/25/2020 11:47","a760a3e145e7656c4403478f7c492704d44732a7","2020-03-25T20:00:00Z",0,8,1773,1773,1773,38,0,3,280,5,285
"3617",20200325,"NE",61,1304,NA,NA,NA,NA,NA,NA,NA,NA,"A","3/24/2020 00:00","1be4f5286d3409d2878e9402bd33116e1217025f","2020-03-25T20:00:00Z",0,NA,1365,1365,1365,31,0,0,329,9,338
"3618",20200325,"NH",108,2356,804,NA,13,NA,NA,NA,NA,NA,"B","3/25/2020 13:30","a138c592a02e176a2742497450667766ea2413f7","2020-03-25T20:00:00Z",1,13,3268,2464,2464,33,0,2,909,7,916
"3619",20200325,"NJ",4402,10452,NA,NA,NA,NA,NA,NA,NA,NA,"B","3/24/2020 01:30","83512456afd279745d4313688e0c2833f10313df","2020-03-25T20:00:00Z",62,NA,14854,14854,14854,34,18,0,2127,727,2854
"3620",20200325,"NM",100,6742,NA,NA,NA,NA,NA,NA,NA,NA,"A","3/24/2020 00:00","dca5f8f0d18de7a779591260584b5b615d2f3446","2020-03-25T20:00:00Z",1,NA,6842,6842,6842,35,1,0,852,17,869
"3621",20200325,"NV",321,4251,NA,NA,NA,NA,NA,NA,NA,NA,"A","3/25/2020 02:59","a10ecea0bc66ed068349c86eb16140f09300e44a","2020-03-25T20:00:00Z",6,NA,4572,4572,4572,32,2,0,297,43,340
"3622",20200325,"NY",30811,72668,NA,4079,3805,NA,NA,NA,NA,NA,"B","3/25/2020 11:45","8416f1590fec27b83e85b39865b220bc4e742f67","2020-03-25T20:00:00Z",285,3805,103479,103479,103479,36,75,571,7063,5146,12209
"3623",20200325,"OH",704,14060,NA,NA,182,NA,74,NA,NA,NA,"B","3/25/2020 14:00","63295b4f0011c06fd417eee134ea5bdd85fb6059","2020-03-25T20:00:00Z",10,182,14764,14764,14764,39,2,37,13920,140,14060
"3624",20200325,"OK",164,805,NA,NA,59,NA,NA,NA,NA,NA,"A","3/25/2020 08:00","dec4aec43b39587f592e50a40b99647befdaeab7","2020-03-25T20:00:00Z",5,59,969,969,969,40,2,34,70,58,128
"3625",20200325,"OR",209,4350,NA,NA,61,NA,NA,NA,NA,NA,"A","3/24/2020 11:00","ee2a72dc548151311cc376f37fcf6234ff7087bf","2020-03-25T20:00:00Z",8,61,4559,4559,4559,41,0,0,0,0,0
"3626",20200325,"PA",1127,11193,NA,NA,NA,NA,NA,NA,NA,NA,"A","3/25/2020 12:00","640fcb2d93bda2a7ddbb8adccd66d8a0d3457faa","2020-03-25T20:00:00Z",11,NA,12320,12320,12320,42,4,0,2550,276,2826
"3627",20200325,"PR",51,317,70,NA,NA,NA,NA,NA,NA,NA,"A","3/25/2020 07:00","865cca491840856dc62844c381ef5b5f04b2f3bb","2020-03-25T20:00:00Z",2,NA,438,368,368,72,0,0,49,12,61
"3628",20200325,"RI",132,1262,196,15,NA,NA,NA,NA,NA,NA,"B","3/25/2020 00:00","5d06e9807cc63d888fe7069050b2bfba323c3fbf","2020-03-25T20:00:00Z",NA,NA,1590,1394,1394,44,0,0,62,8,70
"3629",20200325,"SC",424,2303,NA,NA,102,NA,NA,NA,NA,NA,"B","3/24/2020 19:30","9a96cb471fad8ccd06436d9df99dde75592b7fd9","2020-03-25T20:00:00Z",7,102,2727,2727,2727,45,2,102,291,126,417
"3630",20200325,"SD",41,819,268,NA,NA,NA,NA,NA,NA,NA,"A","3/25/2020 13:00","cad2c2f0fb178164fbd96e081f007c6e0c1183ca","2020-03-25T20:00:00Z",1,NA,1128,860,860,46,0,0,29,11,40
"3631",20200325,"TN",784,11012,NA,NA,53,NA,NA,NA,NA,NA,"A","3/25/2020 15:00","4e700622fcccb8f4b0f9862a07e7872447a34e0f","2020-03-25T20:00:00Z",3,53,11796,11796,11796,47,1,53,495,117,612
"3632",20200325,"TX",974,12520,NA,NA,NA,NA,NA,NA,NA,NA,"A","3/25/2020 12:30","58e98207985c7f64fa0cbd333ac2014f4ef5375f","2020-03-25T20:00:00Z",12,NA,13494,13494,13494,48,3,0,1763,564,2327
"3633",20200325,"UT",346,6491,NA,NA,NA,NA,NA,NA,NA,NA,"A","3/25/2020 15:00","53625dbf77101f6953f91be8f21e4c5dc9f8d35d","2020-03-25T20:00:00Z",1,NA,6837,6837,6837,49,0,0,967,47,1014
"3634",20200325,"VA",391,4979,NA,NA,59,NA,NA,NA,NA,NA,"A","3/25/2020 00:00","250d93c8997f6d654743ab56879f8c4819587e56","2020-03-25T20:00:00Z",9,59,5370,5370,5370,51,2,14,799,101,900
"3635",20200325,"VI",17,55,2,NA,NA,NA,NA,NA,NA,NA,"","3/24/2020 20:30","7a12eb162aa4dfe687e2e2796ae382384454f217","2020-03-25T20:00:00Z",NA,NA,74,72,72,78,0,0,55,0,55
"3636",20200325,"VT",160,1810,NA,NA,NA,NA,NA,NA,NA,NA,"A","3/25/2020 00:00","981a5ef0c42801a5be1a5d4557c0ce7e6bd81f7c","2020-03-25T20:00:00Z",8,NA,1970,1970,1970,50,1,0,241,35,276
"3637",20200325,"WA",4477,57897,NA,NA,NA,NA,NA,NA,NA,NA,"A","3/25/2020 00:00","48c5c0a3f5d2b6cd57c9c72105587c6441fc3afb","2020-03-25T20:00:00Z",159,NA,62374,62374,62374,53,13,0,4571,439,5010
"3638",20200325,"WI",585,10089,NA,NA,NA,NA,NA,NA,NA,NA,"A","3/25/2020 16:00","d6b29b0f4bec8f540ed2bfa3e9eb7c06c8f902d9","2020-03-25T20:00:00Z",7,NA,10674,10674,10674,55,2,0,1852,128,1980
"3639",20200325,"WV",39,759,6,NA,1,NA,NA,NA,NA,NA,"B","3/24/2020 00:00","b95886565bc3bb06aab2728938f794796db9aaa4","2020-03-25T20:00:00Z",0,1,804,798,798,54,0,0,149,19,168
"3640",20200325,"WY",44,954,NA,NA,NA,NA,NA,NA,NA,7,"A","3/25/2020 12:45","9bb0d407569a27e94c57602a9ec0a9f7039187d1","2020-03-25T20:00:00Z",NA,NA,998,998,998,56,0,0,244,15,259
"3641",20200324,"AK",36,986,NA,NA,0,NA,NA,NA,NA,NA,"A","3/23/2020 19:00","ad0bffec84cecd8b2294f21337c9c6bb79b66ded","2020-03-24T20:00:00Z",0,0,1022,1022,1022,2,0,0,40,14,54
"3642",20200324,"AL",215,2106,NA,NA,NA,NA,NA,NA,NA,NA,"C","3/24/2020 12:00","0beac38e505e26f2af4236fa25f2047e9ed14e5a","2020-03-24T20:00:00Z",0,NA,2321,2321,2321,1,0,0,441,48,489
"3643",20200324,"AR",218,947,NA,22,NA,NA,NA,NA,NA,NA,"A","3/24/2020 00:00","1d9cefc002bf7770c5b5aae9a4c76a817a4a890a","2020-03-24T20:00:00Z",0,NA,1165,1165,1165,5,0,0,41,44,85
"3644",20200324,"AS",NA,NA,NA,NA,NA,NA,NA,NA,NA,NA,"","3/24/2020 00:00","ba91d52d754c128b8c527c6061b25fdff76694ba","2020-03-24T20:00:00Z",0,NA,0,0,0,60,0,0,0,0,0
"3645",20200324,"AZ",357,313,22,NA,NA,NA,NA,NA,NA,NA,"B","3/24/2020 00:00","93714762a86e294d0beef71ef1aab1150ac5f9c3","2020-03-24T20:00:00Z",5,NA,692,670,670,4,3,0,4,92,96
"3646",20200324,"CA",2102,13452,12100,NA,NA,NA,NA,NA,NA,NA,"B","3/24/2020 00:00","84aee4eec875915e8a297db205628728135b5c14","2020-03-24T20:00:00Z",40,NA,27654,15554,15554,6,13,0,885,369,1254
"3647",20200324,"CO",720,5504,NA,116,72,NA,NA,NA,NA,NA,"A","3/23/2020 18:13","857a6a8cad82254df0586f2ad92767eda1a2b4e7","2020-03-24T20:00:00Z",7,72,6224,6224,6224,8,1,14,659,129,788
"3648",20200324,"CT",618,4682,NA,71,NA,NA,NA,NA,NA,NA,"A","3/24/2020 16:00","ab0e283e8b1acbd9926359d1a7e82da8999896cc","2020-03-24T20:00:00Z",12,NA,5300,5300,5300,9,2,0,597,203,800
"3649",20200324,"DC",137,1195,2,NA,NA,NA,NA,NA,NA,NA,"A","3/23/2020 19:30","2fe3a0b82ad7ce77c19a9749e0b6d72f0c3c4d70","2020-03-24T20:00:00Z",2,NA,1334,1332,1332,11,0,0,82,21,103
"3650",20200324,"DE",91,36,NA,NA,NA,NA,NA,NA,NA,NA,"C","3/24/2020 10:45","c515ef744b28a95f506a7c7341be8db24c39e411","2020-03-24T20:00:00Z",0,NA,127,127,127,10,0,0,0,23,23
"3651",20200324,"FL",1412,13127,1008,NA,259,NA,NA,NA,NA,NA,"A","3/24/2020 11:00","e6def059df9ce1c730a997274eac245e2aab49eb","2020-03-24T20:00:00Z",18,259,15547,14539,14539,12,4,42,2064,241,2305
"3652",20200324,"GA",1026,4458,NA,NA,NA,NA,NA,NA,NA,NA,"A","3/24/2020 12:00","78af7f301ca7948f698ab7e1589ed7862ce89f70","2020-03-24T20:00:00Z",32,NA,5484,5484,5484,13,7,0,161,254,415
"3653",20200324,"GU",32,201,NA,5,NA,NA,NA,NA,NA,NA,"","3/24/2020 06:45","aaad6d380b8022fd01fb58b743bbaa425cfb066f","2020-03-24T20:00:00Z",1,NA,233,233,233,66,0,0,40,3,43
"3654",20200324,"HI",77,3589,NA,NA,4,NA,NA,NA,NA,NA,"A","3/23/2020 18:00","394b72ea9d53d284743894fa2760133503b5ed1c","2020-03-24T20:00:00Z",NA,4,3666,3666,3666,15,0,4,634,21,655
"3655",20200324,"IA",124,2315,NA,NA,27,NA,NA,NA,NA,NA,"C","3/24/2020 00:00","10ce98b3e77c0dd0935d82f050eb97c7c38e27b8","2020-03-24T20:00:00Z",NA,27,2439,2439,2439,19,0,27,272,19,291
"3656",20200324,"ID",50,1887,NA,NA,NA,NA,NA,NA,NA,NA,"A","3/23/2020 19:00","769a9cb59623485f60d778f25f04d06717970572","2020-03-24T20:00:00Z",0,NA,1937,1937,1937,16,0,0,578,3,581
"3657",20200324,"IL",1535,9934,NA,NA,NA,NA,NA,NA,NA,NA,"A","3/24/2020 00:00","8c83c1070c8cdc7a0871c8643ac563d1ee04dda5","2020-03-24T20:00:00Z",16,NA,11469,11469,11469,17,4,0,1351,262,1613
"3658",20200324,"IN",365,2566,NA,NA,1,NA,NA,NA,NA,NA,"B","3/24/2020 11:00","4683d94c49ef4b59c87e6ca7f76097b7e193fa5f","2020-03-24T20:00:00Z",12,1,2931,2931,2931,18,5,0,865,106,971
"3659",20200324,"KS",98,2086,NA,NA,NA,NA,NA,NA,NA,NA,"B","3/24/2020 12:00","822db51e8ea8c56f0a348580fbd41d49a7f38a9b","2020-03-24T20:00:00Z",2,NA,2184,2184,2184,20,0,0,1669,16,1685
"3660",20200324,"KY",124,1762,NA,NA,NA,NA,NA,NA,NA,NA,"A","3/23/2020 17:00","79e01bcfcda37bb6f6552da61ebb6c568744d590","2020-03-24T20:00:00Z",4,NA,1886,1886,1886,21,1,0,0,20,20
"3661",20200324,"LA",1388,7215,NA,271,NA,NA,NA,NA,NA,NA,"A","3/24/2020 13:00","82a3e98716612c5e4b74b1685382feebd71e6af8","2020-03-24T20:00:00Z",46,NA,8603,8603,8603,22,12,0,2439,216,2655
"3662",20200324,"MA",1060,12714,NA,NA,94,NA,NA,NA,NA,NA,"B","3/24/2020 12:30","f64fa88ca121311a73c44c6f81825d2eedd143d1","2020-03-24T20:00:00Z",26,94,13774,13774,13774,25,9,15,4451,382,4833
"3663",20200324,"MD",349,94,NA,NA,NA,NA,NA,NA,NA,NA,"D","3/24/2020 10:00","722cc80779568114ba5bb4546835eb4a72af43a3","2020-03-24T20:00:00Z",3,NA,443,443,443,24,0,0,0,61,61
"3664",20200324,"ME",125,3014,NA,NA,NA,NA,NA,NA,NA,NA,"A","3/24/2020 12:00","aec5ab38c72838c8c03b42523975db73cdbaa10e","2020-03-24T20:00:00Z",NA,NA,3139,3139,3139,23,0,0,223,18,241
"3665",20200324,"MI",6441,5796,NA,NA,NA,NA,NA,NA,NA,NA,"D","3/24/2020 11:00","79741e9b4a2a371cafd36b54d7916057a6ab8373","2020-03-24T20:00:00Z",24,NA,12237,12237,12237,26,9,0,1099,652,1751
"3666",20200324,"MN",262,5550,NA,NA,21,NA,NA,NA,NA,NA,"A","3/24/2020 00:00","eafcae4da89815acd6305bfe51463dfae87e1c94","2020-03-24T20:00:00Z",1,21,5812,5812,5812,27,0,4,1039,27,1066
"3667",20200324,"MO",183,369,NA,NA,NA,NA,NA,NA,NA,NA,"C","3/23/2020 15:00","60a11eb8f416803b66f1e70bd33e71fe87224a99","2020-03-24T20:00:00Z",3,NA,552,552,552,29,0,0,0,0,0
"3668",20200324,"MP",0,NA,NA,NA,NA,NA,NA,NA,NA,NA,"","3/23/2020 01:30","976f5806247900c4d1e954b21b55c23b8e92c344","2020-03-24T20:00:00Z",0,NA,0,0,0,69,0,0,0,0,0
"3669",20200324,"MS",320,1552,NA,NA,86,NA,NA,NA,NA,NA,"B","3/23/2020 19:00","41ca10d1c0ef99f41ee9e7830ff0647ac806cd19","2020-03-24T20:00:00Z",1,86,1872,1872,1872,28,0,53,409,71,480
"3670",20200324,"MT",46,1643,NA,NA,NA,NA,NA,NA,NA,NA,"C","3/24/2020 10:00","d39ccbf3cb45eee20bc61ffe9d550483eb1bdeb6","2020-03-24T20:00:00Z",NA,NA,1689,1689,1689,30,0,0,497,12,509
"3671",20200324,"NC",398,8141,NA,NA,NA,NA,NA,NA,NA,NA,"A","3/24/2020 09:45","151a641a4502a9bff0afadad12d201ba20194222","2020-03-24T20:00:00Z",0,NA,8539,8539,8539,37,0,0,0,101,101
"3672",20200324,"ND",34,1454,NA,NA,5,NA,NA,NA,NA,NA,"B","3/24/2020 11:17","d3e06dfc76164d709e9a584702f432aa4dfd5953","2020-03-24T20:00:00Z",0,5,1488,1488,1488,38,0,1,101,4,105
"3673",20200324,"NE",52,975,NA,NA,NA,NA,NA,NA,NA,NA,"A","3/23/2020 00:00","1d6fe6bf66b605e6b2613fd15e863b56c0a6f4d4","2020-03-24T20:00:00Z",0,NA,1027,1027,1027,31,0,0,619,2,621
"3674",20200324,"NH",101,1447,869,NA,11,NA,NA,NA,NA,NA,"B","3/23/2020 09:00","7df1edb98807080ad6a0e86d3888733fbd47b0e7","2020-03-24T20:00:00Z",1,11,2417,1548,1548,33,1,11,73,23,96
"3675",20200324,"NJ",3675,8325,45,NA,NA,NA,NA,NA,NA,NA,"B","3/24/2020 01:30","1e853ac82de1b36d2e92ee4fcd68146175f02255","2020-03-24T20:00:00Z",44,NA,12045,12000,12000,34,17,0,7966,831,8797
"3676",20200324,"NM",83,5890,NA,NA,NA,NA,NA,NA,NA,NA,"A","3/23/2020 00:00","f069ef0e2f5cd10da073cdf2729c50518fa3f4d1","2020-03-24T20:00:00Z",NA,NA,5973,5973,5973,35,0,0,569,18,587
"3677",20200324,"NV",278,3954,NA,NA,NA,NA,NA,NA,NA,NA,"A","3/23/2020 14:59","e9135baa8e8438a3113c06117a66af8a8a6a4c22","2020-03-24T20:00:00Z",4,NA,4232,4232,4232,32,0,0,464,33,497
"3678",20200324,"NY",25665,65605,NA,3343,3234,NA,NA,NA,NA,NA,"B","3/24/2020 11:30","b08731f515bedc235dd7e90953425c36bf60c91c","2020-03-24T20:00:00Z",210,3234,91270,91270,91270,36,96,599,8191,4790,12981
"3679",20200324,"OH",564,140,NA,NA,145,NA,NA,NA,NA,NA,"D","3/24/2020 14:00","b30c6ef605875885739e48b3ead9acda79a2c629","2020-03-24T20:00:00Z",8,145,704,704,704,39,2,41,0,122,122
"3680",20200324,"OK",106,735,NA,NA,25,NA,NA,NA,NA,NA,"A","3/24/2020 08:00","9968e2d587a7632553b3fa63dbde368a6f664918","2020-03-24T20:00:00Z",3,25,841,841,841,40,1,10,41,25,66
"3681",20200324,"OR",209,4350,NA,NA,61,NA,NA,NA,NA,NA,"A","3/24/2020 11:00","d10760c1234fe2c31823f147ac52eda1d7e5304a","2020-03-24T20:00:00Z",8,61,4559,4559,4559,41,3,5,701,18,719
"3682",20200324,"PA",851,8643,NA,NA,NA,NA,NA,NA,NA,NA,"A","3/24/2020 12:00","c4700dd9300214cbb3bdb952e0b52c3bee1a8fa5","2020-03-24T20:00:00Z",7,NA,9494,9494,9494,42,1,0,2048,207,2255
"3683",20200324,"PR",39,268,42,NA,NA,NA,NA,NA,NA,NA,"A","3/23/2020 07:00","0ed041850e58ad93073822631b4f3a32a7370128","2020-03-24T20:00:00Z",2,NA,349,307,307,72,0,0,79,8,87
"3684",20200324,"RI",124,1200,77,NA,NA,NA,NA,NA,NA,NA,"B","3/24/2020 00:00","25832521d2915d7474ece874e702d6796a89d978","2020-03-24T20:00:00Z",NA,NA,1401,1324,1324,44,0,0,57,18,75
"3685",20200324,"SC",298,2012,NA,NA,NA,NA,NA,NA,NA,NA,"B","3/23/2020 16:35","d645c72133962c3ada32573c53f539d6cb619b45","2020-03-24T20:00:00Z",5,NA,2310,2310,2310,45,0,0,546,0,546
"3686",20200324,"SD",30,790,268,NA,NA,NA,NA,NA,NA,NA,"A","3/24/2020 12:30","97d46f70fec94ea950b3e9477c2b8c0ff45c19c1","2020-03-24T20:00:00Z",1,NA,1088,820,820,46,0,0,28,2,30
"3687",20200324,"TN",667,10517,NA,NA,NA,NA,NA,NA,NA,NA,"A","3/24/2020 15:00","07240399061a62bf7c5d602d9e694522963f2d58","2020-03-24T20:00:00Z",2,NA,11184,11184,11184,47,0,0,7245,52,7297
"3688",20200324,"TX",410,10757,NA,NA,NA,NA,NA,NA,NA,NA,"A","3/23/2020 21:00","894d8614af5c592964d2a9e576a4231a2583a29d","2020-03-24T20:00:00Z",9,NA,11167,11167,11167,48,1,0,1054,58,1112
"3689",20200324,"UT",299,5524,NA,NA,NA,NA,NA,NA,NA,NA,"A","3/24/2020 15:00","8ae05d02f9ffad13460fe8e2dc800a640c771a9c","2020-03-24T20:00:00Z",1,NA,5823,5823,5823,49,0,0,734,42,776
"3690",20200324,"VA",290,4180,NA,NA,45,NA,NA,NA,NA,NA,"A","3/24/2020 00:00","e309b6d7793826192fd9f8f3b85fa348a73f9a09","2020-03-24T20:00:00Z",7,45,4470,4470,4470,51,1,7,737,36,773
"3691",20200324,"VI",17,NA,NA,NA,NA,NA,NA,NA,NA,NA,"","3/23/2020 20:30","c044786248f73e7b9299c77e1f39f1b8bb0ea32b","2020-03-24T20:00:00Z",NA,NA,17,17,17,78,0,0,0,0,0
"3692",20200324,"VT",125,1569,NA,NA,NA,NA,NA,NA,NA,NA,"A","3/24/2020 00:00","dbf72abaec82307c3ba5d2536575b927871587d6","2020-03-24T20:00:00Z",7,NA,1694,1694,1694,50,2,0,145,28,173
"3693",20200324,"WA",4038,53326,NA,NA,NA,NA,NA,NA,NA,NA,"A","3/24/2020 00:00","eee3a8a00613adf64bdcac25df6204d0383994ff","2020-03-24T20:00:00Z",146,NA,57364,57364,57364,53,9,0,4818,434,5252
"3694",20200324,"WI",457,8237,NA,NA,NA,NA,NA,NA,NA,NA,"A","3/24/2020 16:00","d97f6818f3499e22260a5756205dcc6b053e1d71","2020-03-24T20:00:00Z",5,NA,8694,8694,8694,55,0,0,1187,41,1228
"3695",20200324,"WV",20,610,0,NA,1,NA,NA,NA,NA,NA,"B","3/23/2020 00:00","64e69e21b23b6024aae325a7c0edce6d82e680cc","2020-03-24T20:00:00Z",0,1,630,630,630,54,0,0,166,4,170
"3696",20200324,"WY",29,710,NA,NA,NA,NA,NA,NA,NA,NA,"A","3/24/2020 00:00","513e8a68ce9b6201f75b043ea7f328007f7d7def","2020-03-24T20:00:00Z",NA,NA,739,739,739,56,0,0,118,3,121
"3697",20200323,"AK",22,946,NA,NA,0,NA,NA,NA,NA,NA,"A","3/21/2020 16:30","a4aea76abb5487074f98bc248438f33cfc1691da","2020-03-23T20:00:00Z",0,0,968,968,968,2,0,0,0,0,0
"3698",20200323,"AL",167,1665,NA,NA,NA,NA,NA,NA,NA,NA,"C","3/23/2020 12:00","8dec022271dbb0c2fb18ed8a405a71687b634fab","2020-03-23T20:00:00Z",0,NA,1832,1832,1832,1,0,0,201,29,230
"3699",20200323,"AR",174,906,NA,13,NA,NA,NA,NA,NA,NA,"A","3/23/2020 00:00","605289cad3f1c12aa6d3cb8d8266410cd437efce","2020-03-23T20:00:00Z",0,NA,1080,1080,1080,5,0,0,195,9,204
"3700",20200323,"AS",NA,NA,NA,NA,NA,NA,NA,NA,NA,NA,"","3/19/2020 00:00","9480353f38b640e6dc50533bca98401333732bc3","2020-03-23T20:00:00Z",0,NA,0,0,0,60,0,0,0,0,0
"3701",20200323,"AZ",265,309,6,NA,NA,NA,NA,NA,NA,NA,"B","3/23/2020 00:00","fb0b0fc0fbbd5701162bccbcfc89c2266e64587f","2020-03-23T20:00:00Z",2,NA,580,574,574,4,0,0,27,113,140
"3702",20200323,"CA",1733,12567,12100,NA,NA,NA,NA,NA,NA,NA,"B","3/23/2020 00:00","29643721de2a758e3a666f0d4513e881cc132913","2020-03-23T20:00:00Z",27,NA,26400,14300,14300,6,0,0,1263,197,1460
"3703",20200323,"CO",591,4845,NA,74,58,NA,NA,NA,NA,NA,"A","3/22/2020 18:00","9d91a34b6e6b537e5c50b13b09972c4292f3e4b8","2020-03-23T20:00:00Z",6,58,5436,5436,5436,8,1,9,770,116,886
"3704",20200323,"CT",415,4085,NA,54,NA,NA,NA,NA,NA,NA,"A","3/23/2020 16:00","60eb9321766cf3cfd4a9af4461e355f12b41e5ae","2020-03-23T20:00:00Z",10,NA,4500,4500,4500,9,5,0,1208,192,1400
"3705",20200323,"DC",116,1113,NA,NA,NA,NA,NA,NA,NA,NA,"A","3/22/2020 19:00","4b7d545f605c86af210680643839d883de10b653","2020-03-23T20:00:00Z",2,NA,1229,1229,1229,11,1,0,156,18,174
"3706",20200323,"DE",68,36,NA,NA,NA,NA,NA,NA,NA,NA,"C","3/23/2020 11:15","2e3d7939cdc8f95d4b1a238ea76a618f4435312b","2020-03-23T20:00:00Z",0,NA,104,104,104,10,0,0,0,12,12
"3707",20200323,"FL",1171,11063,860,NA,217,NA,NA,NA,NA,NA,"A","3/23/2020 11:00","20fd33cb106da648b65d1a89b4d41b604275f461","2020-03-23T20:00:00Z",14,217,13094,12234,12234,12,1,32,3073,341,3414
"3708",20200323,"GA",772,4297,NA,NA,NA,NA,NA,NA,NA,NA,"A","3/23/2020 12:00","f9b3af350aa3b26dcdf08e46a0b8fcf9c87bdbb7","2020-03-23T20:00:00Z",25,NA,5069,5069,5069,13,2,0,877,172,1049
"3709",20200323,"GU",29,161,NA,NA,NA,NA,NA,NA,NA,NA,"","3/23/2020 06:45","6e0822908c11bf2c12f72623ff358387bedf0ec2","2020-03-23T20:00:00Z",1,NA,190,190,190,66,0,0,35,2,37
"3710",20200323,"HI",56,2955,NA,NA,NA,NA,NA,NA,NA,NA,"A","3/22/2020 18:00","63c635fe69e4df167e64b3b43629863eaaf08425","2020-03-23T20:00:00Z",NA,NA,3011,3011,3011,15,0,0,2692,8,2700
"3711",20200323,"IA",105,2043,NA,NA,NA,NA,NA,NA,NA,NA,"C","3/23/2020 00:00","34fc79b005d119abcd9ceffcc8c08aa91231d1c9","2020-03-23T20:00:00Z",NA,NA,2148,2148,2148,19,0,0,828,15,843
"3712",20200323,"ID",47,1309,NA,NA,NA,NA,NA,NA,NA,NA,"A","3/22/2020 19:00","185c0e4885558751e5a4dc0d1a207e2744e5ded6","2020-03-23T20:00:00Z",0,NA,1356,1356,1356,16,0,0,134,5,139
"3713",20200323,"IL",1273,8583,NA,NA,NA,NA,NA,NA,NA,NA,"A","3/23/2020 00:00","7015844005c87317e0c37535c8304903b4af38b0","2020-03-23T20:00:00Z",12,NA,9856,9856,9856,17,3,0,1312,224,1536
"3714",20200323,"IN",259,1701,NA,NA,1,NA,NA,NA,NA,NA,"B","3/23/2020 11:00","4806327043321cf60f4af5b1c9583c1993f0418c","2020-03-23T20:00:00Z",7,1,1960,1960,1960,18,1,0,408,58,466
"3715",20200323,"KS",82,417,NA,NA,NA,NA,NA,NA,NA,NA,"B","3/23/2020 11:00","e30731efb5d3903dec024877368f0ed8d4d6770b","2020-03-23T20:00:00Z",2,NA,499,499,499,20,0,0,0,18,18
"3716",20200323,"KY",104,1762,NA,NA,NA,NA,NA,NA,NA,NA,"A","3/23/2020 09:00","ecb8b56863bc8515ffd33e10ef045bf3ca540647","2020-03-23T20:00:00Z",3,NA,1866,1866,1866,21,0,0,290,5,295
"3717",20200323,"LA",1172,4776,NA,NA,NA,NA,NA,NA,NA,NA,"B","3/23/2020 13:00","b909e40e1f6f8a390fded287a3d37235c874103b","2020-03-23T20:00:00Z",34,NA,5948,5948,5948,22,14,0,2115,335,2450
"3718",20200323,"MA",678,8263,NA,NA,79,NA,NA,NA,NA,NA,"B","3/23/2020 12:30","7e25fc50045298a3678688fe9a1d57f0fb893475","2020-03-23T20:00:00Z",17,79,8941,8941,8941,25,6,8,2787,131,2918
"3719",20200323,"MD",288,94,NA,NA,NA,NA,NA,NA,NA,NA,"D","3/23/2020 10:00","0d4f8f43f5785f1aed116ce5758d29040de8fc38","2020-03-23T20:00:00Z",3,NA,382,382,382,24,0,0,0,44,44
"3720",20200323,"ME",107,2791,NA,NA,NA,NA,NA,NA,NA,NA,"A","3/23/2020 11:30","b9593d94a3aaf47b37fdf4aa82f5d1d57d8ccbfd","2020-03-23T20:00:00Z",NA,NA,2898,2898,2898,23,0,0,527,18,545
"3721",20200323,"MI",5789,4697,NA,NA,NA,NA,NA,NA,NA,NA,"D","3/23/2020 11:00","c7c08d256b2b151ced5f92ea35972f92a116f24a","2020-03-23T20:00:00Z",15,NA,10486,10486,10486,26,7,0,985,691,1676
"3722",20200323,"MN",235,4511,NA,NA,17,NA,NA,NA,NA,NA,"A","3/23/2020 00:00","4e22f8ce82aedc29b8f8df5fb2b7480832334218","2020-03-23T20:00:00Z",1,17,4746,4746,4746,27,0,5,0,66,66
"3723",20200323,"MO",183,369,NA,NA,NA,NA,NA,NA,NA,NA,"C","3/23/2020 15:00","a33ce32abaef2428aa8f6a3d45fc86c6ddc584b6","2020-03-23T20:00:00Z",3,NA,552,552,552,29,0,0,0,93,93
"3724",20200323,"MP",0,NA,NA,NA,NA,NA,NA,NA,NA,NA,"","3/23/2020 01:30","ccda8eb6129360727e49ba43a082b95465002058","2020-03-23T20:00:00Z",0,NA,0,0,0,69,0,0,0,0,0
"3725",20200323,"MS",249,1143,NA,NA,33,NA,NA,NA,NA,NA,"B","3/22/2020 19:22","7d69afc691914fdbfbc4e9627d86b8f152fad170","2020-03-23T20:00:00Z",1,33,1392,1392,1392,28,0,0,29,42,71
"3726",20200323,"MT",34,1146,NA,NA,NA,NA,NA,NA,NA,NA,"C","3/23/2020 10:00","5d38741a904278d7d73291c05fc5d095ff8c2a8e","2020-03-23T20:00:00Z",NA,NA,1180,1180,1180,30,0,0,0,3,3
"3727",20200323,"NC",297,8141,NA,NA,NA,NA,NA,NA,NA,NA,"A","3/23/2020 15:00","40dccdf2e6bc35cbc482daa7d74d10cb91213b35","2020-03-23T20:00:00Z",0,NA,8438,8438,8438,37,0,0,1958,42,2000
"3728",20200323,"ND",30,1353,NA,NA,4,NA,NA,NA,NA,NA,"B","3/23/2020 12:11","19c0e58439521d42fafc10b466e4f017ec7716ed","2020-03-23T20:00:00Z",0,4,1383,1383,1383,38,0,1,93,2,95
"3729",20200323,"NE",50,356,NA,NA,NA,NA,NA,NA,NA,NA,"A","3/21/2020 00:00","63f29c5fe556f16a1d7ea1e4cc3de79842288934","2020-03-23T20:00:00Z",0,NA,406,406,406,31,0,0,0,2,2
"3730",20200323,"NH",78,1374,889,NA,NA,NA,NA,NA,NA,NA,"B","3/22/2020 09:00","73fe18c0ece67c5247b6c07b112353ee0c2d6f24","2020-03-23T20:00:00Z",NA,NA,2341,1452,1452,33,0,0,186,13,199
"3731",20200323,"NJ",2844,359,94,NA,NA,NA,NA,NA,NA,NA,"B","3/23/2020 14:00","db3b289905782ac76c28af1519270af96f74fb35","2020-03-23T20:00:00Z",27,NA,3297,3203,3203,34,7,0,32,930,962
"3732",20200323,"NM",65,5321,NA,NA,NA,NA,NA,NA,NA,NA,"A","3/22/2020 00:00","dd5da89dd28313023866c789a08e91ca29dc0908","2020-03-23T20:00:00Z",NA,NA,5386,5386,5386,35,0,0,599,8,607
"3733",20200323,"NV",245,3490,NA,NA,NA,NA,NA,NA,NA,NA,"A","3/22/2020 14:59","c9a9537f1a92f4aeafedb08c7f247cbc957eaffe","2020-03-23T20:00:00Z",4,NA,3735,3735,3735,32,2,0,1042,55,1097
"3734",20200323,"NY",20875,57414,NA,2629,2635,NA,NA,NA,NA,NA,"B","3/23/2020 11:36","13847b3570d018bcf9a9f5cb779f6d72d04267c2","2020-03-23T20:00:00Z",114,2635,78289,78289,78289,36,0,661,11181,5707,16888
"3735",20200323,"OH",442,140,NA,NA,104,NA,NA,NA,NA,NA,"D","3/23/2020 14:00","a0ce1ce8a1eabaa945e8054b77fbc4f7969a6c2d","2020-03-23T20:00:00Z",6,104,582,582,582,39,3,21,0,91,91
"3736",20200323,"OK",81,694,102,NA,15,NA,NA,NA,NA,NA,"A","3/23/2020 08:00","2667e95c36445000a0d792cd9920a5ad67da70ec","2020-03-23T20:00:00Z",2,15,877,775,775,40,0,4,25,14,39
"3737",20200323,"OR",191,3649,NA,NA,56,NA,NA,NA,NA,NA,"A","3/23/2020 11:00","8ef1a77c5cf5829330e9b75b359c38d8a6c6e242","2020-03-23T20:00:00Z",5,56,3840,3840,3840,41,1,13,785,30,815
"3738",20200323,"PA",644,6595,NA,NA,NA,NA,NA,NA,NA,NA,"A","3/23/2020 15:00","a0e94f34ae6c0853de6b1b1800c12cd01950c2c8","2020-03-23T20:00:00Z",6,NA,7239,7239,7239,42,4,0,1631,165,1796
"3739",20200323,"PR",31,189,35,NA,NA,NA,NA,NA,NA,NA,"A","3/23/2020 07:00","0d462bd18c338ea8d97c5e5c03b10e97018a8a31","2020-03-23T20:00:00Z",2,NA,255,220,220,72,1,0,6,8,14
"3740",20200323,"RI",106,1143,216,NA,NA,NA,NA,NA,NA,NA,"B","3/23/2020 15:25","95535f310153e2a057f51ca92a440be3e1118389","2020-03-23T20:00:00Z",NA,NA,1465,1249,1249,44,0,0,211,23,234
"3741",20200323,"SC",298,1466,NA,NA,NA,NA,NA,NA,NA,NA,"A","3/23/2020 16:35","b9f41965cebbf933b3364de7aeb13c2b0d413b5f","2020-03-23T20:00:00Z",5,NA,1764,1764,1764,45,2,0,0,103,103
"3742",20200323,"SD",28,762,265,NA,NA,NA,NA,NA,NA,NA,"A","3/23/2020 10:00","2d2498b3e5ef70186e8889068d23a885d1979a5c","2020-03-23T20:00:00Z",1,NA,1055,790,790,46,0,0,22,7,29
"3743",20200323,"TN",615,3272,NA,NA,NA,NA,NA,NA,NA,NA,"B","3/23/2020 15:00","c412fcca3ffe9234c56338745947271fd86c95f4","2020-03-23T20:00:00Z",2,NA,3887,3887,3887,47,2,0,0,110,110
"3744",20200323,"TX",352,9703,NA,NA,NA,NA,NA,NA,NA,NA,"A","3/23/2020 13:00","07e9dee831230ca7dc26bb043584140a45d7e5aa","2020-03-23T20:00:00Z",8,NA,10055,10055,10055,48,3,0,1281,18,1299
"3745",20200323,"UT",257,4790,NA,NA,NA,NA,NA,NA,NA,NA,"A","3/23/2020 15:00","99b39eb91e625fb1a66d7d28c7fba037120fc86c","2020-03-23T20:00:00Z",1,NA,5047,5047,5047,49,0,0,1282,76,1358
"3746",20200323,"VA",254,3443,NA,NA,38,NA,NA,NA,NA,NA,"A","3/23/2020 00:00","06332ec93603d7af13fb94a5c76d86b829641592","2020-03-23T20:00:00Z",6,38,3697,3697,3697,51,3,6,325,35,360
"3747",20200323,"VI",17,NA,NA,NA,NA,NA,NA,NA,NA,NA,"","3/22/2020 20:30","a8bad8e99852a4f0b960d02375b9ddb4aca1194e","2020-03-23T20:00:00Z",NA,NA,17,17,17,78,0,0,0,11,11
"3748",20200323,"VT",97,1424,NA,NA,NA,NA,NA,NA,NA,NA,"A","3/23/2020 00:00","b3089d92fb41eb5423a34071496978112c13c4b7","2020-03-23T20:00:00Z",5,NA,1521,1521,1521,50,3,0,220,21,241
"3749",20200323,"WA",3604,48508,NA,NA,NA,NA,NA,NA,NA,NA,"A","3/23/2020 00:00","c818ffe9478f4b7ef8515474cf6e60d0feb5c662","2020-03-23T20:00:00Z",137,NA,52112,52112,52112,53,11,0,4845,463,5308
"3750",20200323,"WI",416,7050,NA,NA,NA,NA,NA,NA,NA,NA,"A","3/23/2020 16:00","4f40f488914be1910b8c85b390bf30ceaf63362e","2020-03-23T20:00:00Z",5,NA,7466,7466,7466,55,1,0,820,31,851
"3751",20200323,"WV",16,444,4,NA,1,NA,NA,NA,NA,NA,"B","3/22/2020 19:00","69b93dc3791f0b80fbeb826f2d8e8059d737a20e","2020-03-23T20:00:00Z",0,1,464,460,460,54,0,0,59,4,63
"3752",20200323,"WY",26,592,NA,NA,NA,NA,NA,NA,NA,NA,"A","3/23/2020 14:00","250c0c2bc6d30ed66e56adc05be0ea851b8f97a1","2020-03-23T20:00:00Z",NA,NA,618,618,618,56,0,0,154,2,156
"3753",20200322,"AK",22,946,NA,NA,0,NA,NA,NA,NA,NA,"","3/21/2020 16:30","e669781c62a117ab762f1da8f91c871c513e9e56","2020-03-22T20:00:00Z",0,0,968,968,968,2,0,0,188,8,196
"3754",20200322,"AL",138,1464,NA,NA,NA,NA,NA,NA,NA,NA,"","3/22/2020 10:37","6e25732fb6cbdc929597b28f6adbaace2008c82d","2020-03-22T20:00:00Z",0,NA,1602,1602,1602,1,0,0,1436,14,1450
"3755",20200322,"AR",165,711,119,13,NA,NA,NA,NA,NA,NA,"","3/22/2020 13:45","304ea055fd1909c32446df54144c2f17b4207813","2020-03-22T20:00:00Z",0,NA,995,876,876,5,0,0,144,47,191
"3756",20200322,"AS",NA,NA,NA,NA,NA,NA,NA,NA,NA,NA,"","3/19/2020 00:00","9d9169e3810d30e31b1eeeb7c3fe7292245c1c04","2020-03-22T20:00:00Z",0,NA,0,0,0,60,0,0,0,0,0
"3757",20200322,"AZ",152,282,87,NA,NA,NA,NA,NA,NA,NA,"","3/22/2020 00:00","8909444bc385cb17af32caf4fcfe463203c931e3","2020-03-22T20:00:00Z",2,NA,521,434,434,4,1,0,42,48,90
"3758",20200322,"CA",1536,11304,NA,NA,NA,NA,NA,NA,NA,NA,"","3/22/2020 13:34","f48b09557316ba13035d6aaab0d05f7b6e4eb5f5","2020-03-22T20:00:00Z",27,NA,12840,12840,12840,6,3,0,55,257,312
"3759",20200322,"CO",475,4075,NA,56,49,NA,NA,NA,NA,NA,"","3/21/2020 18:00","eb9aabf33ed6a9aefa1ca268e1f87ff7bac835ce","2020-03-22T20:00:00Z",5,49,4550,4550,4550,8,1,5,758,112,870
"3760",20200322,"CT",223,2877,NA,43,NA,NA,NA,NA,NA,NA,"","3/21/2020 19:30","89843b6e31494dbdb2c2f5d2da9425776d483f21","2020-03-22T20:00:00Z",5,NA,3100,3100,3100,9,1,0,771,29,800
"3761",20200322,"DC",98,957,NA,NA,NA,NA,NA,NA,NA,NA,"","3/21/2020 19:30","9e7e50e1ce55f7c7d056ae37d6fa5abb90545f9b","2020-03-22T20:00:00Z",1,NA,1055,1055,1055,11,0,0,451,21,472
"3762",20200322,"DE",56,36,NA,NA,NA,NA,NA,NA,NA,NA,"","3/22/2020 16:15","8986894e94ae98603dd5f453a820580862e632de","2020-03-22T20:00:00Z",0,NA,92,92,92,10,0,0,0,11,11
"3763",20200322,"FL",830,7990,963,NA,185,NA,NA,NA,NA,NA,"","3/22/2020 11:00","2d497f311268ed292cf463f58943175da2059b45","2020-03-22T20:00:00Z",13,185,9783,8820,8820,12,1,27,1411,172,1583
"3764",20200322,"GA",600,3420,NA,NA,NA,NA,NA,NA,NA,NA,"","3/22/2020 12:00","44f1c92fc037da18081686b3f2acfe4dd856a2fa","2020-03-22T20:00:00Z",23,NA,4020,4020,4020,13,9,0,863,93,956
"3765",20200322,"GU",27,126,NA,NA,NA,NA,NA,NA,NA,NA,"","3/22/2020 07:00","4aad50bd3e1b8249ee721b72e8833d6c8dca6504","2020-03-22T20:00:00Z",1,NA,153,153,153,66,1,0,18,12,30
"3766",20200322,"HI",48,263,NA,NA,NA,NA,NA,NA,NA,NA,"","3/21/2020 18:00","129ba0e198c828294922c6de227dd688c55ff9c9","2020-03-22T20:00:00Z",NA,NA,311,311,311,15,0,0,139,11,150
"3767",20200322,"IA",90,1215,NA,NA,NA,NA,NA,NA,NA,NA,"","3/22/2020 00:00","0431b902c31884f64b26f019d5177acebd58e8cf","2020-03-22T20:00:00Z",NA,NA,1305,1305,1305,19,0,0,166,22,188
"3768",20200322,"ID",42,1175,NA,NA,NA,NA,NA,NA,NA,NA,"","3/21/2020 19:55","53868749c68edfc9881fb8ab5732f71e1edd754c","2020-03-22T20:00:00Z",0,NA,1217,1217,1217,16,0,0,295,11,306
"3769",20200322,"IL",1049,7271,NA,NA,NA,NA,NA,NA,NA,NA,"","3/22/2020 00:00","fdd66fb0ee203fc25f48300975504b1ec74f12ab","2020-03-22T20:00:00Z",9,NA,8320,8320,8320,17,3,0,1783,296,2079
"3770",20200322,"IN",201,1293,NA,NA,1,NA,NA,NA,NA,NA,"","3/13/2020 00:59","c819ec0c992adca61f1555b7dab422d788b2a35a","2020-03-22T20:00:00Z",6,1,1494,1494,1494,18,2,0,586,75,661
"3771",20200322,"KS",64,417,NA,NA,NA,NA,NA,NA,NA,NA,"","3/21/2020 11:00","a80b13f76279d9092d3b9e05b02f7d3ad2d02b5f","2020-03-22T20:00:00Z",2,NA,481,481,481,20,0,0,0,9,9
"3772",20200322,"KY",99,1472,NA,NA,NA,NA,NA,NA,NA,NA,"","3/22/2020 09:00","88cd469a44338e2514ace0f4905d3e5171f9fe58","2020-03-22T20:00:00Z",3,NA,1571,1571,1571,21,1,0,758,45,803
"3773",20200322,"LA",837,2661,NA,NA,NA,NA,NA,NA,NA,NA,"","3/22/2020 10:00","b583f2540f47c592482ce101079c06088ec75d76","2020-03-22T20:00:00Z",20,NA,3498,3498,3498,22,4,0,481,257,738
"3774",20200322,"MA",547,5476,NA,NA,71,NA,NA,NA,NA,NA,"","3/22/2020 16:00","f35e651e27a808654757bdf97133ad0b3d2db999","2020-03-22T20:00:00Z",11,71,6023,6023,6023,25,4,10,677,121,798
"3775",20200322,"MD",244,94,NA,NA,NA,NA,NA,NA,NA,NA,"","3/22/2020 10:00","897f0c375b571a4b73bcc1db59694e1da968cc83","2020-03-22T20:00:00Z",3,NA,338,338,338,24,1,0,0,54,54
"3776",20200322,"ME",89,2264,NA,NA,NA,NA,NA,NA,NA,NA,"","3/22/2020 12:15","8052b9c8fa717462e6311a49ff662c98cb6eb496","2020-03-22T20:00:00Z",NA,NA,2353,2353,2353,23,0,0,0,16,16
"3777",20200322,"MI",5098,3712,NA,NA,NA,NA,NA,NA,NA,NA,"","3/22/2020 15:00","a481c35630b318e877be798106138d9369a98320","2020-03-22T20:00:00Z",8,NA,8810,8810,8810,26,3,0,16,555,571
"3778",20200322,"MN",169,4511,NA,NA,12,NA,NA,NA,NA,NA,"","3/21/2020 12:10","a02f3a9a39fa92d725fcdce0d4e7025a9953ed94","2020-03-22T20:00:00Z",1,12,4680,4680,4680,27,0,12,559,31,590
"3779",20200322,"MO",90,369,NA,NA,NA,NA,NA,NA,NA,NA,"","3/21/2020 22:00","8acb19ab32326b612304c5c08df11317f736c659","2020-03-22T20:00:00Z",3,NA,459,459,459,29,0,0,0,17,17
"3780",20200322,"MP",0,NA,NA,NA,NA,NA,NA,NA,NA,NA,"","3/22/2020 01:30","86ce066ddb74fe1a280397894e69b83d7e1f28cf","2020-03-22T20:00:00Z",0,NA,0,0,0,69,0,0,0,0,0
"3781",20200322,"MS",207,1114,NA,NA,33,NA,NA,NA,NA,NA,"","3/22/2020 11:20","dbe44a236e83e149bd62ce3f41006c27edee0f94","2020-03-22T20:00:00Z",1,33,1321,1321,1321,28,0,33,419,67,486
"3782",20200322,"MT",31,1146,NA,NA,NA,NA,NA,NA,NA,NA,"","3/22/2020 00:00","77745b3217cb0d82c60680a338cccf513b69f141","2020-03-22T20:00:00Z",NA,NA,1177,1177,1177,30,0,0,0,11,11
"3783",20200322,"NC",255,6183,NA,NA,NA,NA,NA,NA,NA,NA,"","3/22/2020 10:16","c90f96825071c0c2910d2430136dbccd1816c6f4","2020-03-22T20:00:00Z",0,NA,6438,6438,6438,37,0,0,1091,71,1162
"3784",20200322,"ND",28,1260,NA,NA,3,NA,NA,NA,NA,NA,"","3/22/2020 11:39","58ff20c48f486143ef2209c34ed6207e981ec896","2020-03-22T20:00:00Z",0,3,1288,1288,1288,38,0,0,119,0,119
"3785",20200322,"NE",48,356,NA,NA,NA,NA,NA,NA,NA,NA,"","3/21/2020 00:00","6f44613da8786f96608b1371a22a2e7caafd9023","2020-03-22T20:00:00Z",0,NA,404,404,404,31,0,0,0,10,10
"3786",20200322,"NH",65,1188,959,NA,NA,NA,NA,NA,NA,NA,"","3/21/2020 09:00","86911330247703697a7cfe68ee6c89d6b86f8c43","2020-03-22T20:00:00Z",NA,NA,2212,1253,1253,33,0,0,215,10,225
"3787",20200322,"NJ",1914,327,49,NA,NA,NA,NA,NA,NA,NA,"","3/22/2020 13:30","abd0b321c43928525cc184d15d1cb5cab26b8725","2020-03-22T20:00:00Z",20,NA,2290,2241,2241,34,4,0,33,587,620
"3788",20200322,"NM",57,4722,NA,NA,NA,NA,NA,NA,NA,NA,"","3/21/2020 00:00","083019efe27992e6acd9634ad5c5d5e885dac047","2020-03-22T20:00:00Z",NA,NA,4779,4779,4779,35,0,0,951,0,951
"3789",20200322,"NV",190,2448,NA,NA,NA,NA,NA,NA,NA,NA,"","3/21/2020 14:00","a6638efc87821290d4eff47b0d3711c5d4436877","2020-03-22T20:00:00Z",2,NA,2638,2638,2638,32,0,0,64,66,130
"3790",20200322,"NY",15168,46233,NA,2043,1974,NA,NA,NA,NA,NA,"","3/22/2020 11:00","158fc2e8d902a0fd3ae2187878a8093152cc396d","2020-03-22T20:00:00Z",114,1974,61401,61401,61401,36,70,371,11152,4812,15964
"3791",20200322,"OH",351,140,NA,NA,83,NA,NA,NA,NA,NA,"","3/20/2020 14:00","57bf8be935019760d541377a94752cb7f1244018","2020-03-22T20:00:00Z",3,83,491,491,491,39,0,25,0,104,104
"3792",20200322,"OK",67,669,102,NA,11,NA,NA,NA,NA,NA,"","3/22/2020 08:00","fcb081cc967661023631a03ee9a9c38648286359","2020-03-22T20:00:00Z",2,11,838,736,736,40,1,1,109,14,123
"3793",20200322,"OR",161,2864,NA,NA,43,NA,NA,NA,NA,NA,"","3/22/2020 11:00","947754da65727fc21c3201568f258275d40ca4f8","2020-03-22T20:00:00Z",4,43,3025,3025,3025,41,1,43,861,47,908
"3794",20200322,"PA",479,4964,NA,NA,NA,NA,NA,NA,NA,NA,"","3/22/2020 12:00","263e8d82c415eb7fc0ab8198d2a3b1157b8dd454","2020-03-22T20:00:00Z",2,NA,5443,5443,5443,42,0,0,1198,108,1306
"3795",20200322,"PR",23,183,69,NA,NA,NA,NA,NA,NA,NA,"","3/22/2020 07:00","a9223cc0317856448928393e143d61b8c8da28c9","2020-03-22T20:00:00Z",1,NA,275,206,206,72,1,0,40,2,42
"3796",20200322,"RI",83,932,216,NA,NA,NA,NA,NA,NA,NA,"","3/22/2020 15:25","365a2fb9dd8bc3b39d97c41ad8fa885ad9e02a7d","2020-03-22T20:00:00Z",NA,NA,1231,1015,1015,44,0,0,70,17,87
"3797",20200322,"SC",195,1466,NA,NA,NA,NA,NA,NA,NA,NA,"","3/22/2020 15:40","43d0609c89969ab6607be4c995979b9e873f886b","2020-03-22T20:00:00Z",3,NA,1661,1661,1661,45,2,0,211,43,254
"3798",20200322,"SD",21,740,277,NA,NA,NA,NA,NA,NA,NA,"","3/22/2020 12:30","c0477c64020d543fdc41098347ced64869fb923b","2020-03-22T20:00:00Z",1,NA,1038,761,761,46,0,0,49,7,56
"3799",20200322,"TN",505,3272,NA,NA,NA,NA,NA,NA,NA,NA,"","3/22/2020 15:00","8a41c2fbc4e11313f40eb203f70ffdf28bc63002","2020-03-22T20:00:00Z",NA,NA,3777,3777,3777,47,0,0,0,134,134
"3800",20200322,"TX",334,8422,NA,NA,NA,NA,NA,NA,NA,NA,"","3/21/2020 21:00","8156ddffdc59ddaf52d4bcebb89c0f5f34ef7445","2020-03-22T20:00:00Z",5,NA,8756,8756,8756,48,0,0,2204,30,2234
"3801",20200322,"UT",181,3508,NA,NA,NA,NA,NA,NA,NA,NA,"","3/22/2020 15:00","fdb2d30d5fa2555cd5c3ea807c5d6c6bf33032f2","2020-03-22T20:00:00Z",1,NA,3689,3689,3689,49,1,0,1084,45,1129
"3802",20200322,"VA",219,3118,NA,NA,32,NA,NA,NA,NA,NA,"","3/21/2020 17:00","3fec7d22ce2ce39d390d3318a017432bdbd27214","2020-03-22T20:00:00Z",3,32,3337,3337,3337,51,1,7,480,67,547
"3803",20200322,"VI",6,NA,NA,NA,NA,NA,NA,NA,NA,NA,"","3/21/2020 20:30","76560e5af2f7abb0a2d1b0ca03127aa3aa5fcc24","2020-03-22T20:00:00Z",NA,NA,6,6,6,78,0,0,0,0,0
"3804",20200322,"VT",76,1204,NA,NA,NA,NA,NA,NA,NA,NA,"","3/22/2020 00:00","c53e14819b3ca9052665d0a0a4254368c62b50fe","2020-03-22T20:00:00Z",2,NA,1280,1280,1280,50,0,0,124,24,148
"3805",20200322,"WA",3141,43663,NA,NA,NA,NA,NA,NA,NA,NA,"","3/22/2020 00:00","f91d25164824d4a4f8cf088837229924375a3fc0","2020-03-22T20:00:00Z",126,NA,46804,46804,46804,53,15,0,1707,183,1890
"3806",20200322,"WI",385,6230,NA,NA,NA,NA,NA,NA,NA,NA,"","3/22/2020 04:00","ec440cda383a9dad38bb20d7182decc9583d11b0","2020-03-22T20:00:00Z",4,NA,6615,6615,6615,55,0,0,1602,104,1706
"3807",20200322,"WV",12,385,1,NA,1,NA,NA,NA,NA,NA,"","3/21/2020 00:00","694914e340f8ad9a0f8061a02b8f7e2db711f8fe","2020-03-22T20:00:00Z",0,1,398,397,397,54,0,0,55,1,56
"3808",20200322,"WY",24,438,NA,NA,NA,NA,NA,NA,NA,NA,"","3/21/2020 23:00","6e035147b640db56dc1001efd97274718de151ae","2020-03-22T20:00:00Z",NA,NA,462,462,462,56,0,0,0,1,1
"3809",20200321,"AK",14,758,NA,NA,0,NA,NA,NA,NA,NA,"","3/21/2020 16:30","040a8237b6953bded6ce9cfbc7c1407cd7217925","2020-03-21T20:00:00Z",0,0,772,772,772,2,0,0,72,2,74
"3810",20200321,"AL",124,28,NA,NA,NA,NA,NA,NA,NA,NA,"","3/21/2020 11:20","cd92e175f57f1bfb3e7a1203354254d2ff491493","2020-03-21T20:00:00Z",0,NA,152,152,152,1,0,0,0,43,43
"3811",20200321,"AR",118,567,154,NA,NA,NA,NA,NA,NA,NA,"","3/21/2020 13:47","bc397f8a77d43a9767fbaa7977f376b9338e4269","2020-03-21T20:00:00Z",NA,NA,839,685,685,5,0,0,216,22,238
"3812",20200321,"AS",NA,NA,NA,NA,NA,NA,NA,NA,NA,NA,"","3/19/2020 00:00","042b1b3840bef8bbd6db2a4b842c2fd7aff871ce","2020-03-21T20:00:00Z",0,NA,0,0,0,60,0,0,0,0,0
"3813",20200321,"AZ",104,240,122,NA,NA,NA,NA,NA,NA,NA,"","3/21/2020 00:00","f7c342dd44d13501d0deb205122630ff7ed2dbe7","2020-03-21T20:00:00Z",1,NA,466,344,344,4,1,0,29,39,68
"3814",20200321,"CA",1279,11249,NA,NA,NA,NA,NA,NA,NA,NA,"","3/21/2020 00:00","11be5894b43280fdee5e86c50102ac962e333908","2020-03-21T20:00:00Z",24,NA,12528,12528,12528,6,4,0,825,216,1041
"3815",20200321,"CO",363,3317,NA,NA,44,NA,NA,NA,NA,NA,"","3/20/2020 18:00","02508dc3c6cd71775604a46c4b29030b95e97e58","2020-03-21T20:00:00Z",4,44,3680,3680,3680,8,1,44,642,86,728
"3816",20200321,"CT",194,2106,NA,NA,NA,NA,NA,NA,NA,NA,"","3/20/2020 20:44","0698412e18b779a4fa5c40c59097b3c9ce39484b","2020-03-21T20:00:00Z",4,NA,2300,2300,2300,9,1,0,1502,0,1502
"3817",20200321,"DC",77,506,0,NA,NA,NA,NA,NA,NA,NA,"","3/20/2020 20:00","27a429092c40ad78b6f16c7ec81b5439dd426ca3","2020-03-21T20:00:00Z",1,NA,583,583,583,11,0,0,5,6,11
"3818",20200321,"DE",45,36,NA,NA,NA,NA,NA,NA,NA,NA,"","3/21/2020 15:15","28aef8d0847d80d187fdf1cccad1411239a3b3ec","2020-03-21T20:00:00Z",0,NA,81,81,81,10,0,0,0,7,7
"3819",20200321,"FL",658,6579,1002,NA,158,NA,NA,NA,NA,NA,"","3/21/2020 11:00","bb152aee28c720cb3cb005484c50ea100a373453","2020-03-21T20:00:00Z",12,158,8239,7237,7237,12,2,158,4709,138,4847
"3820",20200321,"GA",507,2557,NA,NA,NA,NA,NA,NA,NA,NA,"","3/21/2020 12:00","28c56c7b4767a7299d125fa6de677836cc0e5af1","2020-03-21T20:00:00Z",14,NA,3064,3064,3064,13,1,0,591,87,678
"3821",20200321,"GU",15,108,NA,NA,NA,NA,NA,NA,NA,NA,"","3/21/2020 07:15","dad683473732a0b95aafe7b0cc77a681eb514b91","2020-03-21T20:00:00Z",NA,NA,123,123,123,66,0,0,22,1,23
"3822",20200321,"HI",37,124,NA,NA,NA,NA,NA,NA,NA,NA,"","3/20/2020 18:00","61b56a66d010f445db5052e1be321c20eaa53b7c","2020-03-21T20:00:00Z",NA,NA,161,161,161,15,0,0,0,11,11
"3823",20200321,"IA",68,1049,NA,NA,NA,NA,NA,NA,NA,NA,"","3/21/2020 14:20","fcd35b396d0ca2e9277718b9d445e55b1e98e421","2020-03-21T20:00:00Z",NA,NA,1117,1117,1117,19,0,0,407,23,430
"3824",20200321,"ID",31,880,NA,NA,NA,NA,NA,NA,NA,NA,"","3/20/2020 19:00","357375e6ed98477935cbf0f29e949ef13e86ee96","2020-03-21T20:00:00Z",NA,NA,911,911,911,16,0,0,290,8,298
"3825",20200321,"IL",753,5488,NA,NA,NA,NA,NA,NA,NA,NA,"","3/21/2020 00:00","bdb59648c55a39e8fabf5c871d563c4b9351994d","2020-03-21T20:00:00Z",6,NA,6241,6241,6241,17,1,0,1792,168,1960
"3826",20200321,"IN",126,707,NA,NA,1,NA,NA,NA,NA,NA,"","3/21/2020 00:59","6eda9677d49081678c78017f82c5510053aced3f","2020-03-21T20:00:00Z",4,1,833,833,833,18,2,1,232,47,279
"3827",20200321,"KS",55,417,NA,NA,NA,NA,NA,NA,NA,NA,"","3/21/2020 11:00","30c7f37cad7a203e524cd2e70561552ae09dd844","2020-03-21T20:00:00Z",2,NA,472,472,472,20,1,0,0,11,11
"3828",20200321,"KY",54,714,NA,NA,NA,NA,NA,NA,NA,NA,"","3/21/2020 09:00","fe927b20c08510d96a0c85755fa4023c15ef579f","2020-03-21T20:00:00Z",2,NA,768,768,768,21,1,0,122,7,129
"3829",20200321,"LA",580,2180,NA,NA,NA,NA,NA,NA,NA,NA,"","3/21/2020 10:30","b0e27f8ec2ac6075cd3aba0d8a6267f2b3942ecc","2020-03-21T20:00:00Z",16,NA,2760,2760,2760,22,4,0,1612,107,1719
"3830",20200321,"MA",426,4799,NA,NA,61,NA,NA,NA,NA,NA,"","3/21/2020 16:00","e600ca928fc6a15ed775e849e1b7bf9619c844cd","2020-03-21T20:00:00Z",7,61,5225,5225,5225,25,2,61,1004,112,1116
"3831",20200321,"MD",190,94,NA,NA,NA,NA,NA,NA,NA,NA,"","3/21/2020 10:00","9ced6ad9dcb36e55a0685db3e05978d9a55021ea","2020-03-21T20:00:00Z",2,NA,284,284,284,24,1,0,0,41,41
"3832",20200321,"ME",73,2264,NA,NA,NA,NA,NA,NA,NA,NA,"","3/21/2020 13:30","3bb0e46a9ee15335be0c3270a1d2bb5e7ec31fd9","2020-03-21T20:00:00Z",NA,NA,2337,2337,2337,23,0,0,0,16,16
"3833",20200321,"MI",4543,3696,NA,NA,NA,NA,NA,NA,NA,NA,"","3/21/2020 13:44","08fb0718923da500d186369ff5b8725ff6feca71","2020-03-21T20:00:00Z",5,NA,8239,8239,8239,26,2,0,950,516,1466
"3834",20200321,"MN",138,3952,NA,NA,NA,NA,NA,NA,NA,NA,"","3/21/2020 00:00","ef69371b3cac3f387b10ee5aa206664447d9de5d","2020-03-21T20:00:00Z",1,NA,4090,4090,4090,27,1,0,211,23,234
"3835",20200321,"MO",73,369,NA,NA,NA,NA,NA,NA,NA,NA,"","3/20/2020 22:00","e87fdda103d3823089231443898b8eabe52a789c","2020-03-21T20:00:00Z",3,NA,442,442,442,29,2,0,0,26,26
"3836",20200321,"MP",0,NA,NA,NA,NA,NA,NA,NA,NA,NA,"","3/21/2020 02:30","4ca5a77ad4d0eb51252ebe658c5ddb47e3536ecc","2020-03-21T20:00:00Z",0,NA,0,0,0,69,0,0,0,0,0
"3837",20200321,"MS",140,695,NA,NA,NA,NA,NA,NA,NA,NA,"","3/20/2020 19:00","02d711dca0bc2b08cf6d31d9a1e33c1c810680a9","2020-03-21T20:00:00Z",1,NA,835,835,835,28,0,0,0,60,60
"3838",20200321,"MT",20,1146,NA,NA,NA,NA,NA,NA,NA,NA,"","3/20/2020 21:24","f5505d9cb48bfe3c878aecf0b86485dd36270c39","2020-03-21T20:00:00Z",NA,NA,1166,1166,1166,30,0,0,215,4,219
"3839",20200321,"NC",184,5092,NA,NA,NA,NA,NA,NA,NA,NA,"","3/21/2020 10:30","625afde07e4d5c4c50cec7f266a4d2b6cb3b6aa6","2020-03-21T20:00:00Z",0,NA,5276,5276,5276,37,0,0,1996,47,2043
"3840",20200321,"ND",28,1141,NA,NA,3,NA,NA,NA,NA,NA,"","3/21/2020 11:56","1ada4b659febd794094e04557db9c5ee771df494","2020-03-21T20:00:00Z",0,3,1169,1169,1169,38,0,3,341,8,349
"3841",20200321,"NE",38,356,NA,NA,NA,NA,NA,NA,NA,NA,"","3/20/2020 00:00","84e390adfb1d9fca6becc45064ecc838a9576989","2020-03-21T20:00:00Z",0,NA,394,394,394,31,0,0,116,6,122
"3842",20200321,"NH",55,973,942,NA,NA,NA,NA,NA,NA,NA,"","3/20/2020 09:00","3aa08a176b1227f55b62e32a3a4522a8c953d907","2020-03-21T20:00:00Z",NA,NA,1970,1028,1028,33,0,0,228,11,239
"3843",20200321,"NJ",1327,294,40,NA,NA,NA,NA,NA,NA,NA,"","3/21/2020 13:00","1f85eb4bef925c459b836a599e6acf4242b99b7e","2020-03-21T20:00:00Z",16,NA,1661,1621,1621,34,5,0,30,437,467
"3844",20200321,"NM",57,3771,NA,NA,NA,NA,NA,NA,NA,NA,"","3/21/2020 00:00","591ea74ab920cd98e2e1436ad98ff6028bf55c58","2020-03-21T20:00:00Z",NA,NA,3828,3828,3828,35,0,0,0,14,14
"3845",20200321,"NV",124,2384,NA,NA,NA,NA,NA,NA,NA,NA,"","3/21/2020 02:59","8e28cf6bcba1d777aa5b96094f5258d41b2a64e1","2020-03-21T20:00:00Z",2,NA,2508,2508,2508,32,1,0,392,15,407
"3846",20200321,"NY",10356,35081,NA,1436,1603,NA,NA,NA,NA,NA,"","3/20/2020 21:22","6a0cf80f7c3e2f1ac498d63692836d8066eacf00","2020-03-21T20:00:00Z",44,1603,45437,45437,45437,36,9,1603,9756,3254,13010
"3847",20200321,"OH",247,140,NA,NA,58,NA,NA,NA,NA,NA,"","3/21/2020 14:00","9f4353f9875110bbe7a327f2bcb9de23e8aa54ad","2020-03-21T20:00:00Z",3,58,387,387,387,39,2,58,0,78,78
"3848",20200321,"OK",53,560,144,NA,10,NA,NA,NA,NA,NA,"","3/21/2020 08:00","ddba081c2bc298e29186c34d26d175b86287fbcb","2020-03-21T20:00:00Z",1,10,757,613,613,40,0,10,22,4,26
"3849",20200321,"OR",114,2003,433,NA,NA,NA,NA,NA,NA,NA,"","3/20/2020 11:00","831225ef9f5fe280452135906506789b82fa77d3","2020-03-21T20:00:00Z",3,NA,2550,2117,2117,41,0,0,0,0,0
"3850",20200321,"PA",371,3766,NA,NA,NA,NA,NA,NA,NA,NA,"","3/21/2020 12:00","219ee475656cef1b36b2d3f77506d5d9dda4aa62","2020-03-21T20:00:00Z",2,NA,4137,4137,4137,42,1,0,1192,103,1295
"3851",20200321,"PR",21,143,71,NA,NA,NA,NA,NA,NA,NA,"","3/21/2020 13:00","02633cfd91e716dfd137fc5f751d214726bca7c4","2020-03-21T20:00:00Z",NA,NA,235,164,164,72,0,0,29,7,36
"3852",20200321,"RI",66,862,290,NA,NA,NA,NA,NA,NA,NA,"","3/21/2020 00:00","78977933333fa413dc3437484f6ca40d99f60dee","2020-03-21T20:00:00Z",NA,NA,1218,928,928,44,0,0,62,12,74
"3853",20200321,"SC",152,1255,NA,NA,NA,NA,NA,NA,NA,NA,"","3/20/2020 16:45","6e043096edd04559bb2e9579ad01849477f64d34","2020-03-21T20:00:00Z",1,NA,1407,1407,1407,45,0,0,422,71,493
"3854",20200321,"SD",14,691,268,NA,NA,NA,NA,NA,NA,NA,"","3/21/2020 13:00","98a3d491705f2c54b6a65793adb477b03dc53cd9","2020-03-21T20:00:00Z",1,NA,973,705,705,46,0,0,28,0,28
"3855",20200321,"TN",371,3272,NA,NA,NA,NA,NA,NA,NA,NA,"","3/20/2020 22:48","8f78878b5929c5b1213feb6281ecd2a130712cc6","2020-03-21T20:00:00Z",NA,NA,3643,3643,3643,47,0,0,2709,143,2852
"3856",20200321,"TX",304,6218,NA,NA,NA,NA,NA,NA,NA,NA,"","3/21/2020 13:00","8e1276b48eda51dc0495f80dd6b663c52feeb0fe","2020-03-21T20:00:00Z",5,NA,6522,6522,6522,48,0,0,1135,110,1245
"3857",20200321,"UT",136,2424,NA,NA,NA,NA,NA,NA,NA,NA,"","3/21/2020 00:00","a32d17a5af452a1f820581469b7029f9d1805524","2020-03-21T20:00:00Z",0,NA,2560,2560,2560,49,0,0,389,24,413
"3858",20200321,"VA",152,2638,NA,NA,25,NA,NA,NA,NA,NA,"","3/21/2020 00:00","54cba1d1cf5edc40a1d5d490ae02ba682197705f","2020-03-21T20:00:00Z",2,25,2790,2790,2790,51,0,25,427,38,465
"3859",20200321,"VI",6,NA,NA,NA,NA,NA,NA,NA,NA,NA,"","3/20/2020 20:30","627a17d6d40b893aab5024266a0d7f0f7c0e7f39","2020-03-21T20:00:00Z",NA,NA,6,6,6,78,0,0,0,3,3
"3860",20200321,"VT",52,1080,NA,NA,NA,NA,NA,NA,NA,NA,"","3/21/2020 00:00","adde6b3a4e49aa73eacafc13c7c0b536608ed814","2020-03-21T20:00:00Z",2,NA,1132,1132,1132,50,0,0,123,8,131
"3861",20200321,"WA",2958,41956,NA,NA,NA,NA,NA,NA,NA,NA,"","3/21/2020 00:00","16891ab2664f0123b7e801b46cd70f0efff6f396","2020-03-21T20:00:00Z",111,NA,44914,44914,44914,53,7,0,2151,194,2345
"3862",20200321,"WI",281,4628,NA,NA,NA,NA,NA,NA,NA,NA,"","3/21/2020 16:00","234037917284f6886c9ac83ff5a8594836713adc","2020-03-21T20:00:00Z",4,NA,4909,4909,4909,55,1,0,1173,75,1248
"3863",20200321,"WV",11,330,2,NA,1,NA,NA,NA,NA,NA,"","3/21/2020 00:00","300609a19440be1a0de63fe1289b3190a4793955","2020-03-21T20:00:00Z",0,1,343,341,341,54,0,1,111,4,115
"3864",20200321,"WY",23,438,NA,NA,NA,NA,NA,NA,NA,NA,"","3/21/2020 12:30","db59757828eeac7401b65fa97cf63161cb6cea8b","2020-03-21T20:00:00Z",NA,NA,461,461,461,56,0,0,107,4,111
"3865",20200320,"AK",12,686,NA,NA,NA,NA,NA,NA,NA,NA,"","3/20/2020 16:30","f333d1fc4f737ba173a927f13856144d9ede40b1","2020-03-20T20:00:00Z",0,NA,698,698,698,2,0,0,254,6,260
"3866",20200320,"AL",81,28,NA,NA,NA,NA,NA,NA,NA,NA,"","3/20/2020 11:00","bf5fb6616f886eb47b854b0721a2360f480fa40f","2020-03-20T20:00:00Z",0,NA,109,109,109,1,0,0,0,13,13
"3867",20200320,"AR",96,351,203,NA,NA,NA,NA,NA,NA,NA,"","3/20/2020 14:19","a5720b29e0d8f374d541d90a353a19601e1852f5","2020-03-20T20:00:00Z",NA,NA,650,447,447,5,0,0,41,50,91
"3868",20200320,"AS",NA,NA,NA,NA,NA,NA,NA,NA,NA,NA,"","3/19/2020 00:00","b5f845a1c0f1a69a9d05243593a28406c1e50dfe","2020-03-20T20:00:00Z",0,NA,0,0,0,60,0,0,0,0,0
"3869",20200320,"AZ",65,211,101,NA,NA,NA,NA,NA,NA,NA,"","3/20/2020 00:00","d7a33a07f5449740a821c938c9dfa1ecd658f5cc","2020-03-20T20:00:00Z",0,NA,377,276,276,4,0,0,36,21,57
"3870",20200320,"CA",1063,10424,NA,NA,NA,NA,NA,NA,NA,NA,"","3/20/2020 14:41","fe6729bf787445cb9a968a6cec2e4fa04d2017f6","2020-03-20T20:00:00Z",20,NA,11487,11487,11487,6,2,0,1637,139,1776
"3871",20200320,"CO",277,2675,NA,NA,NA,NA,NA,NA,NA,NA,"","3/20/2020 14:42","2a9e02b94f01a3a8a0d8f62d647a452346d69fc6","2020-03-20T20:00:00Z",3,NA,2952,2952,2952,8,1,0,563,61,624
"3872",20200320,"CT",194,604,NA,NA,NA,NA,NA,NA,NA,NA,"","3/20/2020 15:30","82d7c04711d2250a6521626879f891664df69159","2020-03-20T20:00:00Z",3,NA,798,798,798,9,2,0,0,98,98
"3873",20200320,"DC",71,501,1,NA,NA,NA,NA,NA,NA,NA,"","3/20/2020 00:00","31a50414682108091da02020ac11dbfdae69cfb3","2020-03-20T20:00:00Z",1,NA,573,572,572,11,1,0,348,32,380
"3874",20200320,"DE",38,36,NA,NA,NA,NA,NA,NA,NA,NA,"","3/20/2020 10:00","b1e7ae87824d0392da820c4fe75c92f7df72427e","2020-03-20T20:00:00Z",0,NA,74,74,74,10,0,0,0,8,8
"3875",20200320,"FL",520,1870,1026,NA,NA,NA,NA,NA,NA,NA,"","3/20/2020 11:00","affc5c0207b3feda8a11ad6f607b7f7a1504f18f","2020-03-20T20:00:00Z",10,NA,3416,2390,2390,12,2,0,337,130,467
"3876",20200320,"GA",420,1966,NA,NA,NA,NA,NA,NA,NA,NA,"","3/20/2020 12:00","2a0014800bc0d1e4682848e5aa4380ba986eecab","2020-03-20T20:00:00Z",13,NA,2386,2386,2386,13,3,0,422,133,555
"3877",20200320,"GU",14,86,NA,NA,NA,NA,NA,NA,NA,NA,"","3/20/2020 05:15","21dd574656e9d876a56e18a85b4fb696cc104f5e","2020-03-20T20:00:00Z",NA,NA,100,100,100,66,0,0,17,2,19
"3878",20200320,"HI",26,124,NA,NA,NA,NA,NA,NA,NA,NA,"","3/19/2020 18:00","2d9e66927781990760faffe23e801ad46ca97d1b","2020-03-20T20:00:00Z",NA,NA,150,150,150,15,0,0,31,10,41
"3879",20200320,"IA",45,642,NA,NA,NA,NA,NA,NA,NA,NA,"","3/20/2020 16:15","b49315b9768ffb0225a9b4e60a03131af4707b65","2020-03-20T20:00:00Z",NA,NA,687,687,687,19,0,0,559,7,566
"3880",20200320,"ID",23,590,NA,NA,NA,NA,NA,NA,NA,NA,"","3/19/2020 19:00","e6c8e53489bdbd8c0714a37b487f376a9ac0e5fe","2020-03-20T20:00:00Z",NA,NA,613,613,613,16,0,0,131,12,143
"3881",20200320,"IL",585,3696,NA,NA,NA,NA,NA,NA,NA,NA,"","3/20/2020 00:00","0d2c8e9e067e8a3b344a7ec63c3a64bc75377f77","2020-03-20T20:00:00Z",5,NA,4281,4281,4281,17,1,0,971,163,1134
"3882",20200320,"IN",79,475,NA,NA,NA,NA,NA,NA,NA,NA,"","3/20/2020 00:59","b393f22b3dc04bc490cf82c796f70a94c3eb3b8f","2020-03-20T20:00:00Z",2,NA,554,554,554,18,0,0,151,23,174
"3883",20200320,"KS",44,417,NA,NA,NA,NA,NA,NA,NA,NA,"","3/20/2020 11:00","5ac90e55acb39552bfc148acdfd3de65aeb10872","2020-03-20T20:00:00Z",1,NA,461,461,461,20,0,0,0,10,10
"3884",20200320,"KY",47,592,NA,NA,NA,NA,NA,NA,NA,NA,"","3/19/2020 17:00","8b4815287e24716dec465941a133094a4726ca45","2020-03-20T20:00:00Z",1,NA,639,639,639,21,0,0,138,12,150
"3885",20200320,"LA",473,568,NA,NA,NA,NA,NA,NA,NA,NA,"","3/20/2020 15:30","98cce02eca5663435a48083902ed814f1e8bfc42","2020-03-20T20:00:00Z",12,NA,1041,1041,1041,22,4,0,110,126,236
"3886",20200320,"MA",314,3795,NA,NA,NA,NA,NA,NA,NA,NA,"","3/20/2020 16:00","fbb2ca94fd12b061247a3bcc3fea88c0208b0377","2020-03-20T20:00:00Z",5,NA,4109,4109,4109,25,2,0,877,85,962
"3887",20200320,"MD",149,94,NA,NA,NA,NA,NA,NA,NA,NA,"","3/20/2020 10:00","986c1f546e6d722997440961f9197bc40d0371f4","2020-03-20T20:00:00Z",1,NA,243,243,243,24,0,0,0,42,42
"3888",20200320,"ME",57,2264,NA,NA,NA,NA,NA,NA,NA,NA,"","3/20/2020 11:00","530faad333217ca7ac115e0ee0f5e113a2b598eb","2020-03-20T20:00:00Z",NA,NA,2321,2321,2321,23,0,0,260,4,264
"3889",20200320,"MI",4027,2746,NA,NA,NA,NA,NA,NA,NA,NA,"","3/20/2020 15:00","a6d3c1c40162f3ad60bde7e7d6640e61e45898ee","2020-03-20T20:00:00Z",3,NA,6773,6773,6773,26,0,0,961,635,1596
"3890",20200320,"MN",115,3741,NA,NA,NA,NA,NA,NA,NA,NA,"","3/20/2020 00:00","d6456d258a6dbf9bfab58a3e0e49b20d99f81c43","2020-03-20T20:00:00Z",NA,NA,3856,3856,3856,27,0,0,792,26,818
"3891",20200320,"MO",47,369,NA,NA,NA,NA,NA,NA,NA,NA,"","3/20/2020 10:05","46a8439036d794e92c4fce683179a5aa0083172e","2020-03-20T20:00:00Z",1,NA,416,416,416,29,0,0,61,23,84
"3892",20200320,"MP",0,NA,NA,NA,NA,NA,NA,NA,NA,NA,"","3/20/2020 01:30","35e22e6d40bff22834775bb846e2c8bcac54ff55","2020-03-20T20:00:00Z",0,NA,0,0,0,69,0,0,0,0,0
"3893",20200320,"MS",80,695,NA,NA,NA,NA,NA,NA,NA,NA,"","3/20/2020 11:35","2101901e491663b010b5383bc69316111dd412c0","2020-03-20T20:00:00Z",1,NA,775,775,775,28,1,0,143,30,173
"3894",20200320,"MT",16,931,NA,NA,NA,NA,NA,NA,NA,NA,"","3/19/2020 22:11","3f278c4e6c85804ab658f99eff2b112ebf97c279","2020-03-20T20:00:00Z",NA,NA,947,947,947,30,0,0,170,4,174
"3895",20200320,"NC",137,3096,NA,NA,NA,NA,NA,NA,NA,NA,"","3/20/2020 09:35","cffc82dad7fa0202dbd118dcf48d7e729062e902","2020-03-20T20:00:00Z",0,NA,3233,3233,3233,37,0,0,688,40,728
"3896",20200320,"ND",20,800,NA,NA,NA,NA,NA,NA,NA,NA,"","3/20/2020 00:00","fc60e38fb70309ed9a37763acde6537a0b660f46","2020-03-20T20:00:00Z",0,NA,820,820,820,38,0,0,307,5,312
"3897",20200320,"NE",32,240,NA,NA,NA,NA,NA,NA,NA,NA,"","3/19/2020 00:00","afe941b22231fc86e9fbfedf9d0c4df757c8195b","2020-03-20T20:00:00Z",0,NA,272,272,272,31,0,0,0,5,5
"3898",20200320,"NH",44,745,631,NA,NA,NA,NA,NA,NA,NA,"","3/19/2020 09:00","1dea046789bad1e28758b2d292f819fbfc2cf935","2020-03-20T20:00:00Z",NA,NA,1420,789,789,33,0,0,124,5,129
"3899",20200320,"NJ",890,264,86,NA,NA,NA,NA,NA,NA,NA,"","3/20/2020 13:30","4d0d4c35d528b6ff69abc29317698c01c40db4ce","2020-03-20T20:00:00Z",11,NA,1240,1154,1154,34,2,0,54,148,202
"3900",20200320,"NM",43,3771,NA,NA,NA,NA,NA,NA,NA,NA,"","3/20/2020 00:00","40ce43691cf50a94d343781abf50e61222297a59","2020-03-20T20:00:00Z",NA,NA,3814,3814,3814,35,0,0,1009,8,1017
"3901",20200320,"NV",109,1992,NA,NA,NA,NA,NA,NA,NA,NA,"","3/20/2020 02:59","717f9a2099af62ba60df3de77f6a8b21fb422012","2020-03-20T20:00:00Z",1,NA,2101,2101,2101,32,0,0,366,14,380
"3902",20200320,"NY",7102,25325,NA,1042,NA,NA,NA,NA,NA,NA,"","3/20/2020 13:20","095d6b7dfaf049aed260c22124a93718d18a054d","2020-03-20T20:00:00Z",35,NA,32427,32427,32427,36,23,0,7193,2950,10143
"3903",20200320,"OH",169,140,NA,NA,NA,NA,NA,NA,NA,NA,"","3/20/2020 14:00","57c8d7e0e3fa63168f7a074cd9c934a111580dd2","2020-03-20T20:00:00Z",1,NA,309,309,309,39,1,0,0,50,50
"3904",20200320,"OK",49,538,374,NA,NA,NA,NA,NA,NA,NA,"","3/20/2020 08:00","ad1e7d8fad796986ea43c8f55624fee36ad031e2","2020-03-20T20:00:00Z",1,NA,961,587,587,40,0,0,72,5,77
"3905",20200320,"OR",114,2003,433,NA,NA,NA,NA,NA,NA,NA,"","3/20/2020 11:00","8599fd013560af7956452e54b211cb24647435d4","2020-03-20T20:00:00Z",3,NA,2550,2117,2117,41,0,0,674,26,700
"3906",20200320,"PA",268,2574,NA,NA,NA,NA,NA,NA,NA,NA,"","3/20/2020 12:00","2c9d0ab0ac8469adb5c067f7da7778d4d826f62c","2020-03-20T20:00:00Z",1,NA,2842,2842,2842,42,0,0,966,83,1049
"3907",20200320,"PR",14,114,52,NA,NA,NA,NA,NA,NA,NA,"","3/20/2020 13:00","eb9414336fd8b0d1c249316b2f79c76fec95d0b2","2020-03-20T20:00:00Z",NA,NA,180,128,128,72,0,0,58,9,67
"3908",20200320,"RI",54,800,140,NA,NA,NA,NA,NA,NA,NA,"","3/20/2020 00:00","74b7d9c0e3c8566dc3d94e79d354a7ecd923b04e","2020-03-20T20:00:00Z",NA,NA,994,854,854,44,0,0,146,10,156
"3909",20200320,"SC",81,833,NA,NA,NA,NA,NA,NA,NA,NA,"","3/19/2020 17:10","bbe54041e63a8b9b76529a5804806700fb9eb47a","2020-03-20T20:00:00Z",1,NA,914,914,914,45,0,0,250,21,271
"3910",20200320,"SD",14,663,270,NA,NA,NA,NA,NA,NA,NA,"","3/20/2020 00:00","00c536cfd1f8ceee328ba506466648f64fb8bef2","2020-03-20T20:00:00Z",1,NA,947,677,677,46,0,0,112,3,115
"3911",20200320,"TN",228,563,NA,NA,NA,NA,NA,NA,NA,NA,"","3/20/2020 15:00","198e4984d0017d7b47fdceb68397bbd6cc3cb9f3","2020-03-20T20:00:00Z",NA,NA,791,791,791,47,0,0,214,74,288
"3912",20200320,"TX",194,5083,NA,NA,NA,NA,NA,NA,NA,NA,"","3/20/2020 13:00","23bf3cf557b06275baeec7fb3da8fbce4009e33a","2020-03-20T20:00:00Z",5,NA,5277,5277,5277,48,2,0,2871,51,2922
"3913",20200320,"UT",112,2035,NA,NA,NA,NA,NA,NA,NA,NA,"","3/20/2020 00:00","a7b8df9cdc110ddabb950f997109392746d20816","2020-03-20T20:00:00Z",0,NA,2147,2147,2147,49,0,0,587,34,621
"3914",20200320,"VA",114,2211,NA,NA,NA,NA,NA,NA,NA,NA,"","3/20/2020 00:00","8e33ca5ea7c8e944df67dcfb436114e9af630816","2020-03-20T20:00:00Z",2,NA,2325,2325,2325,51,0,0,382,20,402
"3915",20200320,"VI",3,NA,NA,NA,NA,NA,NA,NA,NA,NA,"","3/19/2020 17:30","4bdedbd6c7ede4c935b5e374822373dd9d56fe24","2020-03-20T20:00:00Z",NA,NA,3,3,3,78,0,0,0,0,0
"3916",20200320,"VT",44,957,NA,NA,NA,NA,NA,NA,NA,NA,"","3/20/2020 00:00","90c96d5ad1b1a94947776db3cf955f466c72e4b2","2020-03-20T20:00:00Z",2,NA,1001,1001,1001,50,2,0,193,16,209
"3917",20200320,"WA",2764,39805,NA,NA,NA,NA,NA,NA,NA,NA,"","3/20/2020 00:00","9ef708c001a480dc4c232ec93c472130cedd3472","2020-03-20T20:00:00Z",104,NA,42569,42569,42569,53,12,0,3765,303,4068
"3918",20200320,"WI",206,3455,NA,NA,NA,NA,NA,NA,NA,NA,"","3/20/2020 16:00","0218e1e542519ea06e22b72b25fe4094a9a53db9","2020-03-20T20:00:00Z",3,NA,3661,3661,3661,55,3,0,1263,51,1314
"3919",20200320,"WV",7,219,13,NA,NA,NA,NA,NA,NA,NA,"","3/20/2020 00:00","7eabc07935f2e032f22abdb69e9d9c58edf9561e","2020-03-20T20:00:00Z",0,NA,239,226,226,54,0,0,76,5,81
"3920",20200320,"WY",19,331,NA,NA,NA,NA,NA,NA,NA,NA,"","3/20/2020 13:30","e5aec9eb24d3628cd8b19e4ef042f5171c3150f0","2020-03-20T20:00:00Z",NA,NA,350,350,350,56,0,0,60,1,61
"3921",20200319,"AK",6,432,NA,NA,NA,NA,NA,NA,NA,NA,"","3/18/2020 16:30","2f94c7b77ddd84452d1a7abc0c35bfbb30a683ec","2020-03-19T20:00:00Z",0,NA,438,438,438,2,0,0,26,0,26
"3922",20200319,"AL",68,28,NA,NA,NA,NA,NA,NA,NA,NA,"","3/19/2020 10:45","f9fa0f9d46fc27c74c8d59db3eafd1e4fc7907e2","2020-03-19T20:00:00Z",0,NA,96,96,96,1,0,0,0,22,22
"3923",20200319,"AR",46,310,113,NA,NA,NA,NA,NA,NA,NA,"","3/19/2020 11:23","c140738f20dcbecfd202c687e402bf390b92bdbb","2020-03-19T20:00:00Z",NA,NA,469,356,356,5,0,0,74,13,87
"3924",20200319,"AS",NA,NA,NA,NA,NA,NA,NA,NA,NA,NA,"","3/14/2020 00:00","4f5cedfdee60489e52005613c4641eaea97d40a3","2020-03-19T20:00:00Z",0,NA,0,0,0,60,0,0,0,0,0
"3925",20200319,"AZ",44,175,130,NA,NA,NA,NA,NA,NA,NA,"","3/19/2020 00:00","0b6127b6f71258575296e73b0230144c7353a5de","2020-03-19T20:00:00Z",0,NA,349,219,219,4,0,0,27,16,43
"3926",20200319,"CA",924,8787,NA,NA,NA,NA,NA,NA,NA,NA,"","3/19/2020 14:25","8210e10bb4f132716a18da56c454714b06f5883b","2020-03-19T20:00:00Z",18,NA,9711,9711,9711,6,5,0,806,313,1119
"3927",20200319,"CO",216,2112,NA,NA,NA,NA,NA,NA,NA,NA,"","3/18/2020 18:30","f3aa598866917c72e2597d90acfdedef0df5bcd7","2020-03-19T20:00:00Z",2,NA,2328,2328,2328,8,0,0,495,33,528
"3928",20200319,"CT",96,604,NA,NA,NA,NA,NA,NA,NA,NA,"","3/18/2020 16:30","1321ae678334e29bd3fbb7f8324394a8d72dcbfe","2020-03-19T20:00:00Z",1,NA,700,700,700,9,1,0,479,28,507
"3929",20200319,"DC",39,153,11,NA,NA,NA,NA,NA,NA,NA,"","3/18/2020 00:00","77eed4c990c7a280ae76a562b21fdc50337f3a8e","2020-03-19T20:00:00Z",0,NA,203,192,192,11,0,0,15,8,23
"3930",20200319,"DE",30,36,NA,NA,NA,NA,NA,NA,NA,NA,"","3/19/2020 12:00","0ca9be78a3594a83e9a6b4c7cc03e4eb433f128c","2020-03-19T20:00:00Z",0,NA,66,66,66,10,0,0,0,5,5
"3931",20200319,"FL",390,1533,1019,NA,NA,NA,NA,NA,NA,NA,"","3/19/2020 11:00","1c5b5851e5399d6bd6a8660b4f9a1ac067b0a5ff","2020-03-19T20:00:00Z",8,NA,2942,1923,1923,12,1,0,308,76,384
"3932",20200319,"GA",287,1544,NA,NA,NA,NA,NA,NA,NA,NA,"","3/19/2020 12:00","b5eea88a2941fab0e43ed38379304dd95d03b625","2020-03-19T20:00:00Z",10,NA,1831,1831,1831,13,9,0,233,90,323
"3933",20200319,"GU",12,69,NA,NA,NA,NA,NA,NA,NA,NA,"","3/19/2020 05:15","30aa01def5d0ea6b711ed84ad75b90ec7f3090c1","2020-03-19T20:00:00Z",NA,NA,81,81,81,66,0,0,12,4,16
"3934",20200319,"HI",16,93,NA,NA,NA,NA,NA,NA,NA,NA,"","3/18/2020 18:00","3ba6e1d7028c7f39e397aff0d911fe7921a8987d","2020-03-19T20:00:00Z",NA,NA,109,109,109,15,0,0,0,2,2
"3935",20200319,"IA",38,83,NA,NA,NA,NA,NA,NA,NA,NA,"","3/18/2020 19:39","91f4b28c8ab0e1f684742bfe9d28762dda64b67d","2020-03-19T20:00:00Z",NA,NA,121,121,121,19,0,0,0,9,9
"3936",20200319,"ID",11,459,NA,NA,NA,NA,NA,NA,NA,NA,"","3/18/2020 10:30","dd1dea8a4555108ad610b4ecca72fd1b3bfed7fd","2020-03-19T20:00:00Z",NA,NA,470,470,470,16,0,0,0,2,2
"3937",20200319,"IL",422,2725,NA,NA,NA,NA,NA,NA,NA,NA,"","3/19/2020 00:00","936159c33c2080bb8b458e81cbadf87f65e125f9","2020-03-19T20:00:00Z",4,NA,3147,3147,3147,17,3,0,962,134,1096
"3938",20200319,"IN",56,324,NA,NA,NA,NA,NA,NA,NA,NA,"","3/19/2020 00:59","44a5f654c9e0ae86489cb787e7ac79d18d916549","2020-03-19T20:00:00Z",2,NA,380,380,380,18,0,0,170,17,187
"3939",20200319,"KS",34,417,NA,NA,NA,NA,NA,NA,NA,NA,"","3/19/2020 11:00","3e179b33ab482d2a66401182b771976b22d7696d","2020-03-19T20:00:00Z",1,NA,451,451,451,20,0,0,0,18,18
"3940",20200319,"KY",35,454,NA,NA,NA,NA,NA,NA,NA,NA,"","3/18/2020 17:00","3f6fdaf373a319f162b56fa128ed69eeea008adf","2020-03-19T20:00:00Z",1,NA,489,489,489,21,0,0,100,9,109
"3941",20200319,"LA",347,458,NA,NA,NA,NA,NA,NA,NA,NA,"","3/19/2020 10:30","5d28fad455f9f5603634125b1944a61265090e0b","2020-03-19T20:00:00Z",8,NA,805,805,805,22,2,0,123,107,230
"3942",20200319,"MA",229,2918,NA,NA,NA,NA,NA,NA,NA,NA,"","3/19/2020 11:30","3188ba2f263b4d972999d889114b0ed26ebff83e","2020-03-19T20:00:00Z",3,NA,3147,3147,3147,25,1,0,803,73,876
"3943",20200319,"MD",107,94,NA,NA,NA,NA,NA,NA,NA,NA,"","3/19/2020 10:00","1ce41f5ecdc759daf656cb52e25546390bd57da7","2020-03-19T20:00:00Z",1,NA,201,201,201,24,1,0,0,22,22
"3944",20200319,"ME",53,2004,NA,NA,NA,NA,NA,NA,NA,NA,"","3/19/2020 12:15","67a67e0318524fe1dc2f7a679d93f8073b034de5","2020-03-19T20:00:00Z",NA,NA,2057,2057,2057,23,0,0,334,10,344
"3945",20200319,"MI",3392,1785,NA,NA,NA,NA,NA,NA,NA,NA,"","3/19/2020 15:00","4478ecbc50eed65b9f63798dcefa86e3d58858f4","2020-03-19T20:00:00Z",3,NA,5177,5177,5177,26,3,0,570,479,1049
"3946",20200319,"MN",89,2949,NA,NA,NA,NA,NA,NA,NA,NA,"","3/19/2020 00:00","fe3caa05cbfaecea82c925908d44f6a5cdf7b283","2020-03-19T20:00:00Z",NA,NA,3038,3038,3038,27,0,0,264,12,276
"3947",20200319,"MO",24,308,NA,NA,NA,NA,NA,NA,NA,NA,"","3/18/2020 20:00","4b64158f7354396fb911af095db36f9d0d18e56f","2020-03-19T20:00:00Z",1,NA,332,332,332,29,1,0,55,11,66
"3948",20200319,"MP",0,NA,NA,NA,NA,NA,NA,NA,NA,NA,"","3/19/2020 01:30","1def757560099005da5a8744902d8d323d2156f3","2020-03-19T20:00:00Z",0,NA,0,0,0,69,0,0,0,0,0
"3949",20200319,"MS",50,552,NA,NA,NA,NA,NA,NA,NA,NA,"","3/19/2020 00:00","1a2cdaacab2980d884cbcebafc23d81c0379f114","2020-03-19T20:00:00Z",NA,NA,602,602,602,28,0,0,73,16,89
"3950",20200319,"MT",12,761,NA,NA,NA,NA,NA,NA,NA,NA,"","3/18/2020 23:23","f75c175942c8591bce86e4dfbf8cb912ac0d56db","2020-03-19T20:00:00Z",NA,NA,773,773,773,30,0,0,262,2,264
"3951",20200319,"NC",97,2408,NA,NA,NA,NA,NA,NA,NA,NA,"","3/19/2020 09:45","587e174f2a9998836dac650b58e7c84be17e3874","2020-03-19T20:00:00Z",0,NA,2505,2505,2505,37,0,0,621,34,655
"3952",20200319,"ND",15,493,NA,NA,NA,NA,NA,NA,NA,NA,"","3/19/2020 00:00","e40b18195198c2b1bf6e644113303785d4b44d30","2020-03-19T20:00:00Z",0,NA,508,508,508,38,0,0,225,9,234
"3953",20200319,"NE",27,240,NA,NA,NA,NA,NA,NA,NA,NA,"","3/18/2020 14:00","691044363cdc9c04963611246595fabbc05aa9cd","2020-03-19T20:00:00Z",0,NA,267,267,267,31,0,0,34,3,37
"3954",20200319,"NH",39,621,231,NA,NA,NA,NA,NA,NA,NA,"","3/18/2020 09:00","fc46fa069ba89048b9194e2d0adda947ed337b25","2020-03-19T20:00:00Z",NA,NA,891,660,660,33,0,0,108,13,121
"3955",20200319,"NJ",742,210,74,NA,NA,NA,NA,NA,NA,NA,"","3/19/2020 11:30","c380ce11850137ddbe4c9678181d13ef5c284f22","2020-03-19T20:00:00Z",9,NA,1026,952,952,34,4,0,20,315,335
"3956",20200319,"NM",35,2762,NA,NA,NA,NA,NA,NA,NA,NA,"","3/19/2020 00:00","38746f6db24a465ffbcaecf878daaebbf627a95c","2020-03-19T20:00:00Z",NA,NA,2797,2797,2797,35,0,0,436,7,443
"3957",20200319,"NV",95,1626,NA,NA,NA,NA,NA,NA,NA,NA,"","3/19/2020 00:00","940a5223ff18562d5087c9b079bd5263a945ac6c","2020-03-19T20:00:00Z",1,NA,1721,1721,1721,32,0,0,1458,40,1498
"3958",20200319,"NY",4152,18132,NA,617,NA,NA,NA,NA,NA,NA,"","3/19/2020 13:20","29d7c99fe26188158e7aedf4a8ac6ee81751950a","2020-03-19T20:00:00Z",12,NA,22284,22284,22284,36,0,0,5917,1770,7687
"3959",20200319,"OH",119,140,NA,NA,NA,NA,NA,NA,NA,NA,"","3/19/2020 14:00","4ef1783959cd8e6e933c7f1037cf9d86422f7c93","2020-03-19T20:00:00Z",NA,NA,259,259,259,39,0,0,0,31,31
"3960",20200319,"OK",44,466,250,NA,NA,NA,NA,NA,NA,NA,"","3/19/2020 13:00","f6b8c5b94c862aabdd58c01374e4b34d4c0558ea","2020-03-19T20:00:00Z",1,NA,760,510,510,40,1,0,88,15,103
"3961",20200319,"OR",88,1329,437,NA,NA,NA,NA,NA,NA,NA,"","3/19/2020 11:00","b12dbbfd1b26af180c4d8d20d82ddcf3b9196d6f","2020-03-19T20:00:00Z",3,NA,1854,1417,1417,41,0,0,211,13,224
"3962",20200319,"PA",185,1608,NA,NA,NA,NA,NA,NA,NA,NA,"","3/19/2020 12:00","dd0b0247d5b01b9fc86e2fee23f3b59e4151e9ea","2020-03-19T20:00:00Z",1,NA,1793,1793,1793,42,0,0,421,52,473
"3963",20200319,"PR",5,56,29,NA,NA,NA,NA,NA,NA,NA,"","3/19/2020 07:50","e3aab5a95e332c6338dc772a270b4299a61e16df","2020-03-19T20:00:00Z",NA,NA,90,61,61,72,0,0,25,0,25
"3964",20200319,"RI",44,654,334,NA,NA,NA,NA,NA,NA,NA,"","3/19/2020 00:00","314ad1ce693955314b586efc15e17ec692240d09","2020-03-19T20:00:00Z",NA,NA,1032,698,698,44,0,0,114,11,125
"3965",20200319,"SC",60,583,NA,NA,NA,NA,NA,NA,NA,NA,"","3/18/2020 16:00","6c5826f28b88dc0089d3b1724d818ef42f5f1d56","2020-03-19T20:00:00Z",1,NA,643,643,643,45,0,0,0,0,0
"3966",20200319,"SD",11,551,385,NA,NA,NA,NA,NA,NA,NA,"","3/19/2020 00:00","1aa7beb1461cab75d8939d2af19f5aef6c4c2b10","2020-03-19T20:00:00Z",1,NA,947,562,562,46,0,0,0,0,0
"3967",20200319,"TN",154,349,NA,NA,NA,NA,NA,NA,NA,NA,"","3/19/2020 15:00","666137fe55bb7b36c092fe5d064cd7bf4f4be3f3","2020-03-19T20:00:00Z",NA,NA,503,503,503,47,0,0,0,56,56
"3968",20200319,"TX",143,2212,NA,NA,NA,NA,NA,NA,NA,NA,"","3/19/2020 13:00","efc3d4edcff2f658e420c3ca4361a14b6436e9da","2020-03-19T20:00:00Z",3,NA,2355,2355,2355,48,1,0,388,60,448
"3969",20200319,"UT",78,1448,NA,NA,NA,NA,NA,NA,NA,NA,"","3/19/2020 00:00","0590983bdd79e95e85ee1dcf1801daed9dc9cf91","2020-03-19T20:00:00Z",0,NA,1526,1526,1526,49,0,0,1317,15,1332
"3970",20200319,"VA",94,1829,NA,NA,NA,NA,NA,NA,NA,NA,"","3/19/2020 12:00","852aef0d1a28cb7c03ad2a8ff65ee7426e3ef800","2020-03-19T20:00:00Z",2,NA,1923,1923,1923,51,1,0,628,17,645
"3971",20200319,"VI",3,NA,NA,NA,NA,NA,NA,NA,NA,NA,"","3/18/2020 07:30","57981690eb575d11b72ffa68c22a7af61c6f9100","2020-03-19T20:00:00Z",NA,NA,3,3,3,78,0,0,0,1,1
"3972",20200319,"VT",28,764,NA,NA,NA,NA,NA,NA,NA,NA,"","3/19/2020 00:00","bf258ae586ad76ae0b680550b503b4693310adad","2020-03-19T20:00:00Z",NA,NA,792,792,792,50,0,0,127,7,134
"3973",20200319,"WA",2461,36040,NA,NA,NA,NA,NA,NA,NA,NA,"","3/19/2020 00:00","761d22d26d040c5fbd14aa4a112fc60345e771a4","2020-03-19T20:00:00Z",92,NA,38501,38501,38501,53,10,0,4228,332,4560
"3974",20200319,"WI",155,2192,NA,NA,NA,NA,NA,NA,NA,NA,"","3/19/2020 16:00","edd16428aebe9e0d8f3fa130fb223fcb4292d55f","2020-03-19T20:00:00Z",NA,NA,2347,2347,2347,55,0,0,615,49,664
"3975",20200319,"WV",2,143,3,NA,NA,NA,NA,NA,NA,NA,"","3/18/2020 00:00","324fc40437533c65f4b384b2cf09b8a8aae86a6a","2020-03-19T20:00:00Z",0,NA,148,145,145,54,0,0,21,1,22
"3976",20200319,"WY",18,271,NA,NA,NA,NA,NA,NA,NA,NA,"","3/19/2020 16:45","d61009fe47ca518fa4f8f090833dd5a6361997ce","2020-03-19T20:00:00Z",NA,NA,289,289,289,56,0,0,93,3,96
"3977",20200318,"AK",6,406,NA,NA,NA,NA,NA,NA,NA,NA,"","3/17/2020 23:00","f5288de93bf587b4c28a1f99cabe8bd017cd5a75","2020-03-18T20:00:00Z",0,NA,412,412,412,2,0,0,72,3,75
"3978",20200318,"AL",46,28,NA,NA,NA,NA,NA,NA,NA,NA,"","3/18/2020 11:05","2e691f4e0fa081f2b42b43c7a65992124bbca213","2020-03-18T20:00:00Z",0,NA,74,74,74,1,0,0,0,10,10
"3979",20200318,"AR",33,236,50,NA,NA,NA,NA,NA,NA,NA,"","3/18/2020 00:00","9b224c31ffe5cac298e923ec9d2ce31f77c20a86","2020-03-18T20:00:00Z",NA,NA,319,269,269,5,0,0,39,11,50
"3980",20200318,"AS",NA,NA,NA,NA,NA,NA,NA,NA,NA,NA,"","3/14/2020 00:00","08a134397d3097e2ea01c9e772c4620942471890","2020-03-18T20:00:00Z",0,NA,0,0,0,60,0,0,0,0,0
"3981",20200318,"AZ",28,148,102,NA,NA,NA,NA,NA,NA,NA,"","3/18/2020 00:00","4769b941009d051f2dad7122a629b07ea1dcb64f","2020-03-18T20:00:00Z",0,NA,278,176,176,4,0,0,6,8,14
"3982",20200318,"CA",611,7981,NA,NA,NA,NA,NA,NA,NA,NA,"","3/17/2020 21:00","211831b7b898d77f8cbc9d7df4cead2248189ec9","2020-03-18T20:00:00Z",13,NA,8592,8592,8592,6,2,0,0,128,128
"3983",20200318,"CO",183,1617,NA,NA,NA,NA,NA,NA,NA,NA,"","3/18/2020 00:00","4f5463d12b577f6d1fee7289ae1625e986c9c0f1","2020-03-18T20:00:00Z",2,NA,1800,1800,1800,8,1,0,561,23,584
"3984",20200318,"CT",68,125,NA,NA,NA,NA,NA,NA,NA,NA,"","3/17/2020 16:30","2aa6772fe0031ffef41ecaa7a3b3290d37c05e7f","2020-03-18T20:00:00Z",NA,NA,193,193,193,9,0,0,0,27,27
"3985",20200318,"DC",31,138,1,NA,NA,NA,NA,NA,NA,NA,"","3/17/2020 19:00","10077e4202f778fbbabfd687efa3b51bf092df6b","2020-03-18T20:00:00Z",NA,NA,170,169,169,11,0,0,34,9,43
"3986",20200318,"DE",25,36,NA,NA,NA,NA,NA,NA,NA,NA,"","3/18/2020 11:30","601ee7dfc3d770165a2e0433ef27c262a174591a","2020-03-18T20:00:00Z",NA,NA,61,61,61,10,0,0,0,9,9
"3987",20200318,"FL",314,1225,954,NA,NA,NA,NA,NA,NA,NA,"","3/18/2020 11:00","5978bb0f0395bc23b910abb20a5c9f8dcfb0898c","2020-03-18T20:00:00Z",7,NA,2493,1539,1539,12,1,0,285,128,413
"3988",20200318,"GA",197,1311,NA,NA,NA,NA,NA,NA,NA,NA,"","3/18/2020 12:00","008b6e3c72c6952b8452de48087a19c122b0529a","2020-03-18T20:00:00Z",1,NA,1508,1508,1508,13,0,0,1311,51,1362
"3989",20200318,"GU",8,57,NA,NA,NA,NA,NA,NA,NA,NA,"","3/18/2020 05:45","24186343908e752838562a6fb9ea3d854cb7c379","2020-03-18T20:00:00Z",NA,NA,65,65,65,66,0,0,16,3,19
"3990",20200318,"HI",14,93,NA,NA,NA,NA,NA,NA,NA,NA,"","3/17/2020 20:00","fa6c55476437d80854b1d711768b059f949bdc57","2020-03-18T20:00:00Z",NA,NA,107,107,107,15,0,0,93,4,97
"3991",20200318,"IA",29,83,NA,NA,NA,NA,NA,NA,NA,NA,"","3/17/2020 19:58","0bcf732b73bd78f2d72d6277eae1c8385b32417b","2020-03-18T20:00:00Z",NA,NA,112,112,112,19,0,0,0,6,6
"3992",20200318,"ID",9,459,NA,NA,NA,NA,NA,NA,NA,NA,"","3/18/2020 10:30","bf5cf7d573e49c78c4574e517bdb06317b93f183","2020-03-18T20:00:00Z",NA,NA,468,468,468,16,0,0,113,2,115
"3993",20200318,"IL",288,1763,NA,NA,NA,NA,NA,NA,NA,NA,"","3/18/2020 00:00","626b59c9b2c91e737bce661ef6eb7e02f49cf49c","2020-03-18T20:00:00Z",1,NA,2051,2051,2051,17,0,0,423,129,552
"3994",20200318,"IN",39,154,NA,NA,NA,NA,NA,NA,NA,NA,"","3/17/2020 23:59","dcb07b411f3b58d29f73c5c1e3826498fe4ec668","2020-03-18T20:00:00Z",2,NA,193,193,193,18,0,0,25,9,34
"3995",20200318,"KS",16,417,NA,NA,NA,NA,NA,NA,NA,NA,"","3/17/2020 15:30","9fb82fa34211b0efee830b287502ffbb83f372c3","2020-03-18T20:00:00Z",1,NA,433,433,433,20,0,0,35,1,36
"3996",20200318,"KY",26,354,NA,NA,NA,NA,NA,NA,NA,NA,"","3/17/2020 16:00","ee41e45bbb89fadc7a5075777da6712195beed72","2020-03-18T20:00:00Z",1,NA,380,380,380,21,0,0,59,4,63
"3997",20200318,"LA",240,335,NA,NA,NA,NA,NA,NA,NA,NA,"","3/18/2020 00:00","40c81639e8e1837123d0743ff34978deb0721b14","2020-03-18T20:00:00Z",6,NA,575,575,575,22,2,0,49,103,152
"3998",20200318,"MA",156,2115,NA,NA,NA,NA,NA,NA,NA,NA,"","3/18/2020 16:00","b2221d52fc1f377763c3af6491e89fb6c0e5e5cf","2020-03-18T20:00:00Z",2,NA,2271,2271,2271,25,2,0,482,38,520
"3999",20200318,"MD",85,94,NA,NA,NA,NA,NA,NA,NA,NA,"","3/18/2020 10:00","440886fe99f7c2e165b09c670871079e4facea29","2020-03-18T20:00:00Z",NA,NA,179,179,179,24,0,0,0,28,28
"4000",20200318,"ME",43,1670,NA,NA,NA,NA,NA,NA,NA,NA,"","3/18/2020 12:00","f8ec8ac62077b73cbef0078cb2b8c099fe309708","2020-03-18T20:00:00Z",NA,NA,1713,1713,1713,23,0,0,367,11,378
"4001",20200318,"MI",2913,1215,NA,NA,NA,NA,NA,NA,NA,NA,"","3/18/2020 14:00","2125f01a1437fb16067e7b2d01f1e7c45410f836","2020-03-18T20:00:00Z",NA,NA,4128,4128,4128,26,0,0,589,520,1109
"4002",20200318,"MN",77,2685,NA,NA,NA,NA,NA,NA,NA,NA,"","3/18/2020 00:00","0a0c2c93cb3cfebf009e647227823fef48f3a20f","2020-03-18T20:00:00Z",NA,NA,2762,2762,2762,27,0,0,409,17,426
"4003",20200318,"MO",13,253,NA,NA,NA,NA,NA,NA,NA,NA,"","3/17/2020 19:15","3ff121940b6155f5627fb5b15067a58c10a7fb42","2020-03-18T20:00:00Z",0,NA,266,266,266,29,0,0,46,5,51
"4004",20200318,"MP",0,NA,NA,NA,NA,NA,NA,NA,NA,NA,"","3/18/2020 03:30","a0a820975afbc1927fd3067661e16278a1a760cd","2020-03-18T20:00:00Z",0,NA,0,0,0,69,0,0,0,0,0
"4005",20200318,"MS",34,479,NA,NA,NA,NA,NA,NA,NA,NA,"","3/18/2020 00:00","3e737e52391268ae91f783493b00eb018f3af943","2020-03-18T20:00:00Z",NA,NA,513,513,513,28,0,0,111,13,124
"4006",20200318,"MT",10,499,NA,NA,NA,NA,NA,NA,NA,NA,"","3/18/2020 10:15","80017e33fbf888f7478ed161bfcbf603cec7611f","2020-03-18T20:00:00Z",NA,NA,509,509,509,30,0,0,196,2,198
"4007",20200318,"NC",63,1787,NA,NA,NA,NA,NA,NA,NA,NA,"","3/18/2020 10:44","4b4543bbf95134b857abb09a4569ff3c3c65865a","2020-03-18T20:00:00Z",0,NA,1850,1850,1850,37,0,0,1313,23,1336
"4008",20200318,"ND",6,268,NA,NA,NA,NA,NA,NA,NA,NA,"","3/18/2020 00:00","7025327657c052706a93a8be09abf4bd8f054b96","2020-03-18T20:00:00Z",0,NA,274,274,274,38,0,0,48,3,51
"4009",20200318,"NE",24,206,NA,NA,NA,NA,NA,NA,NA,NA,"","3/18/2020 00:00","673f9c509f5c8fb758b90fd6743e1956e23dfcc6","2020-03-18T20:00:00Z",NA,NA,230,230,230,31,0,0,0,3,3
"4010",20200318,"NH",26,513,208,NA,NA,NA,NA,NA,NA,NA,"","3/17/2020 09:00","cfdc234086c0a98144465c9bd20e06ccbcae5537","2020-03-18T20:00:00Z",NA,NA,747,539,539,33,0,0,158,9,167
"4011",20200318,"NJ",427,190,21,NA,NA,NA,NA,NA,NA,NA,"","3/17/2020 13:00","96bc539aa14794d7e050e10cb4e9dd3aea3234de","2020-03-18T20:00:00Z",5,NA,638,617,617,34,2,0,27,160,187
"4012",20200318,"NM",28,2326,NA,NA,NA,NA,NA,NA,NA,NA,"","3/18/2020 00:00","5b7361efa32ad8e4b4045ec5cebf1f9bf19b4604","2020-03-18T20:00:00Z",NA,NA,2354,2354,2354,35,0,0,1077,5,1082
"4013",20200318,"NV",55,168,NA,NA,NA,NA,NA,NA,NA,NA,"","3/17/2020 15:00","43dc6b77ca80f18ca7bc213e7fa94c52f85b2575","2020-03-18T20:00:00Z",1,NA,223,223,223,32,0,0,0,0,0
"4014",20200318,"NY",2382,12215,NA,416,NA,NA,NA,NA,NA,NA,"","3/18/2020 15:05","2387f137d1dfbfcce5392a336b9d7133e1886e73","2020-03-18T20:00:00Z",12,NA,14597,14597,14597,36,5,0,6709,682,7391
"4015",20200318,"OH",88,140,NA,NA,NA,NA,NA,NA,NA,NA,"","3/18/2020 15:00","cb940db871c4d361ae2680a1e8adc6528f33affa","2020-03-18T20:00:00Z",NA,NA,228,228,228,39,0,0,0,21,21
"4016",20200318,"OK",29,378,110,NA,NA,NA,NA,NA,NA,NA,"","3/18/2020 08:00","35d97c6844aec71a0199c3913e39cfaff3d3b838","2020-03-18T20:00:00Z",NA,NA,517,407,407,40,0,0,131,12,143
"4017",20200318,"OR",75,1118,361,NA,NA,NA,NA,NA,NA,NA,"","3/17/2020 12:00","65fa0173a585e92fc43a84e6f155c86f516159b9","2020-03-18T20:00:00Z",3,NA,1554,1193,1193,41,3,0,429,28,457
"4018",20200318,"PA",133,1187,NA,NA,NA,NA,NA,NA,NA,NA,"","3/18/2020 12:00","28d824731900e4a1a9f93474a73bb703ffc8eefc","2020-03-18T20:00:00Z",1,NA,1320,1320,1320,42,1,0,308,37,345
"4019",20200318,"PR",5,31,21,NA,NA,NA,NA,NA,NA,NA,"","3/17/2020 22:00","33148f78b36e2cf967a7a7a9e052935be707309c","2020-03-18T20:00:00Z",NA,NA,57,36,36,72,0,0,18,0,18
"4020",20200318,"RI",33,540,334,NA,NA,NA,NA,NA,NA,NA,"","3/18/2020 00:00","ae961d1eaede756b322225132f5339ae22f0d13d","2020-03-18T20:00:00Z",NA,NA,907,573,573,44,0,0,137,10,147
"4021",20200318,"SC",60,583,NA,NA,NA,NA,NA,NA,NA,NA,"","3/18/2020 16:00","bc98c310c8975f735f9c831586ad15c7bbc78a79","2020-03-18T20:00:00Z",1,NA,643,643,643,45,0,0,272,27,299
"4022",20200318,"SD",11,551,350,NA,NA,NA,NA,NA,NA,NA,"","3/18/2020 00:00","1b687b6ee240ac192a75127b5e870af0c7c95edd","2020-03-18T20:00:00Z",1,NA,912,562,562,46,1,0,0,0,0
"4023",20200318,"TN",98,349,NA,NA,NA,NA,NA,NA,NA,NA,"","3/17/2020 15:00","008ada1826982989f4c340cf9f652aad0e0315bf","2020-03-18T20:00:00Z",NA,NA,447,447,447,47,0,0,19,25,44
"4024",20200318,"TX",83,1824,NA,NA,NA,NA,NA,NA,NA,NA,"","3/18/2020 13:00","06be026230031b92469361a920e8765decf48742","2020-03-18T20:00:00Z",2,NA,1907,1907,1907,48,1,0,620,19,639
"4025",20200318,"UT",63,131,NA,NA,NA,NA,NA,NA,NA,NA,"","3/18/2020 14:45","09ffdf02baa6c23772f30d33d655ed5ad352bb86","2020-03-18T20:00:00Z",0,NA,194,194,194,49,0,0,0,12,12
"4026",20200318,"VA",77,1201,NA,NA,NA,NA,NA,NA,NA,NA,"","3/18/2020 12:00","b3c472a405db176e338664447b989833c9fbf1a3","2020-03-18T20:00:00Z",1,NA,1278,1278,1278,51,0,0,240,10,250
"4027",20200318,"VI",2,NA,NA,NA,NA,NA,NA,NA,NA,NA,"","3/18/2020 00:00","3374cdd13d4fc753d192d2f9f979eb52e2afc1d8","2020-03-18T20:00:00Z",NA,NA,2,2,2,78,0,0,0,0,0
"4028",20200318,"VT",21,637,NA,NA,NA,NA,NA,NA,NA,NA,"","3/18/2020 00:00","546f4d2fba8e18bd46ce0f81921f4f614ac3384f","2020-03-18T20:00:00Z",NA,NA,658,658,658,50,0,0,56,2,58
"4029",20200318,"WA",2129,31812,NA,NA,NA,NA,NA,NA,NA,NA,"","3/18/2020 00:00","e2b2bb0f0dd68fba96775e39f4a0a776b1f19ca2","2020-03-18T20:00:00Z",82,NA,33941,33941,33941,53,4,0,4468,289,4757
"4030",20200318,"WI",106,1577,NA,NA,NA,NA,NA,NA,NA,NA,"","3/17/2020 15:00","e7782bc2f1b759f54c382a4b46c46862485a87e4","2020-03-18T20:00:00Z",NA,NA,1683,1683,1683,55,0,0,539,34,573
"4031",20200318,"WV",1,122,14,NA,NA,NA,NA,NA,NA,NA,"","3/17/2020 00:00","4a89d3b105098a13629c0aa49142c1be4d8e47e5","2020-03-18T20:00:00Z",0,NA,137,123,123,54,0,0,42,1,43
"4032",20200318,"WY",15,178,NA,NA,NA,NA,NA,NA,NA,NA,"","3/18/2020 00:00","9bee8b7c2d2a92cc804b9ef3e95bda376924eb41","2020-03-18T20:00:00Z",NA,NA,193,193,193,56,0,0,83,5,88
"4033",20200317,"AK",3,334,NA,NA,NA,NA,NA,NA,NA,NA,"","3/17/2020 00:01","969eccec44af129b62208bde1e56de80253261ba","2020-03-17T20:00:00Z",0,NA,337,337,337,2,0,0,191,2,193
"4034",20200317,"AL",36,28,NA,NA,NA,NA,NA,NA,NA,NA,"","3/17/2020 11:15","fca4639da0e8cb6c78cc6c89baae94c934e2f4ab","2020-03-17T20:00:00Z",0,NA,64,64,64,1,0,0,0,8,8
"4035",20200317,"AR",22,197,41,NA,NA,NA,NA,NA,NA,NA,"","3/17/2020 00:00","d8d3870fa54c757140c74195994b7dab042e22b3","2020-03-17T20:00:00Z",NA,NA,260,219,219,5,0,0,65,0,65
"4036",20200317,"AS",NA,NA,NA,NA,NA,NA,NA,NA,NA,NA,"","3/14/2020 00:00","b66ee4ef7ceb7b6f0af06e2e57be2edd57b64f93","2020-03-17T20:00:00Z",NA,NA,0,0,0,60,0,0,0,0,0
"4037",20200317,"AZ",20,142,66,NA,NA,NA,NA,NA,NA,NA,"","3/17/2020 00:00","e450f564d602ad1c699fdc910cba65f31090c2c3","2020-03-17T20:00:00Z",0,NA,228,162,162,4,0,0,17,2,19
"4038",20200317,"CA",483,7981,NA,NA,NA,NA,NA,NA,NA,NA,"","3/16/2020 21:00","2d6f4f31b87f25825ad93bc3781c3caea61ce7d2","2020-03-17T20:00:00Z",11,NA,8464,8464,8464,6,5,0,0,148,148
"4039",20200317,"CO",160,1056,NA,NA,NA,NA,NA,NA,NA,NA,"","3/16/2020 17:00","9c123867be8be537548e0fbf334a023e27c63d5c","2020-03-17T20:00:00Z",1,NA,1216,1216,1216,8,0,0,429,29,458
"4040",20200317,"CT",41,125,NA,NA,NA,NA,NA,NA,NA,NA,"","3/16/2020 17:00","43cf808fd648635204305f85378c60104c5c5e03","2020-03-17T20:00:00Z",NA,NA,166,166,166,9,0,0,0,15,15
"4041",20200317,"DC",22,104,0,NA,NA,NA,NA,NA,NA,NA,"","3/16/2020 19:00","4386682e1464479427c822ecc0b39256bce58590","2020-03-17T20:00:00Z",NA,NA,126,126,126,11,0,0,8,5,13
"4042",20200317,"DE",16,36,NA,NA,NA,NA,NA,NA,NA,NA,"","3/16/2020 11:40","5739fb0b3ceef7398782d6a867f65308b42bf70e","2020-03-17T20:00:00Z",NA,NA,52,52,52,10,0,0,0,8,8
"4043",20200317,"FL",186,940,872,NA,NA,NA,NA,NA,NA,NA,"","3/17/2020 11:00","b9d174bb1ebb924772113f90cbac1fe703d57491","2020-03-17T20:00:00Z",6,NA,1998,1126,1126,12,2,0,256,45,301
"4044",20200317,"GA",146,NA,NA,NA,NA,NA,NA,NA,NA,NA,"","3/17/2020 12:00","fc82728db34fbde1b3adc08844d65b67d2e348c3","2020-03-17T20:00:00Z",1,NA,146,146,146,13,0,0,0,25,25
"4045",20200317,"GU",5,41,NA,NA,NA,NA,NA,NA,NA,NA,"","3/17/2020 04:15","56bb1f995f1ee433f32c55384cd99d067a1dc176","2020-03-17T20:00:00Z",NA,NA,46,46,46,66,0,0,18,2,20
"4046",20200317,"HI",10,NA,NA,NA,NA,NA,NA,NA,NA,NA,"","3/16/2020 18:00","518a48de9997a29f1106e0a9946a4899d3b8aafe","2020-03-17T20:00:00Z",NA,NA,10,10,10,15,0,0,0,3,3
"4047",20200317,"IA",23,83,NA,NA,NA,NA,NA,NA,NA,NA,"","3/17/2020 00:00","ec27a78868d372c997468cddfadbb35e37c9f7e0","2020-03-17T20:00:00Z",NA,NA,106,106,106,19,0,0,0,1,1
"4048",20200317,"ID",7,346,NA,NA,NA,NA,NA,NA,NA,NA,"","3/17/2020 11:45","0625b1670dbc48e0397c91c2c8e089846535958d","2020-03-17T20:00:00Z",NA,NA,353,353,353,16,0,0,81,2,83
"4049",20200317,"IL",159,1340,NA,NA,NA,NA,NA,NA,NA,NA,"","3/16/2020 00:00","03d4c52477379b33b41ca7e7f9e778da2cb5e8af","2020-03-17T20:00:00Z",1,NA,1499,1499,1499,17,1,0,408,66,474
"4050",20200317,"IN",30,129,NA,NA,NA,NA,NA,NA,NA,NA,"","3/16/2020 23:59","a78ba9536e6d8e9bfcba5801108d501d144cc010","2020-03-17T20:00:00Z",2,NA,159,159,159,18,1,0,14,6,20
"4051",20200317,"KS",15,382,NA,NA,NA,NA,NA,NA,NA,NA,"","3/17/2020 13:00","250cfd121077cca9a3fd6a9170d83159857e1dd0","2020-03-17T20:00:00Z",1,NA,397,397,397,20,0,0,216,4,220
"4052",20200317,"KY",22,295,NA,NA,NA,NA,NA,NA,NA,NA,"","3/16/2020 16:00","4b87b0b796fc0ac207cbd4f00a3c2a479d5cba55","2020-03-17T20:00:00Z",1,NA,317,317,317,21,0,0,61,1,62
"4053",20200317,"LA",137,286,NA,NA,NA,NA,NA,NA,NA,NA,"","3/17/2020 10:30","d1bf1313ada51c87e5fe574741c75f0c06117e52","2020-03-17T20:00:00Z",4,NA,423,423,423,22,2,0,98,22,120
"4054",20200317,"MA",118,1633,NA,NA,NA,NA,NA,NA,NA,NA,"","3/16/2020 16:00","036062f6ee2569040579055ccffc66e3d068d75e","2020-03-17T20:00:00Z",NA,NA,1751,1751,1751,25,0,0,434,21,455
"4055",20200317,"MD",57,94,NA,NA,NA,NA,NA,NA,NA,NA,"","3/17/2020 10:00","c29d57f96fc92511bc3d828ceb05cdb6a1edf8a6","2020-03-17T20:00:00Z",NA,NA,151,151,151,24,0,0,0,20,20
"4056",20200317,"ME",32,1303,NA,NA,NA,NA,NA,NA,NA,NA,"","3/17/2020 12:00","943d325d5745c00a46310b9b2c6eb020163b1d65","2020-03-17T20:00:00Z",NA,NA,1335,1335,1335,23,0,0,539,15,554
"4057",20200317,"MI",2393,626,NA,NA,NA,NA,NA,NA,NA,NA,"","3/17/2020 14:00","668ae17b5b09827a0d17a301c5b3507f5e14f173","2020-03-17T20:00:00Z",NA,NA,3019,3019,3019,26,0,0,354,460,814
"4058",20200317,"MN",60,2276,NA,NA,NA,NA,NA,NA,NA,NA,"","3/17/2020 00:00","a131ab57908c35d3a81355c263a5bdfd9049e462","2020-03-17T20:00:00Z",NA,NA,2336,2336,2336,27,0,0,437,6,443
"4059",20200317,"MO",8,207,NA,NA,NA,NA,NA,NA,NA,NA,"","3/16/2020 20:00","f643f2dd61e40777be62a571714b369b53b8bc72","2020-03-17T20:00:00Z",0,NA,215,215,215,29,0,0,43,2,45
"4060",20200317,"MP",0,NA,NA,NA,NA,NA,NA,NA,NA,NA,"","3/17/2020 01:30","43bcdbfe588b2e86c034adcfd000d2e690ffda65","2020-03-17T20:00:00Z",NA,NA,0,0,0,69,0,0,0,0,0
"4061",20200317,"MS",21,368,NA,NA,NA,NA,NA,NA,NA,NA,"","3/17/2020 00:00","1a89dbd294697f854bbfca888e4f95f03675ba68","2020-03-17T20:00:00Z",NA,NA,389,389,389,28,0,0,91,9,100
"4062",20200317,"MT",8,303,NA,NA,NA,NA,NA,NA,NA,NA,"","3/16/2020 21:22","616f564552d2323bed901c587caad69779081814","2020-03-17T20:00:00Z",NA,NA,311,311,311,30,0,0,105,1,106
"4063",20200317,"NC",40,474,NA,NA,NA,NA,NA,NA,NA,NA,"","3/17/2020 08:51","4e236bc3725cc06617c1c4d02dad63e966d10077","2020-03-17T20:00:00Z",0,NA,514,514,514,37,0,0,178,7,185
"4064",20200317,"ND",3,220,0,NA,NA,NA,NA,NA,NA,NA,"","3/17/2020 00:00","5f2e29628a2a9c3a6db8da4e7ab787080b68bef1","2020-03-17T20:00:00Z",0,NA,223,223,223,38,0,0,97,2,99
"4065",20200317,"NE",21,206,NA,NA,NA,NA,NA,NA,NA,NA,"","3/17/2020 00:00","e12aad551e68a14f9b664597f8b297ffb598a3d9","2020-03-17T20:00:00Z",NA,NA,227,227,227,31,0,0,36,3,39
"4066",20200317,"NH",17,355,195,NA,NA,NA,NA,NA,NA,NA,"","3/16/2020 09:00","d1d7c529ea4ff7a2ae1ac2f2d3b5f198eb04c5b4","2020-03-17T20:00:00Z",NA,NA,567,372,372,33,0,0,84,4,88
"4067",20200317,"NJ",267,163,55,NA,NA,NA,NA,NA,NA,NA,"","3/17/2020 13:00","3db0bb5cc0fa91f4d05c1594468a2cb2e81ddf05","2020-03-17T20:00:00Z",3,NA,485,430,430,34,1,0,43,89,132
"4068",20200317,"NM",23,1249,NA,NA,NA,NA,NA,NA,NA,NA,"","3/17/2020 00:00","3412aeea5fc6c85fb331aa40e38847a1eb43702a","2020-03-17T20:00:00Z",NA,NA,1272,1272,1272,35,0,0,683,6,689
"4069",20200317,"NV",55,168,NA,NA,NA,NA,NA,NA,NA,NA,"","3/17/2020 15:00","31118e31f73e299ffda49872b137fb442e9c93dc","2020-03-17T20:00:00Z",1,NA,223,223,223,32,0,0,0,10,10
"4070",20200317,"NY",1700,5506,NA,325,NA,NA,NA,NA,NA,NA,"","3/16/2020 15:00","bce556dd77f7c7e28a75313ab899acc8e4958cfe","2020-03-17T20:00:00Z",7,NA,7206,7206,7206,36,0,0,963,750,1713
"4071",20200317,"OH",67,140,NA,NA,NA,NA,NA,NA,NA,NA,"","3/17/2020 15:00","bd02d04528bd3cc669a187fca7f109c868c80274","2020-03-17T20:00:00Z",NA,NA,207,207,207,39,0,0,0,17,17
"4072",20200317,"OK",17,247,82,NA,NA,NA,NA,NA,NA,NA,"","3/17/2020 09:15","6d391f8f8c87d1dccc4fcad70459c2bb54ae1508","2020-03-17T20:00:00Z",NA,NA,346,264,264,40,0,0,73,7,80
"4073",20200317,"OR",47,689,184,NA,NA,NA,NA,NA,NA,NA,"","3/16/2020 13:51","c80cc08eca48330e6dc9cfde5f230300b1489815","2020-03-17T20:00:00Z",NA,NA,920,736,736,41,0,0,110,8,118
"4074",20200317,"PA",96,879,NA,NA,NA,NA,NA,NA,NA,NA,"","3/17/2020 12:45","c155e67b04c8c437da6378913036a5e7bb1ef156","2020-03-17T20:00:00Z",NA,NA,975,975,975,42,0,0,209,20,229
"4075",20200317,"PR",5,13,4,NA,NA,NA,NA,NA,NA,NA,"","3/17/2020 15:41","0a3e64e373035129a3338ac3fc25b3d9a3998d7c","2020-03-17T20:00:00Z",NA,NA,22,18,18,72,0,0,4,0,4
"4076",20200317,"RI",23,403,149,NA,NA,NA,NA,NA,NA,NA,"","3/17/2020 00:00","4dbfdae7592aea06ad5cba132a55e0c411866cf7","2020-03-17T20:00:00Z",NA,NA,575,426,426,44,0,0,95,2,97
"4077",20200317,"SC",33,311,NA,NA,NA,NA,NA,NA,NA,NA,"","3/17/2020 12:02","277330a06998b32569ce824520f7a4fa463e3eb2","2020-03-17T20:00:00Z",1,NA,344,344,344,45,0,0,76,5,81
"4078",20200317,"SD",11,551,35,NA,NA,NA,NA,NA,NA,NA,"","3/17/2020 00:00","5200069484642cdc11376b70c8835fe0b486384e","2020-03-17T20:00:00Z",NA,NA,597,562,562,46,0,0,57,1,58
"4079",20200317,"TN",73,330,NA,NA,NA,NA,NA,NA,NA,NA,"","3/17/2020 15:00","1111771f430430e8c9445eb85aeff1b6c8832341","2020-03-17T20:00:00Z",NA,NA,403,403,403,47,0,0,60,21,81
"4080",20200317,"TX",64,1204,NA,NA,NA,NA,NA,NA,NA,NA,"","3/17/2020 13:00","338691daf793e8d98f338ea86b6a7dba69a84353","2020-03-17T20:00:00Z",1,NA,1268,1268,1268,48,1,0,1204,7,1211
"4081",20200317,"UT",51,131,NA,NA,NA,NA,NA,NA,NA,NA,"","3/17/2020 14:45","ea56f08d2a80026ca12df759d6e9ae01abadad5f","2020-03-17T20:00:00Z",0,NA,182,182,182,49,0,0,0,12,12
"4082",20200317,"VA",67,961,NA,NA,NA,NA,NA,NA,NA,NA,"","3/17/2020 12:00","98a3dbe62fe9599b9b84d7b10f0e8d08dcf65e5b","2020-03-17T20:00:00Z",1,NA,1028,1028,1028,51,0,0,523,16,539
"4083",20200317,"VI",2,NA,NA,NA,NA,NA,NA,NA,NA,NA,"","3/16/2020 00:01","62198a8d1c726adf21cfc064f7d73d4a44a91ebd","2020-03-17T20:00:00Z",NA,NA,2,2,2,78,0,0,0,1,1
"4084",20200317,"VT",19,581,NA,NA,NA,NA,NA,NA,NA,NA,"","3/17/2020 00:00","3ba4891315caf3c7bcd3f8a91b4a92c07f665fbf","2020-03-17T20:00:00Z",NA,NA,600,600,600,50,0,0,94,2,96
"4085",20200317,"WA",1840,27344,NA,NA,NA,NA,NA,NA,NA,NA,"","3/17/2020 00:00","9b907112004182c93b6079790a1e7b1777da7b0c","2020-03-17T20:00:00Z",78,NA,29184,29184,29184,53,9,0,4387,263,4650
"4086",20200317,"WI",72,1038,NA,NA,NA,NA,NA,NA,NA,NA,"","3/17/2020 15:00","2b15b9552b94a357b32c7ca46fa9e4a8f28fe0db","2020-03-17T20:00:00Z",NA,NA,1110,1110,1110,55,0,0,534,25,559
"4087",20200317,"WV",0,80,4,NA,NA,NA,NA,NA,NA,NA,"","3/16/2020 00:00","355ce563cb7d2cd5741ec078dfa0aad4d36b2408","2020-03-17T20:00:00Z",0,NA,84,80,80,54,0,0,0,0,0
"4088",20200317,"WY",10,95,NA,NA,NA,NA,NA,NA,NA,NA,"","3/17/2020 00:00","9372522628141a94a132082c3a435fc85d244ec7","2020-03-17T20:00:00Z",NA,NA,105,105,105,56,0,0,95,7,102
"4089",20200316,"AK",1,143,NA,NA,NA,NA,NA,NA,NA,NA,"","3/16/2020 15:06","7f5e80851d8d525a1ec21037882a96359ee72d43","2020-03-16T20:00:00Z",0,NA,144,144,144,2,0,0,0,0,0
"4090",20200316,"AL",28,28,40,NA,NA,NA,NA,NA,NA,NA,"","3/16/2020 15:08","485be3a893d8a3fb8fdab10be29b5d904718b60e","2020-03-16T20:00:00Z",0,NA,96,56,56,1,0,0,0,16,16
"4091",20200316,"AR",22,132,14,NA,NA,NA,NA,NA,NA,NA,"","3/16/2020 15:08","c884ad51a9008cf970aa5f194e62aa3daeeeae56","2020-03-16T20:00:00Z",NA,NA,168,154,154,5,0,0,29,6,35
"4092",20200316,"AS",NA,NA,NA,NA,NA,NA,NA,NA,NA,NA,"","3/16/2020 15:54","484a1fe533449c2f9995882667a8ae020ec71b5a","2020-03-16T20:00:00Z",NA,NA,0,0,0,60,NA,NA,NA,NA,NA
"4093",20200316,"AZ",18,125,63,NA,NA,NA,NA,NA,NA,NA,"","3/16/2020 16:16","a4784235c1230da64ed185bcb84f5d94163bdbcd","2020-03-16T20:00:00Z",0,NA,206,143,143,4,0,0,4,6,10
"4094",20200316,"CA",335,7981,NA,NA,NA,NA,NA,NA,NA,NA,"","3/16/2020 15:10","ae5d3b47618f50711284c580969ab00778145105","2020-03-16T20:00:00Z",6,NA,8316,8316,8316,6,1,0,7065,42,7107
"4095",20200316,"CO",131,627,NA,NA,NA,NA,NA,NA,NA,NA,"","3/16/2020 15:35","c5f22c1677f441bf1782e78185eb336d388f05db","2020-03-16T20:00:00Z",1,NA,758,758,758,8,0,0,0,0,0
"4096",20200316,"CT",26,125,NA,NA,NA,NA,NA,NA,NA,NA,"","3/16/2020 15:36","0d715aa5ddf2d86e83a62bf5240678dcde106aa3","2020-03-16T20:00:00Z",NA,NA,151,151,151,9,0,0,0,6,6
"4097",20200316,"DC",17,96,7,NA,NA,NA,NA,NA,NA,NA,"","3/16/2020 15:36","fbe622643386d43f29a7500682c1a92bda19c637","2020-03-16T20:00:00Z",NA,NA,120,113,113,11,0,0,17,1,18
"4098",20200316,"DE",8,36,32,NA,NA,NA,NA,NA,NA,NA,"","3/16/2020 15:37","276e164c9f2047b605669448bb59b9ffbbf11a95","2020-03-16T20:00:00Z",NA,NA,76,44,44,10,0,0,0,2,2
"4099",20200316,"FL",141,684,514,NA,NA,NA,NA,NA,NA,NA,"","3/16/2020 16:13","17a2eda14a5e3730dbc41b995156468d1b6e23f4","2020-03-16T20:00:00Z",4,NA,1339,825,825,12,0,0,6,25,31
"4100",20200316,"GA",121,NA,NA,NA,NA,NA,NA,NA,NA,NA,"","3/16/2020 15:19","169e6987762f55fb90407bf326ea0f8a8e49a62e","2020-03-16T20:00:00Z",1,NA,121,121,121,13,0,0,0,22,22
"4101",20200316,"GU",3,23,NA,NA,NA,NA,NA,NA,NA,NA,"","3/16/2020 15:58","3ec782f092118c336e93ee15a7a81f1a1a4dc5eb","2020-03-16T20:00:00Z",NA,NA,26,26,26,66,NA,NA,NA,NA,NA
"4102",20200316,"HI",7,NA,NA,NA,NA,NA,NA,NA,NA,NA,"","3/16/2020 15:39","4d6930e0edbfe5f100f20120ca576f2f4d0af623","2020-03-16T20:00:00Z",NA,NA,7,7,7,15,0,0,0,5,5
"4103",20200316,"IA",22,83,NA,NA,NA,NA,NA,NA,NA,NA,"","3/16/2020 15:41","03d18653db992e753bd2922559326f6fea523f37","2020-03-16T20:00:00Z",NA,NA,105,105,105,19,0,0,0,4,4
"4104",20200316,"ID",5,265,NA,NA,NA,NA,NA,NA,NA,NA,"","3/16/2020 15:42","07283b4e960f231d0efe160fe40f0f90024c6ae8","2020-03-16T20:00:00Z",NA,NA,270,270,270,16,0,0,91,0,91
"4105",20200316,"IL",93,932,NA,NA,NA,NA,NA,NA,NA,NA,"","3/16/2020 15:43","b4758bc7a7579774eaa3c37e1d2350f11f6acd05","2020-03-16T20:00:00Z",NA,NA,1025,1025,1025,17,0,0,483,29,512
"4106",20200316,"IN",24,115,NA,NA,NA,NA,NA,NA,NA,NA,"","3/16/2020 15:44","1e1a844f3cf17d6bfbd330cb0eb85aaf5f3ed36e","2020-03-16T20:00:00Z",1,NA,139,139,139,18,1,0,13,5,18
"4107",20200316,"KS",11,166,NA,NA,NA,NA,NA,NA,NA,NA,"","3/16/2020 16:17","74f6c1c9c68d5a612d3e4c99e8a789b33ae1bb73","2020-03-16T20:00:00Z",1,NA,177,177,177,20,0,0,31,3,34
"4108",20200316,"KY",21,234,NA,NA,NA,NA,NA,NA,NA,NA,"","3/16/2020 15:45","1cd79e34071533aa4ff33bc4378c501ab993fcd0","2020-03-16T20:00:00Z",1,NA,255,255,255,21,1,0,95,5,100
"4109",20200316,"LA",115,188,NA,NA,NA,NA,NA,NA,NA,NA,"","3/16/2020 15:50","703182c5bc9a328779c97950b7e9b50892f335b1","2020-03-16T20:00:00Z",2,NA,303,303,303,22,0,0,32,25,57
"4110",20200316,"MA",97,1199,NA,NA,NA,NA,NA,NA,NA,NA,"","3/16/2020 15:48","e59c715ab646368c3c7225bf0413256b1d4c7da6","2020-03-16T20:00:00Z",NA,NA,1296,1296,1296,25,0,0,615,33,648
"4111",20200316,"MD",37,94,NA,NA,NA,NA,NA,NA,NA,NA,"","3/16/2020 15:49","9461bade2c29da977203f6b3dfa9b3b13ca4c065","2020-03-16T20:00:00Z",NA,NA,131,131,131,24,0,0,0,6,6
"4112",20200316,"ME",17,764,NA,NA,NA,NA,NA,NA,NA,NA,"","3/16/2020 15:51","44e3f5dcb8e1a9bab9382df3055dfbff4dc731ba","2020-03-16T20:00:00Z",NA,NA,781,781,781,23,0,0,673,14,687
"4113",20200316,"MI",1933,272,30,NA,NA,NA,NA,NA,NA,NA,"","3/16/2020 15:52","0dad1f4a67e296edffd8e0d3d5e0a639d4e9252b","2020-03-16T20:00:00Z",NA,NA,2235,2205,2205,26,0,0,67,453,520
"4114",20200316,"MN",54,1839,NA,NA,NA,NA,NA,NA,NA,NA,"","3/16/2020 15:52","77b1a7a30f2a0bdc3a218552a0f04bf32d6704fb","2020-03-16T20:00:00Z",NA,NA,1893,1893,1893,27,0,0,452,19,471
"4115",20200316,"MO",6,164,NA,NA,NA,NA,NA,NA,NA,NA,"","3/16/2020 15:52","cab8246b62c2aed8057e64fce8d032dbea8f0cc5","2020-03-16T20:00:00Z",0,NA,170,170,170,29,0,0,42,1,43
"4116",20200316,"MP",0,NA,NA,NA,NA,NA,NA,NA,NA,NA,"","3/16/2020 15:55","c86069f43abe32f2db6c4c7e52e4d3fab1049414","2020-03-16T20:00:00Z",NA,NA,0,0,0,69,NA,NA,NA,NA,NA
"4117",20200316,"MS",12,277,NA,NA,NA,NA,NA,NA,NA,NA,"","3/16/2020 15:52","a1007f4d96a55949b6a839dd283a0e86369a5925","2020-03-16T20:00:00Z",NA,NA,289,289,289,28,0,0,193,2,195
"4118",20200316,"MT",7,198,NA,NA,NA,NA,NA,NA,NA,NA,"","3/16/2020 15:51","63200125a76c44bc3c52c6d7db0ec15d8e904c2d","2020-03-16T20:00:00Z",NA,NA,205,205,205,30,0,0,95,0,95
"4119",20200316,"NC",33,296,151,NA,NA,NA,NA,NA,NA,NA,"","3/16/2020 15:33","a157dd7bf48595b12550e838fcefdbc5c42f0795","2020-03-16T20:00:00Z",0,NA,480,329,329,37,0,0,69,1,70
"4120",20200316,"ND",1,123,0,NA,NA,NA,NA,NA,NA,NA,"","3/16/2020 15:45","cf57821f8ae2f1d2d7a40e95e49d684195c9e70a","2020-03-16T20:00:00Z",0,NA,124,124,124,38,0,0,28,0,28
"4121",20200316,"NE",18,170,NA,NA,NA,NA,NA,NA,NA,NA,"","3/16/2020 15:32","e70d8257bb02191aaca25b49f27d3f1e774fb6a1","2020-03-16T20:00:00Z",NA,NA,188,188,188,31,0,0,90,1,91
"4122",20200316,"NH",13,271,95,NA,NA,NA,NA,NA,NA,NA,"","3/16/2020 15:12","b607c5cdc5a0f3a3648223da2b7b16b273364962","2020-03-16T20:00:00Z",NA,NA,379,284,284,33,0,0,0,0,0
"4123",20200316,"NJ",178,120,20,NA,NA,NA,NA,NA,NA,NA,"","3/16/2020 15:08","9295881cace819e427ec73bc8e1fae3e9af977db","2020-03-16T20:00:00Z",2,NA,318,298,298,34,0,0,0,80,80
"4124",20200316,"NM",17,566,NA,NA,NA,NA,NA,NA,NA,NA,"","3/16/2020 15:11","7e7cb11db9b4ff0ac5207b76d2992d38411544d2","2020-03-16T20:00:00Z",NA,NA,583,583,583,35,0,0,84,4,88
"4125",20200316,"NV",45,168,NA,NA,NA,NA,NA,NA,NA,NA,"","3/16/2020 15:16","58fc94246e83f557bb7d8c9503358d84d32b74e3","2020-03-16T20:00:00Z",1,NA,213,213,213,32,1,0,0,24,24
"4126",20200316,"NY",950,4543,NA,NA,NA,NA,NA,NA,NA,NA,"","3/16/2020 16:22","ab1a87c7dce9b279751fd03e54e5353edc532d97","2020-03-16T20:00:00Z",7,NA,5493,5493,5493,36,4,0,0,221,221
"4127",20200316,"OH",50,140,361,NA,NA,NA,NA,NA,NA,NA,"","3/16/2020 15:36","6751e30a3733dca9f7ba6f05562d8dccd7faf473","2020-03-16T20:00:00Z",NA,NA,551,190,190,39,0,0,1,14,15
"4128",20200316,"OK",10,174,29,NA,NA,NA,NA,NA,NA,NA,"","3/16/2020 15:37","72417c0f8cb0f0958e78df0d3558f17a752efff3","2020-03-16T20:00:00Z",NA,NA,213,184,184,40,0,0,56,1,57
"4129",20200316,"OR",39,579,182,NA,NA,NA,NA,NA,NA,NA,"","3/16/2020 15:38","a2557da9fcd10bd90e223899b7fb1df1e36d8c9f","2020-03-16T20:00:00Z",NA,NA,800,618,618,41,0,0,159,3,162
"4130",20200316,"PA",76,670,NA,NA,NA,NA,NA,NA,NA,NA,"","3/16/2020 15:28","adca974944be7f5899add3808d0e22efb6f74311","2020-03-16T20:00:00Z",NA,NA,746,746,746,42,0,0,465,13,478
"4131",20200316,"PR",5,9,NA,NA,NA,NA,NA,NA,NA,NA,"","3/16/2020 15:44","e7cbfcada7d4875a4e281ff6ea29e69ceb073526","2020-03-16T20:00:00Z",NA,NA,14,14,14,72,NA,NA,NA,NA,NA
"4132",20200316,"RI",21,308,149,NA,NA,NA,NA,NA,NA,NA,"","3/16/2020 15:40","58febe33b753619ee5e390c5b5b461e0e595c5c0","2020-03-16T20:00:00Z",NA,NA,478,329,329,44,0,0,37,1,38
"4133",20200316,"SC",28,235,NA,NA,NA,NA,NA,NA,NA,NA,"","3/16/2020 15:24","88616d561d34d5547e5a9070f239850782a6a622","2020-03-16T20:00:00Z",1,NA,263,263,263,45,1,0,81,9,90
"4134",20200316,"SD",10,494,0,NA,NA,NA,NA,NA,NA,NA,"","3/16/2020 15:40","5f7393ba35b387012022b1f235608ff19e17e841","2020-03-16T20:00:00Z",NA,NA,504,504,504,46,0,0,167,1,168
"4135",20200316,"TN",52,270,NA,NA,NA,NA,NA,NA,NA,NA,"","3/16/2020 15:23","06994d5ec61db69883a12b8d25d2ce685b3adee2","2020-03-16T20:00:00Z",NA,NA,322,322,322,47,0,0,113,13,126
"4136",20200316,"TX",57,NA,NA,NA,NA,NA,NA,NA,NA,NA,"","3/16/2020 15:21","61002af3ab1ba6971324f11f1589de52dbd3af61","2020-03-16T20:00:00Z",NA,NA,57,57,57,48,0,0,0,1,1
"4137",20200316,"UT",39,131,NA,NA,NA,NA,NA,NA,NA,NA,"","3/16/2020 15:17","c19dec0c5e08d3708e31c13187aa06a891ffa5dc","2020-03-16T20:00:00Z",0,NA,170,170,170,49,0,0,0,11,11
"4138",20200316,"VA",51,438,NA,NA,NA,NA,NA,NA,NA,NA,"","3/16/2020 16:09","aadef9459485e4c94d8d6f9b6b4e8168aad4bbc6","2020-03-16T20:00:00Z",1,NA,489,489,489,51,0,0,75,6,81
"4139",20200316,"VI",1,NA,NA,NA,NA,NA,NA,NA,NA,NA,"","3/16/2020 15:58","e30eaf33e2013299724cffce9954fba88e92eb73","2020-03-16T20:00:00Z",NA,NA,1,1,1,78,NA,NA,NA,NA,NA
"4140",20200316,"VT",17,487,NA,NA,NA,NA,NA,NA,NA,NA,"","3/16/2020 00:00","272353e41b5ecb55f5bb13d869700c90e6055da8","2020-03-16T20:00:00Z",NA,NA,504,504,504,50,0,0,82,5,87
"4141",20200316,"WA",1577,22957,NA,NA,NA,NA,NA,NA,NA,NA,"","3/16/2020 00:00","a5a90c2d56ac7efb5152329c57c1377e37a26f62","2020-03-16T20:00:00Z",69,NA,24534,24534,24534,53,12,0,4604,300,4904
"4142",20200316,"WI",47,504,NA,NA,NA,NA,NA,NA,NA,NA,"","3/16/2020 15:06","fe73e4438c4059e2d9e83008914de78aa6db8938","2020-03-16T20:00:00Z",NA,NA,551,551,551,55,0,0,191,14,205
"4143",20200316,"WV",0,80,4,NA,NA,NA,NA,NA,NA,NA,"","3/16/2020 15:53","215982915f4685b6f44a29954345c4f93d4bf77f","2020-03-16T20:00:00Z",0,NA,84,80,80,54,0,0,42,0,42
"4144",20200316,"WY",3,NA,NA,NA,NA,NA,NA,NA,NA,NA,"","3/16/2020 15:04","949bb1287c1a8a88efc958ba0fe61c9251566353","2020-03-16T20:00:00Z",NA,NA,3,3,3,56,0,0,0,0,0
"4145",20200315,"AK",1,143,NA,NA,NA,NA,NA,NA,NA,NA,"","3/13/2020 16:30","c20c931369ad254d76fc60d098f567d137232cca","2020-03-15T20:00:00Z",0,NA,144,144,144,2,0,0,0,0,0
"4146",20200315,"AL",12,28,46,NA,NA,NA,NA,NA,NA,NA,"","3/15/2020 14:12","d9d73937ff45ac50bc195b2fe42a053e814a4361","2020-03-15T20:00:00Z",0,NA,86,40,40,1,0,0,6,6,12
"4147",20200315,"AR",16,103,30,NA,NA,NA,NA,NA,NA,NA,"","3/15/2020 00:00","4b816512fef0651e544428f0a6b5afc23491f657","2020-03-15T20:00:00Z",NA,NA,149,119,119,5,0,0,38,4,42
"4148",20200315,"AZ",12,121,50,NA,NA,NA,NA,NA,NA,NA,"","3/15/2020 12:01","595131f09151bc9e9719655f54066b18135603de","2020-03-15T20:00:00Z",0,NA,183,133,133,4,0,0,0,0,0
"4149",20200315,"CA",293,916,NA,NA,NA,NA,NA,NA,NA,NA,"","3/14/2020 11:00","8b928d2f4f1bc6083e96e18e46b22200a0242c7a","2020-03-15T20:00:00Z",5,NA,1209,1209,1209,6,0,0,0,41,41
"4150",20200315,"CO",131,627,NA,NA,NA,NA,NA,NA,NA,NA,"","3/15/2020 15:45","f1822a27261757836c31af3dd025f97e71c6e1fb","2020-03-15T20:00:00Z",1,NA,758,758,758,8,0,0,17,30,47
"4151",20200315,"CT",20,125,NA,NA,NA,NA,NA,NA,NA,NA,"","3/14/2020 17:00","6ce52508632f89d1273b18afc3bf6cece609055b","2020-03-15T20:00:00Z",NA,NA,145,145,145,9,0,0,0,9,9
"4152",20200315,"DC",16,79,20,NA,NA,NA,NA,NA,NA,NA,"","3/14/2020 19:30","8c0854e1d9badf48efebb307af7fcf69b9996660","2020-03-15T20:00:00Z",NA,NA,115,95,95,11,0,0,30,6,36
"4153",20200315,"DE",6,36,32,NA,NA,NA,NA,NA,NA,NA,"","3/14/2020 13:00","446a343af17fcad8a141ecb723789f2ad69f6869","2020-03-15T20:00:00Z",NA,NA,74,42,42,10,0,0,0,0,0
"4154",20200315,"FL",116,678,454,NA,NA,NA,NA,NA,NA,NA,"","3/15/2020 01:45","f0ceb4fa49b8f6d9dec020348735370a6ec3cc8e","2020-03-15T20:00:00Z",4,NA,1248,794,794,12,1,0,200,39,239
"4155",20200315,"GA",99,NA,NA,NA,NA,NA,NA,NA,NA,NA,"","3/15/2020 11:43","d0cc540aa98b638298a63382f6b30d7c21f4e0cd","2020-03-15T20:00:00Z",1,NA,99,99,99,13,0,0,0,33,33
"4156",20200315,"HI",2,NA,NA,NA,NA,NA,NA,NA,NA,NA,"","3/13/2020 00:00","9487a4721ac0df82f2b1f4a32f089d71356176fa","2020-03-15T20:00:00Z",NA,NA,2,2,2,15,0,0,0,0,0
"4157",20200315,"IA",18,83,NA,NA,NA,NA,NA,NA,NA,NA,"","3/14/2020 00:00","f886bf38ba386fc2c24785a4fffc564c4e6a41f1","2020-03-15T20:00:00Z",NA,NA,101,101,101,19,0,0,0,1,1
"4158",20200315,"ID",5,174,NA,NA,NA,NA,NA,NA,NA,NA,"","3/13/2020 22:45","31de0c1380b2c971b361d530d246f0365736df62","2020-03-15T20:00:00Z",NA,NA,179,179,179,16,0,0,0,3,3
"4159",20200315,"IL",64,449,195,NA,NA,NA,NA,NA,NA,NA,"","3/14/2020 00:00","05de4e2880cec1365fc004df213d4ba66e02e176","2020-03-15T20:00:00Z",NA,NA,708,513,513,17,0,0,133,18,151
"4160",20200315,"IN",19,102,NA,NA,NA,NA,NA,NA,NA,NA,"","3/15/2020 00:59","62de0620c7316770c3d740f360b247b78c051ac6","2020-03-15T20:00:00Z",0,NA,121,121,121,18,0,0,28,4,32
"4161",20200315,"KS",8,135,NA,NA,NA,NA,NA,NA,NA,NA,"","3/14/2020 13:00","45d60d5a98e8443e79b40a6b9ecc02344213c877","2020-03-15T20:00:00Z",1,NA,143,143,143,20,0,0,42,2,44
"4162",20200315,"KY",16,139,NA,NA,NA,NA,NA,NA,NA,NA,"","3/14/2020 16:00","f22fa93c3852689366013e061f1b244cedbddd5e","2020-03-15T20:00:00Z",NA,NA,155,155,155,21,0,0,0,2,2
"4163",20200315,"LA",90,156,NA,NA,NA,NA,NA,NA,NA,NA,"","3/15/2020 11:30","82ddd941105403c8d3f0fb44070276aab397a332","2020-03-15T20:00:00Z",2,NA,246,246,246,22,2,0,47,39,86
"4164",20200315,"MA",64,584,NA,NA,NA,NA,NA,NA,NA,NA,"","3/14/2020 16:00","9c32341783c45e6a3ae740a728e6acfaf830c678","2020-03-15T20:00:00Z",NA,NA,648,648,648,25,0,0,584,26,610
"4165",20200315,"MD",31,94,NA,NA,NA,NA,NA,NA,NA,NA,"","3/15/2020 00:00","f5f213de355e0b68b37e6d21b7a17ed246d38597","2020-03-15T20:00:00Z",NA,NA,125,125,125,24,0,0,0,5,5
"4166",20200315,"ME",3,91,17,NA,NA,NA,NA,NA,NA,NA,"","3/13/2020 14:00","3528400dd2a489e3d8cd3ee71de35a7534cd23f5","2020-03-15T20:00:00Z",NA,NA,111,94,94,23,0,0,0,0,0
"4167",20200315,"MI",1480,205,26,NA,NA,NA,NA,NA,NA,NA,"","3/14/2020 00:00","f92161865af389703c51ff087a345891f9947bfa","2020-03-15T20:00:00Z",NA,NA,1711,1685,1685,26,0,0,0,284,284
"4168",20200315,"MN",35,1387,NA,NA,NA,NA,NA,NA,NA,NA,"","3/15/2020 00:00","c43ce5a0cc00941a0a080d8487b0b1e38b47ca06","2020-03-15T20:00:00Z",NA,NA,1422,1422,1422,27,0,0,540,14,554
"4169",20200315,"MO",5,122,NA,NA,NA,NA,NA,NA,NA,NA,"","3/14/2020 22:00","649f36bebe6fc4eabd58091c3f20155ce34efc78","2020-03-15T20:00:00Z",0,NA,127,127,127,29,0,0,32,1,33
"4170",20200315,"MS",10,84,NA,NA,NA,NA,NA,NA,NA,NA,"","3/14/2020 00:00","3e325cbafd0dab5ea331227ed6063c059d236cfc","2020-03-15T20:00:00Z",NA,NA,94,94,94,28,0,0,0,4,4
"4171",20200315,"MT",7,103,57,NA,NA,NA,NA,NA,NA,NA,"","3/14/2020 17:52","ad0ec46de164a5a986bb0f525b748a8e77b9da95","2020-03-15T20:00:00Z",NA,NA,167,110,110,30,0,0,0,2,2
"4172",20200315,"NC",32,227,151,NA,NA,NA,NA,NA,NA,NA,"","3/15/2020 10:30","38eec98c6bc9fc90d3227b95cd73edcf08916754","2020-03-15T20:00:00Z",NA,NA,410,259,259,37,0,0,90,9,99
"4173",20200315,"ND",1,95,4,NA,NA,NA,NA,NA,NA,NA,"","3/15/2020 12:00","f4a07c6a84246894fb79cb8989eb1b2099fa42ee","2020-03-15T20:00:00Z",0,NA,100,96,96,38,0,0,41,0,41
"4174",20200315,"NE",17,80,33,NA,NA,NA,NA,NA,NA,NA,"","3/15/2020 00:00","55730094870a8f157622b83eef7f493687a97e83","2020-03-15T20:00:00Z",NA,NA,130,97,97,31,0,0,0,3,3
"4175",20200315,"NH",13,271,95,NA,NA,NA,NA,NA,NA,NA,"","3/15/2020 09:00","5913fa782980f78a0ea615671faee6f5c25d3582","2020-03-15T20:00:00Z",NA,NA,379,284,284,33,0,0,59,6,65
"4176",20200315,"NJ",98,120,34,NA,NA,NA,NA,NA,NA,NA,"","3/15/2020 13:00","eedf880a63e4b7538bff622c6552133c31a0184c","2020-03-15T20:00:00Z",2,NA,252,218,218,34,1,0,23,48,71
"4177",20200315,"NM",13,482,NA,NA,NA,NA,NA,NA,NA,NA,"","3/13/2020 13:00","6962f0e8deb868cc066753d320fca9edeac4db33","2020-03-15T20:00:00Z",NA,NA,495,495,495,35,0,0,245,3,248
"4178",20200315,"NV",21,168,164,NA,NA,NA,NA,NA,NA,NA,"","3/14/2020 17:05","d3e2a5269dff0a1c577a1607cc4566c3c866fe3c","2020-03-15T20:00:00Z",NA,NA,353,189,189,32,0,0,0,1,1
"4179",20200315,"NY",729,4543,NA,NA,NA,NA,NA,NA,NA,NA,"","3/15/2020 00:00","4cdad43cc1b747b51c208a5662fdfdccec506145","2020-03-15T20:00:00Z",3,NA,5272,5272,5272,36,3,0,1764,205,1969
"4180",20200315,"OH",36,139,350,NA,NA,NA,NA,NA,NA,NA,"","3/15/2020 14:00","06e652c8e48e3c9a2ded80086ee320edc0fb2644","2020-03-15T20:00:00Z",NA,NA,525,175,175,39,0,0,89,23,112
"4181",20200315,"OK",9,118,12,NA,NA,NA,NA,NA,NA,NA,"","3/15/2020 12:15","863bf4c25e823ff43c3439bc926f960e8eff063c","2020-03-15T20:00:00Z",NA,NA,139,127,127,40,0,0,82,5,87
"4182",20200315,"OR",36,420,225,NA,NA,NA,NA,NA,NA,NA,"","3/14/2020 14:00","d9557fbcef9290c94ea0b89de7be4c344b1af44d","2020-03-15T20:00:00Z",NA,NA,681,456,456,41,0,0,83,6,89
"4183",20200315,"PA",63,205,183,NA,NA,NA,NA,NA,NA,NA,"","3/15/2020 12:00","7d9c48485dd3e4b32a56eb813b40ff63411ab413","2020-03-15T20:00:00Z",NA,NA,451,268,268,42,0,0,0,16,16
"4184",20200315,"RI",20,271,57,NA,NA,NA,NA,NA,NA,NA,"","3/15/2020 00:00","1ff1418e6faf463694511474af93369cb66ac5be","2020-03-15T20:00:00Z",NA,NA,348,291,291,44,0,0,73,0,73
"4185",20200315,"SC",19,154,NA,NA,NA,NA,NA,NA,NA,NA,"","3/14/2020 16:18","1dffb0709890e322fb153086a569b7c335deb325","2020-03-15T20:00:00Z",NA,NA,173,173,173,45,0,0,44,6,50
"4186",20200315,"SD",9,327,6,NA,NA,NA,NA,NA,NA,NA,"","3/15/2020 00:00","504959038baa3b32622e9ac90c7f12a46fc159aa","2020-03-15T20:00:00Z",NA,NA,342,336,336,46,0,0,145,0,145
"4187",20200315,"TN",39,157,NA,NA,NA,NA,NA,NA,NA,NA,"","3/15/2020 15:00","989bea7cf35771bfb8ebd4d53b31cc9d9033eaba","2020-03-15T20:00:00Z",NA,NA,196,196,196,47,0,0,27,7,34
"4188",20200315,"TX",56,NA,NA,NA,NA,NA,NA,NA,NA,NA,"","3/15/2020 13:00","381cd8bb00ec3e8a158b395952ee4606b6d371c6","2020-03-15T20:00:00Z",NA,NA,56,56,56,48,0,0,0,5,5
"4189",20200315,"UT",28,131,NA,NA,NA,NA,NA,NA,NA,NA,"","3/15/2020 14:45","85bb03655cef6f1ce49428ce34873b4e998934e9","2020-03-15T20:00:00Z",0,NA,159,159,159,49,0,0,0,22,22
"4190",20200315,"VA",45,363,NA,NA,NA,NA,NA,NA,NA,NA,"","3/15/2020 14:15","9ce15add3931013ab1381e6e71971e0b9fb214c3","2020-03-15T20:00:00Z",1,NA,408,408,408,51,1,0,246,15,261
"4191",20200315,"VT",12,405,NA,NA,NA,NA,NA,NA,NA,NA,"","3/15/2020 00:00","b1947db483f66f3c7916f732d355140bc414260d","2020-03-15T20:00:00Z",NA,NA,417,417,417,50,0,0,73,4,77
"4192",20200315,"WA",1277,18353,NA,NA,NA,NA,NA,NA,NA,NA,"","3/15/2020 00:00","07a4ccf601cc4e6ab97e541aa7d24583a07d73dd","2020-03-15T20:00:00Z",57,NA,19630,19630,19630,53,6,0,1585,106,1691
"4193",20200315,"WI",33,313,NA,NA,NA,NA,NA,NA,NA,NA,"","3/14/2020 15:00","1a4cc79d1f3718034c45f4816680625c1577400e","2020-03-15T20:00:00Z",NA,NA,346,346,346,55,0,0,144,14,158
"4194",20200315,"WV",0,38,1,NA,NA,NA,NA,NA,NA,NA,"","3/14/2020 00:00","ee423a78e4e650e708b1ae2d3289c30893c30698","2020-03-15T20:00:00Z",0,NA,39,38,38,54,0,0,12,0,12
"4195",20200315,"WY",3,NA,NA,NA,NA,NA,NA,NA,NA,NA,"","3/14/2020 00:00","8988afd5c145737c0be4917a2d849a3c669b1730","2020-03-15T20:00:00Z",NA,NA,3,3,3,56,0,0,0,1,1
"4196",20200314,"AK",1,143,NA,NA,NA,NA,NA,NA,NA,NA,"","3/13/2020 16:30","4a434e53edb6d886ef8d8268fbaaf9da49839561","2020-03-14T20:00:00Z",0,NA,144,144,144,2,0,0,84,0,84
"4197",20200314,"AL",6,22,46,NA,NA,NA,NA,NA,NA,NA,"","3/13/2020 00:00","6497c1d495dd20a5be16c38b62241d17babda63f","2020-03-14T20:00:00Z",NA,NA,74,28,28,1,0,0,11,5,16
"4198",20200314,"AR",12,65,26,NA,NA,NA,NA,NA,NA,NA,"","3/13/2020 00:00","547c558ca1a9d4ea15f83e59961fb35ced7226ab","2020-03-14T20:00:00Z",NA,NA,103,77,77,5,0,0,35,3,38
"4199",20200314,"AZ",12,121,50,NA,NA,NA,NA,NA,NA,NA,"","3/14/2020 12:01","f2c71e85e75b07f6551abdfd282bdc8f10d91dc9","2020-03-14T20:00:00Z",0,NA,183,133,133,4,0,0,27,3,30
"4200",20200314,"CA",252,916,NA,NA,NA,NA,NA,NA,NA,NA,"","3/13/2020 11:00","43e484041b840b93569400bf282aaf3d7a94f240","2020-03-14T20:00:00Z",5,NA,1168,1168,1168,6,1,0,0,50,50
"4201",20200314,"CO",101,610,NA,NA,NA,NA,NA,NA,NA,NA,"","3/14/2020 14:00","4ae2ebbf9048505db9c6ba6d3610e6e0a4c9bb71","2020-03-14T20:00:00Z",1,NA,711,711,711,8,1,0,86,29,115
"4202",20200314,"CT",11,125,NA,NA,NA,NA,NA,NA,NA,NA,"","3/13/2020 16:00","cd01bf42884ef3393a18abc177edd023dfc05915","2020-03-14T20:00:00Z",NA,NA,136,136,136,9,0,0,26,5,31
"4203",20200314,"DC",10,49,10,NA,NA,NA,NA,NA,NA,NA,"","3/13/2020 19:00","73fbef306b78de24417de6423e961c4ba1b25262","2020-03-14T20:00:00Z",NA,NA,69,59,59,11,0,0,29,0,29
"4204",20200314,"DE",6,36,32,NA,NA,NA,NA,NA,NA,NA,"","3/14/2020 13:00","941ed8e020d4a20a5b2271c43e57b1ddca99bd94","2020-03-14T20:00:00Z",NA,NA,74,42,42,10,0,0,6,2,8
"4205",20200314,"FL",77,478,221,NA,NA,NA,NA,NA,NA,NA,"","3/14/2020 00:54","59fffa3d8eb2d7b80a6f5653b883e5eaac9c174c","2020-03-14T20:00:00Z",3,NA,776,555,555,12,1,0,0,27,27
"4206",20200314,"GA",66,NA,NA,NA,NA,NA,NA,NA,NA,NA,"","3/14/2020 12:00","eda8bef61f292923caf8c996ab79bee7811128b5","2020-03-14T20:00:00Z",1,NA,66,66,66,13,0,0,0,24,24
"4207",20200314,"HI",2,NA,NA,NA,NA,NA,NA,NA,NA,NA,"","3/13/2020 00:00","06dfa410d78fbfa6926bf412ecdd627586310c29","2020-03-14T20:00:00Z",NA,NA,2,2,2,15,0,0,0,0,0
"4208",20200314,"IA",17,83,NA,NA,NA,NA,NA,NA,NA,NA,"","3/13/2020 00:00","7b87bad0b00de2af71560f266a37b2abf9730f8a","2020-03-14T20:00:00Z",NA,NA,100,100,100,19,0,0,0,1,1
"4209",20200314,"ID",2,174,NA,NA,NA,NA,NA,NA,NA,NA,"","3/13/2020 22:45","4d0d75b4146c64fd3153a0849352acea695e3e85","2020-03-14T20:00:00Z",NA,NA,176,176,176,16,0,0,43,2,45
"4210",20200314,"IL",46,316,82,NA,NA,NA,NA,NA,NA,NA,"","3/13/2020 00:00","550c3cd965dc24abf5a5a45dedc90d4b8921466c","2020-03-14T20:00:00Z",NA,NA,444,362,362,17,0,0,22,14,36
"4211",20200314,"IN",15,74,NA,NA,NA,NA,NA,NA,NA,NA,"","3/13/2020 23:59","5684472420086c9ace77eb3b5fbfc6755a806fe3","2020-03-14T20:00:00Z",0,NA,89,89,89,18,0,0,13,3,16
"4212",20200314,"KS",6,93,NA,NA,NA,NA,NA,NA,NA,NA,"","3/13/2020 11:00","ff604ae7e106e952911a81abef80c475d6d75c6a","2020-03-14T20:00:00Z",1,NA,99,99,99,20,1,0,0,0,0
"4213",20200314,"KY",14,139,NA,NA,NA,NA,NA,NA,NA,NA,"","3/13/2020 17:00","5636b91436a2d4fdf621acf450d255d0d59e8aa7","2020-03-14T20:00:00Z",NA,NA,153,153,153,21,0,0,32,3,35
"4214",20200314,"LA",51,109,NA,NA,NA,NA,NA,NA,NA,NA,"","3/14/2020 12:15","7fd66e8f1a3a01f99888cfa4e92eb9459cc2a838","2020-03-14T20:00:00Z",NA,NA,160,160,160,22,0,0,72,15,87
"4215",20200314,"MA",38,NA,NA,NA,NA,NA,NA,NA,NA,NA,"","3/14/2020 16:00","28ef086def2b7f2cc37eee236cf297586e900cf7","2020-03-14T20:00:00Z",NA,NA,38,38,38,25,0,0,0,15,15
"4216",20200314,"MD",26,94,NA,NA,NA,NA,NA,NA,NA,NA,"","3/14/2020 00:00","c96a7f95f435a01e6e07ad1a1b17d2f3761ccfc9","2020-03-14T20:00:00Z",NA,NA,120,120,120,24,0,0,0,9,9
"4217",20200314,"ME",3,91,17,NA,NA,NA,NA,NA,NA,NA,"","3/13/2020 14:00","38ab39e4c87d4c96299af3b4aaf88f628155b6c3","2020-03-14T20:00:00Z",NA,NA,111,94,94,23,0,0,0,0,0
"4218",20200314,"MI",1196,205,26,NA,NA,NA,NA,NA,NA,NA,"","3/13/2020 00:00","f60dbbb8f4bfffe9fe9995fde413285a96cf941e","2020-03-14T20:00:00Z",NA,NA,1427,1401,1401,26,0,0,72,251,323
"4219",20200314,"MN",21,847,NA,NA,NA,NA,NA,NA,NA,NA,"","3/14/2020 00:00","86447649ea9f3d9639bf778d4b070303cf4cc559","2020-03-14T20:00:00Z",NA,NA,868,868,868,27,0,0,306,7,313
"4220",20200314,"MO",4,90,NA,NA,NA,NA,NA,NA,NA,NA,"","3/13/2020 18:10","9597743458ab5656b57e92b28ba7cd52bcb71de6","2020-03-14T20:00:00Z",0,NA,94,94,94,29,0,0,19,2,21
"4221",20200314,"MS",6,84,NA,NA,NA,NA,NA,NA,NA,NA,"","3/13/2020 18:35","b72bc6479db07cd84f7eeaa81de4c4e7b6fd4369","2020-03-14T20:00:00Z",NA,NA,90,90,90,28,0,0,43,2,45
"4222",20200314,"MT",5,103,NA,NA,NA,NA,NA,NA,NA,NA,"","3/13/2020 19:00","c5d48c025c06e3b5b6031a5455ece22f3120dd88","2020-03-14T20:00:00Z",NA,NA,108,108,108,30,0,0,48,4,52
"4223",20200314,"NC",23,137,NA,NA,NA,NA,NA,NA,NA,NA,"","3/14/2020 12:00","fd97b3510add467eb3cac0cc2233a02a97e9c90e","2020-03-14T20:00:00Z",NA,NA,160,160,160,37,0,0,51,8,59
"4224",20200314,"ND",1,54,14,NA,NA,NA,NA,NA,NA,NA,"","3/13/2020 13:00","a37a739a2b5c3041cdd3cbac1fc81362329d8c61","2020-03-14T20:00:00Z",0,NA,69,55,55,38,0,0,15,0,15
"4225",20200314,"NE",14,80,33,NA,NA,NA,NA,NA,NA,NA,"","3/13/2020 00:00","887486b687f374269ecaff0104eb056129205b11","2020-03-14T20:00:00Z",NA,NA,127,94,94,31,0,0,0,1,1
"4226",20200314,"NH",7,212,31,NA,NA,NA,NA,NA,NA,NA,"","3/14/2020 09:00","ccef356ffe646fc79b0fbe41406316614b4d2ea8","2020-03-14T20:00:00Z",NA,NA,250,219,219,33,0,0,118,1,119
"4227",20200314,"NJ",50,97,80,NA,NA,NA,NA,NA,NA,NA,"","3/13/2020 14:00","cc7c2831163e17f703f1ec4b283b7c99043df0ae","2020-03-14T20:00:00Z",1,NA,227,147,147,34,0,0,0,0,0
"4228",20200314,"NM",10,237,NA,NA,NA,NA,NA,NA,NA,NA,"","3/13/2020 00:00","aaa1bd70f1281b6f29c725e8b8d6c03d50920abc","2020-03-14T20:00:00Z",NA,NA,247,247,247,35,0,0,47,0,47
"4229",20200314,"NV",20,168,NA,NA,NA,NA,NA,NA,NA,NA,"","3/14/2020 12:33","f4d71f689c87936424834b35f0f84aedbbbe501a","2020-03-14T20:00:00Z",NA,NA,188,188,188,32,0,0,0,9,9
"4230",20200314,"NY",524,2779,NA,NA,NA,NA,NA,NA,NA,NA,"","3/14/2020 12:30","68e903dce4ea864cab367ecd3df55eb76d6904e8","2020-03-14T20:00:00Z",NA,NA,3303,3303,3303,36,0,0,0,103,103
"4231",20200314,"OH",13,50,159,NA,NA,NA,NA,NA,NA,NA,"","3/13/2020 14:00","fee7f8f7c7fd1ebc32413d707a9daea1428e1fd8","2020-03-14T20:00:00Z",NA,NA,222,63,63,39,0,0,0,0,0
"4232",20200314,"OK",4,36,37,NA,NA,NA,NA,NA,NA,NA,"","3/13/2020 22:30","b7461117f07cfdfdf2c4f23e7f2300222ea89daa","2020-03-14T20:00:00Z",NA,NA,77,40,40,40,0,0,0,1,1
"4233",20200314,"OR",30,337,157,NA,NA,NA,NA,NA,NA,NA,"","3/13/2020 13:00","d43a9fa4f540149064a0770f96a4c81fc08102d9","2020-03-14T20:00:00Z",NA,NA,524,367,367,41,0,0,0,0,0
"4234",20200314,"PA",47,205,150,NA,NA,NA,NA,NA,NA,NA,"","3/14/2020 14:00","4409f1122e37791e0ddf82f8a37a71209d983de7","2020-03-14T20:00:00Z",NA,NA,402,252,252,42,0,0,65,6,71
"4235",20200314,"RI",20,198,57,NA,NA,NA,NA,NA,NA,NA,"","3/14/2020 00:00","f5abfe401fdc25e192990a5948670e06c176846f","2020-03-14T20:00:00Z",NA,NA,275,218,218,44,0,0,56,6,62
"4236",20200314,"SC",13,110,NA,NA,NA,NA,NA,NA,NA,NA,"","3/13/2020 17:47","51c624ef009e9750e5b9f27502cd31f71d55c991","2020-03-14T20:00:00Z",NA,NA,123,123,123,45,0,0,35,1,36
"4237",20200314,"SD",9,182,3,NA,NA,NA,NA,NA,NA,NA,"","3/14/2020 00:00","1dc7460e261f0e6bca4ae360c9c2a197897b8489","2020-03-14T20:00:00Z",NA,NA,194,191,191,46,0,0,109,0,109
"4238",20200314,"TN",32,130,NA,NA,NA,NA,NA,NA,NA,NA,"","3/14/2020 15:00","d65605771f620de5ea2ca73561d85f1303627005","2020-03-14T20:00:00Z",NA,NA,162,162,162,47,0,0,14,6,20
"4239",20200314,"TX",51,NA,NA,NA,NA,NA,NA,NA,NA,NA,"","3/14/2020 13:00","56ce5a6747c196b918e014253fdfc34523799baf","2020-03-14T20:00:00Z",NA,NA,51,51,51,48,0,0,0,12,12
"4240",20200314,"UT",6,131,NA,NA,NA,NA,NA,NA,NA,NA,"","3/13/2020 15:00","e2794ec8641b2042ec3693c82f1e14b0ee51ecc4","2020-03-14T20:00:00Z",NA,NA,137,137,137,49,0,0,0,0,0
"4241",20200314,"VA",30,117,NA,NA,NA,NA,NA,NA,NA,NA,"","3/13/2020 11:00","2b1ce7eb3e4c1f77f8c042a83f7b5a8a2f84ba53","2020-03-14T20:00:00Z",NA,NA,147,147,147,51,0,0,0,0,0
"4242",20200314,"VT",8,332,NA,NA,NA,NA,NA,NA,NA,NA,"","3/14/2020 00:00","8a5b9a7a4c60beb9004e6cddf56d1b08f0ab5d04","2020-03-14T20:00:00Z",NA,NA,340,340,340,50,0,0,109,3,112
"4243",20200314,"WA",1171,16768,NA,NA,NA,NA,NA,NA,NA,NA,"","3/14/2020 00:00","65e3d199ae6fe5007139887fdea7a909df7b814c","2020-03-14T20:00:00Z",51,NA,17939,17939,17939,53,4,0,2183,156,2339
"4244",20200314,"WI",19,169,NA,NA,NA,NA,NA,NA,NA,NA,"","3/13/2020 15:00","0c9bd4aa681ebb12648df794661becd0b673f632","2020-03-14T20:00:00Z",NA,NA,188,188,188,55,0,0,0,0,0
"4245",20200314,"WV",0,26,5,NA,NA,NA,NA,NA,NA,NA,"","3/13/2020 00:00","0a318249afc7e06cce491d615a8bb7b6ef440158","2020-03-14T20:00:00Z",NA,NA,31,26,26,54,0,0,9,0,9
"4246",20200314,"WY",2,NA,NA,NA,NA,NA,NA,NA,NA,NA,"","3/13/2020 00:00","e18f797e0ee87a68795900fba4c17976df63e14e","2020-03-14T20:00:00Z",NA,NA,2,2,2,56,0,0,0,1,1
"4247",20200313,"AK",1,59,NA,NA,NA,NA,NA,NA,NA,NA,"","3/13/2020 00:00","2afab82ea203dff6b9469b231d446fe50372e9a8","2020-03-13T20:00:00Z",0,NA,60,60,60,2,0,0,13,1,14
"4248",20200313,"AL",1,11,NA,NA,NA,NA,NA,NA,NA,NA,"","3/13/2020 00:00","f89b69cb34b1791968f94ecb5f7d765cd724cdbd","2020-03-13T20:00:00Z",NA,NA,12,12,12,1,0,0,1,1,2
"4249",20200313,"AR",9,30,22,NA,NA,NA,NA,NA,NA,NA,"","3/13/2020 00:00","966f4d9427e320a3e7ac261a06c4fea6544dd639","2020-03-13T20:00:00Z",NA,NA,61,39,39,5,0,0,6,3,9
"4250",20200313,"AZ",9,94,40,NA,NA,NA,NA,NA,NA,NA,"","3/13/2020 12:01","9e584502bbeef4c5f4f22856ed366918c3f50895","2020-03-13T20:00:00Z",0,NA,143,103,103,4,0,0,12,0,12
"4251",20200313,"CA",202,916,NA,NA,NA,NA,NA,NA,NA,NA,"","3/12/2020 10:00","0f04f9a029c48f1cba8e590dfd846ab8257d24df","2020-03-13T20:00:00Z",4,NA,1118,1118,1118,6,0,0,0,0,0
"4252",20200313,"CO",72,524,NA,NA,NA,NA,NA,NA,NA,NA,"","3/13/2020 14:00","1a27ee06c1c2c7cbfcbf30f7f698a231641aa514","2020-03-13T20:00:00Z",NA,NA,596,596,596,8,0,0,226,27,253
"4253",20200313,"CT",6,99,NA,NA,NA,NA,NA,NA,NA,NA,"","3/12/2020 19:00","789a85d553e2adaf5b63a1fdac3f87f402263c49","2020-03-13T20:00:00Z",NA,NA,105,105,105,9,0,0,10,0,10
"4254",20200313,"DC",10,20,NA,NA,NA,NA,NA,NA,NA,NA,"","3/11/2020 17:45","0f5088d5a7bba30420c3896809bd89b8cc6ec51b","2020-03-13T20:00:00Z",NA,NA,30,30,30,11,0,0,0,0,0
"4255",20200313,"DE",4,30,10,NA,NA,NA,NA,NA,NA,NA,"","3/12/2020 16:00","ad27ff7cb26900ee22072920d8970891bdf8a8c3","2020-03-13T20:00:00Z",NA,NA,44,34,34,10,0,0,7,0,7
"4256",20200313,"FL",50,478,221,NA,NA,NA,NA,NA,NA,NA,"","3/13/2020 13:53","f8812247438a40baae8b507e7d9c8cf21951ac9d","2020-03-13T20:00:00Z",2,NA,749,528,528,12,0,0,177,18,195
"4257",20200313,"GA",42,NA,NA,NA,NA,NA,NA,NA,NA,NA,"","3/13/2020 00:00","82c655db35cf7f6efe85941f7dd4f1bb55a795f8","2020-03-13T20:00:00Z",1,NA,42,42,42,13,1,0,0,11,11
"4258",20200313,"HI",2,NA,NA,NA,NA,NA,NA,NA,NA,NA,"","3/12/2020 00:00","ae178c98a0757edec338a10e1daa3c3079f23ffa","2020-03-13T20:00:00Z",NA,NA,2,2,2,15,0,0,0,0,0
"4259",20200313,"IA",16,83,29,NA,NA,NA,NA,NA,NA,NA,"","3/12/2020 00:00","98de3d6d7b543352d3a2e40a666130adae013653","2020-03-13T20:00:00Z",NA,NA,128,99,99,19,0,0,16,2,18
"4260",20200313,"ID",0,131,NA,NA,NA,NA,NA,NA,NA,NA,"","3/13/2020 08:00","58f1291a9495c31c46085e8798c1b038bb6624a1","2020-03-13T20:00:00Z",NA,NA,131,131,131,16,0,0,38,0,38
"4261",20200313,"IL",32,294,92,NA,NA,NA,NA,NA,NA,NA,"","3/12/2020 00:00","c3ac5cc0263e15199af50e0d8f5b0b9b24f4f2c8","2020-03-13T20:00:00Z",NA,NA,418,326,326,17,0,0,28,7,35
"4262",20200313,"IN",12,61,NA,NA,NA,NA,NA,NA,NA,NA,"","3/12/2020 23:59","e31bc476fc8b69488be7337990c174221c569bfd","2020-03-13T20:00:00Z",NA,NA,73,73,73,18,0,0,9,0,9
"4263",20200313,"KS",6,93,NA,NA,NA,NA,NA,NA,NA,NA,"","3/13/2020 11:00","bfad5c0b1af8ed4acdcaff2260d78a4d1e11186a","2020-03-13T20:00:00Z",NA,NA,99,99,99,20,0,0,52,2,54
"4264",20200313,"KY",11,107,NA,NA,NA,NA,NA,NA,NA,NA,"","3/12/2020 20:30","1dc57c916342be1f53f98f537fce1b4c5ad6146b","2020-03-13T20:00:00Z",NA,NA,118,118,118,21,0,0,51,3,54
"4265",20200313,"LA",36,37,NA,NA,NA,NA,NA,NA,NA,NA,"","3/13/2020 16:00","bd8ea09e5b1b69d79883251b91431ca933901d08","2020-03-13T20:00:00Z",NA,NA,73,73,73,22,0,0,0,22,22
"4266",20200313,"MA",23,NA,NA,NA,NA,NA,NA,NA,NA,NA,"","3/13/2020 16:00","ed4f25676495f469b38cf2ffcf01042d49e88d78","2020-03-13T20:00:00Z",NA,NA,23,23,23,25,0,0,0,15,15
"4267",20200313,"MD",17,94,NA,NA,NA,NA,NA,NA,NA,NA,"","3/13/2020 00:00","fb5d33899365ea79e5d4ec83a30686a23e331188","2020-03-13T20:00:00Z",NA,NA,111,111,111,24,0,0,0,5,5
"4268",20200313,"ME",3,91,17,NA,NA,NA,NA,NA,NA,NA,"","3/13/2020 14:00","d674d7825063b2929c3fbcae00cadd690e5776b5","2020-03-13T20:00:00Z",NA,NA,111,94,94,23,0,0,26,2,28
"4269",20200313,"MI",945,133,26,NA,NA,NA,NA,NA,NA,NA,"","3/13/2020 00:00","9be4f0a3fa17e1c5dd3be9bf35211ba387613822","2020-03-13T20:00:00Z",NA,NA,1104,1078,1078,26,0,0,42,243,285
"4270",20200313,"MN",14,541,NA,NA,NA,NA,NA,NA,NA,NA,"","3/13/2020 00:00","b7413b9900e0a34c3070ad7b0d37f07ec428c2c7","2020-03-13T20:00:00Z",NA,NA,555,555,555,27,0,0,234,5,239
"4271",20200313,"MO",2,71,NA,NA,NA,NA,NA,NA,NA,NA,"","3/12/2020 17:45","a990b1f20ead0c53e536552a5b3b4e84fca96b96","2020-03-13T20:00:00Z",NA,NA,73,73,73,29,0,0,7,1,8
"4272",20200313,"MS",4,41,NA,NA,NA,NA,NA,NA,NA,NA,"","3/12/2020 00:00","9db4826bd6f035e45707de615cff223844bf7a2d","2020-03-13T20:00:00Z",NA,NA,45,45,45,28,0,0,0,3,3
"4273",20200313,"MT",1,55,NA,NA,NA,NA,NA,NA,NA,NA,"","3/12/2020 19:00","48a7e3825e2729f75577cdbfac00125504a6f7dd","2020-03-13T20:00:00Z",NA,NA,56,56,56,30,0,0,21,0,21
"4274",20200313,"NC",15,86,NA,NA,NA,NA,NA,NA,NA,NA,"","3/13/2020 08:45","61c5c0fdfb45101cb74df222e40d734d2e24b9ef","2020-03-13T20:00:00Z",NA,NA,101,101,101,37,0,0,26,3,29
"4275",20200313,"ND",1,39,12,NA,NA,NA,NA,NA,NA,NA,"","3/13/2020 13:00","973369596661807ff4d381a988464dec48e0c41b","2020-03-13T20:00:00Z",0,NA,52,40,40,38,0,0,27,0,27
"4276",20200313,"NE",13,80,33,NA,NA,NA,NA,NA,NA,NA,"","3/13/2020 00:00","eb0a4560d5bbc95f2d1203f3d511be4fb955bbb4","2020-03-13T20:00:00Z",NA,NA,126,93,93,31,0,0,0,3,3
"4277",20200313,"NH",6,94,21,NA,NA,NA,NA,NA,NA,NA,"","3/12/2020 09:00","f7c3d9fc2f313896dd166210690ea67135d79162","2020-03-13T20:00:00Z",NA,NA,121,100,100,33,0,0,0,0,0
"4278",20200313,"NJ",50,97,80,NA,NA,NA,NA,NA,NA,NA,"","3/13/2020 14:00","19cbcb9820b0b1a0969b0edba340e749c23ee218","2020-03-13T20:00:00Z",1,NA,227,147,147,34,0,0,23,20,43
"4279",20200313,"NM",10,190,NA,NA,NA,NA,NA,NA,NA,NA,"","3/12/2020 00:00","ca02e360148bc6f50ed84c67ee221733e9ec6667","2020-03-13T20:00:00Z",NA,NA,200,200,200,35,0,0,35,5,40
"4280",20200313,"NV",11,168,NA,NA,NA,NA,NA,NA,NA,NA,"","3/12/2020 21:27","d7bd641e3ecea4ec34d8c334c1edaf7677c371ff","2020-03-13T20:00:00Z",NA,NA,179,179,179,32,0,0,0,4,4
"4281",20200313,"NY",421,2779,NA,NA,NA,NA,NA,NA,NA,NA,"","3/12/2020 16:00","6195659df336b89493178ff9cee571d77f6a5c4e","2020-03-13T20:00:00Z",NA,NA,3200,3200,3200,36,0,0,2687,205,2892
"4282",20200313,"OH",13,50,159,NA,NA,NA,NA,NA,NA,NA,"","3/13/2020 15:00","7f90c607a28049422d4028a0f689a125f399117d","2020-03-13T20:00:00Z",NA,NA,222,63,63,39,0,0,20,8,28
"4283",20200313,"OK",3,36,37,NA,NA,NA,NA,NA,NA,NA,"","3/13/2020 00:00","9a060e3764d89f71d47c50557499e8f0b976d261","2020-03-13T20:00:00Z",NA,NA,76,39,39,40,0,0,0,0,0
"4284",20200313,"OR",30,337,157,NA,NA,NA,NA,NA,NA,NA,"","3/13/2020 13:00","e0c79de152c460d3e69826d011b86f11f90bf74c","2020-03-13T20:00:00Z",NA,NA,524,367,367,41,0,0,51,11,62
"4285",20200313,"PA",41,140,130,NA,NA,NA,NA,NA,NA,NA,"","3/13/2020 15:30","164c574777046319ae784f5911ab6c22d535871f","2020-03-13T20:00:00Z",NA,NA,311,181,181,42,0,0,24,19,43
"4286",20200313,"RI",14,142,29,NA,NA,NA,NA,NA,NA,NA,"","3/13/2020 00:00","aef575a87855c4fc4af81070ca6c1d846e845527","2020-03-13T20:00:00Z",NA,NA,185,156,156,44,0,0,48,9,57
"4287",20200313,"SC",12,75,NA,NA,NA,NA,NA,NA,NA,NA,"","3/12/2020 16:05","e22809753572f4790682f5831d2048e49bab023d","2020-03-13T20:00:00Z",NA,NA,87,87,87,45,0,0,27,2,29
"4288",20200313,"SD",9,73,11,NA,NA,NA,NA,NA,NA,NA,"","3/13/2020 00:00","3f8b17024f9562c669c43aadde59991b2521d715","2020-03-13T20:00:00Z",NA,NA,93,82,82,46,0,0,46,1,47
"4289",20200313,"TN",26,116,NA,NA,NA,NA,NA,NA,NA,NA,"","3/13/2020 00:00","d1d2be3542a03569c59f41ca92aaf10d85dee583","2020-03-13T20:00:00Z",NA,NA,142,142,142,47,0,0,37,8,45
"4290",20200313,"TX",39,NA,NA,NA,NA,NA,NA,NA,NA,NA,"","3/13/2020 00:00","8587599385560858292b40eea5f804187e8f8800","2020-03-13T20:00:00Z",NA,NA,39,39,39,48,0,0,0,16,16
"4291",20200313,"UT",6,131,NA,NA,NA,NA,NA,NA,NA,NA,"","3/13/2020 15:00","872f630d93aec61903fa14c2128cd906e6bdfd47","2020-03-13T20:00:00Z",NA,NA,137,137,137,49,0,0,0,2,2
"4292",20200313,"VA",30,117,NA,NA,NA,NA,NA,NA,NA,NA,"","3/13/2020 00:00","19c1bfca0440b480b37dd31af2e985471975bb6e","2020-03-13T20:00:00Z",NA,NA,147,147,147,51,0,0,0,13,13
"4293",20200313,"VT",5,223,NA,NA,NA,NA,NA,NA,NA,NA,"","3/13/2020 00:00","4ad175a7e0197d0af7f78f9a7272e8f55866dd90","2020-03-13T20:00:00Z",NA,NA,228,228,228,50,0,0,87,3,90
"4294",20200313,"WA",1015,14585,NA,NA,NA,NA,NA,NA,NA,NA,"","3/13/2020 00:00","fabc98dfab5b8c284ee41bd9a8664f21e1554968","2020-03-13T20:00:00Z",47,NA,15600,15600,15600,53,3,0,4022,216,4238
"4295",20200313,"WI",19,169,NA,NA,NA,NA,NA,NA,NA,NA,"","3/13/2020 15:00","05f9c1058ec06fc503b7c947a3f6c87961782fd2","2020-03-13T20:00:00Z",NA,NA,188,188,188,55,0,0,85,11,96
"4296",20200313,"WV",0,17,4,NA,NA,NA,NA,NA,NA,NA,"","3/13/2020 00:00","6eef3d265bdb4db30889561a9e57571417fc19db","2020-03-13T20:00:00Z",NA,NA,21,17,17,54,0,0,10,0,10
"4297",20200313,"WY",1,NA,NA,NA,NA,NA,NA,NA,NA,NA,"","3/12/2020 00:00","19b27aea823dbbcbb29e8c146ad22a8736258e75","2020-03-13T20:00:00Z",NA,NA,1,1,1,56,0,0,0,0,0
"4298",20200312,"AK",0,46,14,NA,NA,NA,NA,NA,NA,NA,"","3/11/2020 16:30","0fd333d14b98cc22b225d70a0b314964664b10f9","2020-03-12T20:00:00Z",0,NA,60,46,46,2,0,0,0,0,0
"4299",20200312,"AL",0,10,NA,NA,NA,NA,NA,NA,NA,NA,"","3/9/2020 00:00","ba2f587dec4e40c649ac2dcd9c8a5782aedafb22","2020-03-12T20:00:00Z",NA,NA,10,10,10,1,0,0,0,0,0
"4300",20200312,"AR",6,24,20,NA,NA,NA,NA,NA,NA,NA,"","3/11/2020 00:00","a3db07948d6a59eb4bbc7d472972d06137651dd7","2020-03-12T20:00:00Z",NA,NA,50,30,30,5,0,0,12,6,18
"4301",20200312,"AZ",9,82,24,NA,NA,NA,NA,NA,NA,NA,"","3/12/2020 12:00","a52933ab64ce64eb69d5ff3f6a929c70bb525209","2020-03-12T20:00:00Z",NA,NA,115,91,91,4,0,0,23,0,23
"4302",20200312,"CA",202,916,NA,NA,NA,NA,NA,NA,NA,NA,"","3/12/2020 10:00","a7584b6c9ab89772a3e6a1287e104b91ced4fb4f","2020-03-12T20:00:00Z",4,NA,1118,1118,1118,6,4,0,0,45,45
"4303",20200312,"CO",45,298,NA,NA,NA,NA,NA,NA,NA,NA,"","3/12/2020 17:00","b572b585f84c31d999a5ac9aa5c66c73eed17601","2020-03-12T20:00:00Z",NA,NA,343,343,343,8,0,0,47,17,64
"4304",20200312,"CT",6,89,NA,NA,NA,NA,NA,NA,NA,NA,"","3/12/2020 15:00","eab19925410d64f4b03c0873a822ec7864c54236","2020-03-12T20:00:00Z",NA,NA,95,95,95,9,0,0,18,3,21
"4305",20200312,"DC",10,20,NA,NA,NA,NA,NA,NA,NA,NA,"","3/11/2020 17:45","1c1e964aab6518e06fc99d113a5ef4ecfe82b729","2020-03-12T20:00:00Z",NA,NA,30,30,30,11,0,0,0,5,5
"4306",20200312,"DE",4,23,14,NA,NA,NA,NA,NA,NA,NA,"","3/12/2020 11:30","dc3b37acb5af4bfc5f9c795fbbfbd52bca90227e","2020-03-12T20:00:00Z",NA,NA,41,27,27,10,0,0,6,3,9
"4307",20200312,"FL",32,301,147,NA,NA,NA,NA,NA,NA,NA,"","3/12/2020 09:07","7c7b437d10aff1f7f2ac23ebce44719ea7cc8d5c","2020-03-12T20:00:00Z",2,NA,480,333,333,12,0,0,0,4,4
"4308",20200312,"GA",31,NA,NA,NA,NA,NA,NA,NA,NA,NA,"","3/11/2020 20:00","713e2aa927927b19f521af9d6936987a5e3ff36c","2020-03-12T20:00:00Z",NA,NA,31,31,31,13,0,0,0,9,9
"4309",20200312,"HI",2,NA,NA,NA,NA,NA,NA,NA,NA,NA,"","3/11/2020 00:00","9c7ad6b68824d1c11d37d43737c0b197bfd2c7da","2020-03-12T20:00:00Z",NA,NA,2,2,2,15,0,0,0,0,0
"4310",20200312,"IA",14,67,24,NA,NA,NA,NA,NA,NA,NA,"","3/11/2020 00:00","6e88ebfbae1d83d02a20952caee70ba3b5c88da8","2020-03-12T20:00:00Z",NA,NA,105,81,81,19,0,0,21,1,22
"4311",20200312,"ID",0,93,NA,NA,NA,NA,NA,NA,NA,NA,"","3/12/2020 09:45","1e2caa33f353cb3c8807b74a42933558dd747e46","2020-03-12T20:00:00Z",NA,NA,93,93,93,16,0,0,26,0,26
"4312",20200312,"IL",25,266,76,NA,NA,NA,NA,NA,NA,NA,"","3/11/2020 00:00","c52114081e35f219a44190dee8b1f5928155eea1","2020-03-12T20:00:00Z",NA,NA,367,291,291,17,0,0,22,6,28
"4313",20200312,"IN",12,52,NA,NA,NA,NA,NA,NA,NA,NA,"","3/11/2020 11:59","211b2a7d3bb0537c7e8866bf01e29995265f641f","2020-03-12T20:00:00Z",NA,NA,64,64,64,18,0,0,19,2,21
"4314",20200312,"KS",4,41,NA,NA,NA,NA,NA,NA,NA,NA,"","3/12/2020 00:00","09957a196d5e23871891efcf4069e82eff7840b5","2020-03-12T20:00:00Z",NA,NA,45,45,45,20,0,0,0,3,3
"4315",20200312,"KY",8,56,NA,NA,NA,NA,NA,NA,NA,NA,"","3/11/2020 17:10","37a5b06582e47131204394504c26ef72ac5e8197","2020-03-12T20:00:00Z",NA,NA,64,64,64,21,0,0,10,0,10
"4316",20200312,"LA",14,37,NA,NA,NA,NA,NA,NA,NA,NA,"","3/12/2020 10:30","80c783b5f63eea4ae1829493ab5f508ba1118ab6","2020-03-12T20:00:00Z",NA,NA,51,51,51,22,0,0,0,8,8
"4317",20200312,"MA",8,NA,NA,NA,NA,NA,NA,NA,NA,NA,"","3/11/2020 00:00","33c8f9ad36eda440d682d570e89204700e4901f3","2020-03-12T20:00:00Z",NA,NA,8,8,8,25,NA,NA,NA,NA,NA
"4318",20200312,"MD",12,94,NA,NA,NA,NA,NA,NA,NA,NA,"","3/12/2020 00:00","b045cc538c9ada3a8e9950e7d98a70e218f4c471","2020-03-12T20:00:00Z",NA,NA,106,106,106,24,0,0,0,3,3
"4319",20200312,"ME",1,65,20,NA,NA,NA,NA,NA,NA,NA,"","3/12/2020 13:00","21ab9f643b305cc25bf778d45628085162802271","2020-03-12T20:00:00Z",NA,NA,86,66,66,23,0,0,23,1,24
"4320",20200312,"MI",702,91,27,NA,NA,NA,NA,NA,NA,NA,"","3/11/2020 19:00","8f4bfb63e53492b2662349b3c6824b383a96d996","2020-03-12T20:00:00Z",NA,NA,820,793,793,26,0,0,34,205,239
"4321",20200312,"MN",9,307,NA,NA,NA,NA,NA,NA,NA,NA,"","3/12/2020 00:00","6340d601b63b98be39ca1524899751b56e60ce90","2020-03-12T20:00:00Z",NA,NA,316,316,316,27,0,0,90,4,94
"4322",20200312,"MO",1,64,NA,NA,NA,NA,NA,NA,NA,NA,"","3/11/2020 00:00","e1f7594b0769ea4b3628cffdf5d3745a5c65140f","2020-03-12T20:00:00Z",NA,NA,65,65,65,29,0,0,64,0,64
"4323",20200312,"MS",1,41,NA,NA,NA,NA,NA,NA,NA,NA,"","3/11/2020 13:20","6508f7c8a3a2f6abce192472eaeff77a4822926e","2020-03-12T20:00:00Z",NA,NA,42,42,42,28,0,0,21,1,22
"4324",20200312,"MT",1,34,NA,NA,NA,NA,NA,NA,NA,NA,"","3/11/2020 19:00","6cbfe3f5546429d7e9088a36eff9bdc621c28f10","2020-03-12T20:00:00Z",NA,NA,35,35,35,30,0,0,13,1,14
"4325",20200312,"NC",12,60,NA,NA,NA,NA,NA,NA,NA,NA,"","3/12/2020 08:00","671f3237bbfd84baf2ccbc2a8589c19fd1efe294","2020-03-12T20:00:00Z",NA,NA,72,72,72,37,0,0,60,5,65
"4326",20200312,"ND",1,12,14,NA,NA,NA,NA,NA,NA,NA,"","3/11/2020 00:00","01b362bcaca6ad23c3f26ecdcb9c77f1ae9ccc5e","2020-03-12T20:00:00Z",NA,NA,27,13,13,38,0,0,5,1,6
"4327",20200312,"NE",10,80,33,NA,NA,NA,NA,NA,NA,NA,"","3/12/2020 00:00","8b5177c84b7cce5a61d81a92d96664285e9489ba","2020-03-12T20:00:00Z",NA,NA,123,90,90,31,0,0,33,5,38
"4328",20200312,"NH",6,94,21,NA,NA,NA,NA,NA,NA,NA,"","3/12/2020 09:00","ae0a0e6d78d8d3ef4d5865293f8847bc134fb16b","2020-03-12T20:00:00Z",NA,NA,121,100,100,33,0,0,56,2,58
"4329",20200312,"NJ",30,74,20,NA,NA,NA,NA,NA,NA,NA,"","3/11/2020 12:00","8c4530716ebc5798fffdc1f7f0f63447ca0203f2","2020-03-12T20:00:00Z",1,NA,124,104,104,34,0,0,17,6,23
"4330",20200312,"NM",5,155,NA,NA,NA,NA,NA,NA,NA,NA,"","3/12/2020 00:00","b5ddfad0b4a41e2fba97e9469b6accce484c2694","2020-03-12T20:00:00Z",NA,NA,160,160,160,35,0,0,68,2,70
"4331",20200312,"NV",7,168,NA,NA,NA,NA,NA,NA,NA,NA,"","3/10/2020 16:00","f3227d4b0faa877530e4c915361ef45b83bf5386","2020-03-12T20:00:00Z",NA,NA,175,175,175,32,0,0,0,2,2
"4332",20200312,"NY",216,92,NA,NA,NA,NA,NA,NA,NA,NA,"","3/11/2020 16:00","43210af34819b2a2cd8d6d43d9bed655003da5a6","2020-03-12T20:00:00Z",NA,NA,308,308,308,36,0,0,0,0,0
"4333",20200312,"OH",5,30,52,NA,NA,NA,NA,NA,NA,NA,"","3/12/2020 14:00","efa2e0774233126b4df6cd4a1b0a8503009a8770","2020-03-12T20:00:00Z",NA,NA,87,35,35,39,0,0,9,1,10
"4334",20200312,"OK",3,36,4,NA,NA,NA,NA,NA,NA,NA,"","3/11/2020 00:00","840897d7f37abb8518a4e9211e0e29f6ae79e2c9","2020-03-12T20:00:00Z",NA,NA,43,39,39,40,0,0,21,1,22
"4335",20200312,"OR",19,286,62,NA,NA,NA,NA,NA,NA,NA,"","3/11/2020 13:00","fd5256f94b04b19c55b5d8a2b8420796a23c8e40","2020-03-12T20:00:00Z",NA,NA,367,305,305,41,0,0,0,0,0
"4336",20200312,"PA",22,116,81,NA,NA,NA,NA,NA,NA,NA,"","3/12/2020 13:45","bc7d0a0a3f224b9e4a683d273a282365a3b98209","2020-03-12T20:00:00Z",NA,NA,219,138,138,42,0,0,28,6,34
"4337",20200312,"RI",5,94,8,NA,NA,NA,NA,NA,NA,NA,"","3/12/2020 00:00","b6430bb37b583bc85b9f05acf9d8f1120e0c9cde","2020-03-12T20:00:00Z",NA,NA,107,99,99,44,0,0,0,0,0
"4338",20200312,"SC",10,48,NA,NA,NA,NA,NA,NA,NA,NA,"","3/11/2020 17:12","e9c1435a2731d83fa6da3b6dca689f068428b935","2020-03-12T20:00:00Z",NA,NA,58,58,58,45,0,0,16,1,17
"4339",20200312,"SD",8,27,11,NA,NA,NA,NA,NA,NA,NA,"","3/11/2020 00:00","fa2a4555a132947a8bd5ea7b142c1dc4054bde10","2020-03-12T20:00:00Z",NA,NA,46,35,35,46,0,0,14,3,17
"4340",20200312,"TN",18,79,NA,NA,NA,NA,NA,NA,NA,NA,"","3/12/2020 15:00","20ebad0679dd87764eca29944743555507aacb87","2020-03-12T20:00:00Z",NA,NA,97,97,97,47,0,0,29,11,40
"4341",20200312,"TX",23,NA,NA,NA,NA,NA,NA,NA,NA,NA,"","3/12/2020 11:00","d38ecd87207406a13bc1f4b675e5c78885081682","2020-03-12T20:00:00Z",NA,NA,23,23,23,48,0,0,0,2,2
"4342",20200312,"UT",4,131,NA,NA,NA,NA,NA,NA,NA,NA,"","3/11/2020 00:00","b2090484e710343cf6bed10c51a6046641a77bcb","2020-03-12T20:00:00Z",NA,NA,135,135,135,49,0,0,131,2,133
"4343",20200312,"VA",17,117,NA,NA,NA,NA,NA,NA,NA,NA,"","3/12/2020 12:00","603bdab35e9c1b729faaec84139ead405bac3557","2020-03-12T20:00:00Z",NA,NA,134,134,134,51,0,0,57,8,65
"4344",20200312,"VT",2,136,NA,NA,NA,NA,NA,NA,NA,NA,"","3/12/2020 00:00","c7bddef2d0e7f856aa4cdce8eb592991884a38c1","2020-03-12T20:00:00Z",NA,NA,138,138,138,50,0,0,45,0,45
"4345",20200312,"WA",799,10563,NA,NA,NA,NA,NA,NA,NA,NA,"","3/12/2020 00:00","26637457770343ac30569d53448276021d3273e2","2020-03-12T20:00:00Z",44,NA,11362,11362,11362,53,4,0,3587,178,3765
"4346",20200312,"WI",8,84,NA,NA,NA,NA,NA,NA,NA,NA,"","3/12/2020 15:30","b2a3aab9e1678d1e0824c903d8f87558db50fd03","2020-03-12T20:00:00Z",NA,NA,92,92,92,55,0,0,41,5,46
"4347",20200312,"WV",0,7,1,NA,NA,NA,NA,NA,NA,NA,"","3/12/2020 00:00","bc98a998bad0b66eb8ec744bc37e49cab93b2668","2020-03-12T20:00:00Z",NA,NA,8,7,7,54,0,0,4,0,4
"4348",20200312,"WY",1,NA,NA,NA,NA,NA,NA,NA,NA,NA,"","3/11/2020 00:00","82f143d73ce3619709635a4d54daf88abe2fd5b7","2020-03-12T20:00:00Z",NA,NA,1,1,1,56,0,0,0,1,1
"4349",20200311,"AK",0,46,14,NA,NA,NA,NA,NA,NA,NA,"","","6a17e217d5f39b7b3b9c1c5933dbc5811dbd4620","2020-03-11T20:00:00Z",0,NA,60,46,46,2,0,0,23,0,23
"4350",20200311,"AL",0,10,NA,NA,NA,NA,NA,NA,NA,NA,"","","06ecb0277a90135b760551e5a082a57764c3d807","2020-03-11T20:00:00Z",NA,NA,10,10,10,1,0,0,10,0,10
"4351",20200311,"AR",0,12,14,NA,NA,NA,NA,NA,NA,NA,"","","80255094c621d6195e52b47b98e8bfa28e2e8579","2020-03-11T20:00:00Z",NA,NA,26,12,12,5,0,0,0,0,0
"4352",20200311,"AZ",9,59,32,NA,NA,NA,NA,NA,NA,NA,"","","d11762a6aa89aab69f9835c86bc75cf29daac1a6","2020-03-11T20:00:00Z",NA,NA,100,68,68,4,0,0,8,3,11
"4353",20200311,"CA",157,916,NA,NA,NA,NA,NA,NA,NA,NA,"","","60d936c9cb6d9ed1560900ab7872fc8073995514","2020-03-11T20:00:00Z",NA,NA,1073,1073,1073,6,0,0,226,24,250
"4354",20200311,"CO",28,251,NA,NA,NA,NA,NA,NA,NA,NA,"","","b7997019bc28ca16f0ba29ba93d6207fb06f3239","2020-03-11T20:00:00Z",NA,NA,279,279,279,8,0,0,109,16,125
"4355",20200311,"CT",3,71,NA,NA,NA,NA,NA,NA,NA,NA,"","","a50b946b3349bf840cde39348e0fca28bc40e05e","2020-03-11T20:00:00Z",NA,NA,74,74,74,9,0,0,17,1,18
"4356",20200311,"DC",5,20,15,NA,NA,NA,NA,NA,NA,NA,"","","4d7d67cef5cf4b9935d6b380a888a4a6448eda83","2020-03-11T20:00:00Z",NA,NA,40,25,25,11,0,0,3,0,3
"4357",20200311,"DE",1,17,2,NA,NA,NA,NA,NA,NA,NA,"","","19fef58c9c6a081f4ccc6a0b5789af4a02104ca0","2020-03-11T20:00:00Z",NA,NA,20,18,18,10,0,0,0,1,1
"4358",20200311,"FL",28,301,147,NA,NA,NA,NA,NA,NA,NA,"","","5781ff15663b31589b51bb46a59012926192b1ab","2020-03-11T20:00:00Z",2,NA,476,329,329,12,2,0,79,9,88
"4359",20200311,"GA",22,NA,NA,NA,NA,NA,NA,NA,NA,NA,"","","4a03ebf8087c8597fc843c26f81394a7c705efca","2020-03-11T20:00:00Z",NA,NA,22,22,22,13,0,0,0,5,5
"4360",20200311,"HI",2,NA,NA,NA,NA,NA,NA,NA,NA,NA,"","","eb2926757b94fd9d2e1658516b94e1e324b6bd2a","2020-03-11T20:00:00Z",NA,NA,2,2,2,15,0,0,0,0,0
"4361",20200311,"IA",13,46,27,NA,NA,NA,NA,NA,NA,NA,"","","63c9dda23589c74f3a459e5d04e82ee77d5b1825","2020-03-11T20:00:00Z",NA,NA,86,59,59,19,0,0,14,5,19
"4362",20200311,"ID",0,67,NA,NA,NA,NA,NA,NA,NA,NA,"","","71eccb6f178f32c7ebad5308d02699935f78d077","2020-03-11T20:00:00Z",NA,NA,67,67,67,16,0,0,26,0,26
"4363",20200311,"IL",19,244,63,NA,NA,NA,NA,NA,NA,NA,"","","0004f9eb54f0230d146ed89bdbd8e44bb11e74cc","2020-03-11T20:00:00Z",NA,NA,326,263,263,17,0,0,0,0,0
"4364",20200311,"IN",10,33,NA,NA,NA,NA,NA,NA,NA,NA,"","","50f384cdf0aeed14014c35f1d4c6f89621327b3d","2020-03-11T20:00:00Z",NA,NA,43,43,43,18,0,0,3,4,7
"4365",20200311,"KS",1,41,NA,NA,NA,NA,NA,NA,NA,NA,"","","72c012d297b01fb6956f253e77e1f80fce188701","2020-03-11T20:00:00Z",NA,NA,42,42,42,20,0,0,24,0,24
"4366",20200311,"KY",8,46,NA,NA,NA,NA,NA,NA,NA,NA,"","","ca5a1d05cc67a03bd76386a233cc90302521de91","2020-03-11T20:00:00Z",NA,NA,54,54,54,21,0,0,18,2,20
"4367",20200311,"LA",6,37,NA,NA,NA,NA,NA,NA,NA,NA,"","","1aab27af026a6b0066fc0524e1038304b16cf525","2020-03-11T20:00:00Z",NA,NA,43,43,43,22,0,0,26,5,31
"4368",20200311,"MD",9,94,NA,NA,NA,NA,NA,NA,NA,NA,"","","8fc87b4c236b50c967f5bf481b41f6f95b2b7ec8","2020-03-11T20:00:00Z",NA,NA,103,103,103,24,0,0,5,3,8
"4369",20200311,"ME",0,42,5,NA,NA,NA,NA,NA,NA,NA,"","","0ddac8633d226be8538d32dea5a8c925b5154acf","2020-03-11T20:00:00Z",NA,NA,47,42,42,23,0,0,22,0,22
"4370",20200311,"MI",497,57,18,NA,NA,NA,NA,NA,NA,NA,"","","7330b9b2e5536ce3def8a389537ce0792b0aebf5","2020-03-11T20:00:00Z",NA,NA,572,554,554,26,0,0,18,139,157
"4371",20200311,"MN",5,217,NA,NA,NA,NA,NA,NA,NA,NA,"","","ee873ffab8eb2b95b24d08c93b147719c340ec51","2020-03-11T20:00:00Z",NA,NA,222,222,222,27,0,0,85,2,87
"4372",20200311,"MO",1,NA,NA,NA,NA,NA,NA,NA,NA,NA,"","","3072cff2a497155871e1c3ddeeab4e0e04903236","2020-03-11T20:00:00Z",NA,NA,1,1,1,29,0,0,0,0,0
"4373",20200311,"MS",0,20,NA,NA,NA,NA,NA,NA,NA,NA,"","","a3bffe28438a767a178189225b6b052e060a640b","2020-03-11T20:00:00Z",NA,NA,20,20,20,28,0,0,20,0,20
"4374",20200311,"MT",0,21,NA,NA,NA,NA,NA,NA,NA,NA,"","","91042afeab1e85f5b8e3526a908517f433314aa7","2020-03-11T20:00:00Z",NA,NA,21,21,21,30,0,0,6,0,6
"4375",20200311,"NC",7,NA,NA,NA,NA,NA,NA,NA,NA,NA,"","","68d7887db18fba2c67fbbb0a443ec50045ef70f5","2020-03-11T20:00:00Z",NA,NA,7,7,7,37,0,0,0,0,0
"4376",20200311,"ND",0,7,6,NA,NA,NA,NA,NA,NA,NA,"","","330f48b67b5b673b5a24c02f38c3ef5bd2b00079","2020-03-11T20:00:00Z",NA,NA,13,7,7,38,0,0,1,0,1
"4377",20200311,"NE",5,47,16,NA,NA,NA,NA,NA,NA,NA,"","","866aa890cd81f36382290eb62de8def5006b6d25","2020-03-11T20:00:00Z",NA,NA,68,52,52,31,0,0,0,2,2
"4378",20200311,"NH",4,38,5,NA,NA,NA,NA,NA,NA,NA,"","","22e9ac174530ddfe0b122b8dcc14d7da99402e6d","2020-03-11T20:00:00Z",NA,NA,47,42,42,33,0,0,0,0,0
"4379",20200311,"NJ",24,57,20,NA,NA,NA,NA,NA,NA,NA,"","","60cb4342d3b4c30a1733c72ef909bf0d7f32405f","2020-03-11T20:00:00Z",1,NA,101,81,81,34,1,0,13,9,22
"4380",20200311,"NM",3,87,NA,NA,NA,NA,NA,NA,NA,NA,"","","5fb0667eb7c8726c0f5877e01993e3a931632776","2020-03-11T20:00:00Z",NA,NA,90,90,90,35,0,0,18,3,21
"4381",20200311,"NV",5,168,NA,NA,NA,NA,NA,NA,NA,NA,"","","a4a2aeaeeaf36e62bfa811cb30c85be32c4d93f8","2020-03-11T20:00:00Z",NA,NA,173,173,173,32,0,0,154,4,158
"4382",20200311,"NY",216,92,NA,NA,NA,NA,NA,NA,NA,NA,"","","5cf3e282f2cdc4105ecc7b65c7cf23b8dfa7b10c","2020-03-11T20:00:00Z",NA,NA,308,308,308,36,0,0,0,43,43
"4383",20200311,"OH",4,21,24,NA,NA,NA,NA,NA,NA,NA,"","","ed08ee2387aa0a06219d835de3d21723e8f61aaf","2020-03-11T20:00:00Z",NA,NA,49,25,25,39,0,0,7,1,8
"4384",20200311,"OK",2,15,11,NA,NA,NA,NA,NA,NA,NA,"","","203e05cbc7f8e340061e964ea7473d8b836c4c3f","2020-03-11T20:00:00Z",NA,NA,28,17,17,40,0,0,0,0,0
"4385",20200311,"OR",19,286,62,NA,NA,NA,NA,NA,NA,NA,"","","3deb302fff68fe73b27280faaf9ed5e4c04762c2","2020-03-11T20:00:00Z",NA,NA,367,305,305,41,0,0,73,4,77
"4386",20200311,"PA",16,88,54,NA,NA,NA,NA,NA,NA,NA,"","","8893339ae1005d36d38129a2266059253613f391","2020-03-11T20:00:00Z",NA,NA,158,104,104,42,0,0,88,4,92
"4387",20200311,"RI",5,94,24,NA,NA,NA,NA,NA,NA,NA,"","","f2501a16eee193ceb4ebda6e88672ad45fa77d13","2020-03-11T20:00:00Z",NA,NA,123,99,99,44,0,0,36,2,38
"4388",20200311,"SC",9,32,NA,NA,NA,NA,NA,NA,NA,NA,"","","d2482c6dd3356257b4d3e8fb5784121dc2e2e48a","2020-03-11T20:00:00Z",NA,NA,41,41,41,45,0,0,8,2,10
"4389",20200311,"SD",5,13,2,NA,NA,NA,NA,NA,NA,NA,"","","5ed811da23fe9229ab79f73dd4c15697ab3ed3b6","2020-03-11T20:00:00Z",NA,NA,20,18,18,46,0,0,2,5,7
"4390",20200311,"TN",7,50,NA,NA,NA,NA,NA,NA,NA,NA,"","","363f68ca1bfcc155ee4040328de32478e999582a","2020-03-11T20:00:00Z",NA,NA,57,57,57,47,0,0,50,0,50
"4391",20200311,"TX",21,NA,NA,NA,NA,NA,NA,NA,NA,NA,"","","cdd57a5e5141b6e094cc93557f67f00a2cfc8922","2020-03-11T20:00:00Z",NA,NA,21,21,21,48,0,0,0,8,8
"4392",20200311,"UT",2,NA,NA,NA,NA,NA,NA,NA,NA,NA,"","","d9b1bc62be94033685af0bf6848b7157aead3399","2020-03-11T20:00:00Z",NA,NA,2,2,2,49,0,0,0,0,0
"4393",20200311,"VA",9,60,NA,NA,NA,NA,NA,NA,NA,NA,"","","2af80d9ae51b403b033ddcae7c61d724ba8ac808","2020-03-11T20:00:00Z",NA,NA,69,69,69,51,0,0,7,1,8
"4394",20200311,"VT",2,91,NA,NA,NA,NA,NA,NA,NA,NA,"","3/11/2020 00:00","9cf0ce4216912ced59df03afa130ace58685ffec","2020-03-11T20:00:00Z",NA,NA,93,93,93,50,0,0,31,1,32
"4395",20200311,"WA",621,6976,NA,NA,NA,NA,NA,NA,NA,NA,"","3/11/2020 00:00","f0dbd72d89645c8a8196f72286272a3b885dc513","2020-03-11T20:00:00Z",40,NA,7597,7597,7597,53,3,0,2128,133,2261
"4396",20200311,"WI",3,43,NA,NA,NA,NA,NA,NA,NA,NA,"","","1677f4db42de2eb0e644a7a546e02b5b78b9b969","2020-03-11T20:00:00Z",NA,NA,46,46,46,55,0,0,7,1,8
"4397",20200311,"WV",0,3,2,NA,NA,NA,NA,NA,NA,NA,"","","fe56925cfbec4b47ec62aa0d54549f71d30c1599","2020-03-11T20:00:00Z",NA,NA,5,3,3,54,0,0,1,0,1
"4398",20200311,"WY",0,NA,NA,NA,NA,NA,NA,NA,NA,NA,"","","0d018ee600974481c6d8b8acb1efc3c02b46b980","2020-03-11T20:00:00Z",NA,NA,0,0,0,56,0,0,0,0,0
"4399",20200310,"AK",0,23,9,NA,NA,NA,NA,NA,NA,NA,"","","7aa445ebf9123446b45e378bb01eb24bf5f69895","2020-03-10T20:00:00Z",0,NA,32,23,23,2,0,0,0,0,0
"4400",20200310,"AL",0,0,0,NA,NA,NA,NA,NA,NA,NA,"","","8b98d3b5d6d75f9bb40ee70ef5553b794b7dc4f2","2020-03-10T20:00:00Z",NA,NA,0,0,0,1,0,0,0,0,0
"4401",20200310,"AR",0,12,3,NA,NA,NA,NA,NA,NA,NA,"","","5915eced558a3be0e01106c038a14b0270fc332a","2020-03-10T20:00:00Z",NA,NA,15,12,12,5,0,0,0,0,0
"4402",20200310,"AZ",6,51,27,NA,NA,NA,NA,NA,NA,NA,"","","81695174dcf77c23f3e43cf3fce72505d0e08844","2020-03-10T20:00:00Z",NA,NA,84,57,57,4,0,0,7,1,8
"4403",20200310,"CA",133,690,NA,NA,NA,NA,NA,NA,NA,NA,"","","f4e668d5ae447eac56a4fa18a1ce16cc9f955e3c","2020-03-10T20:00:00Z",NA,NA,823,823,823,6,0,0,0,19,19
"4404",20200310,"CO",12,142,1,NA,NA,NA,NA,NA,NA,NA,"","","4657e3fc46f817f32540879c088eeb1002fb8d08","2020-03-10T20:00:00Z",NA,NA,155,154,154,8,0,0,9,3,12
"4405",20200310,"CT",2,54,NA,NA,NA,NA,NA,NA,NA,NA,"","","7f3277a408e2f348babf7d8d9eb2de399879a75c","2020-03-10T20:00:00Z",NA,NA,56,56,56,9,0,0,8,1,9
"4406",20200310,"DC",5,17,2,NA,NA,NA,NA,NA,NA,NA,"","","613bf069c452d58c8d409d9456a9bc7ff150d845","2020-03-10T20:00:00Z",NA,NA,24,22,22,11,0,0,3,4,7
"4407",20200310,"DE",0,17,3,NA,NA,NA,NA,NA,NA,NA,"","","8cea37df26f67cfb796a63b7c55f40e6f85697fa","2020-03-10T20:00:00Z",NA,NA,20,17,17,10,0,0,2,0,2
"4408",20200310,"FL",19,222,155,NA,NA,NA,NA,NA,NA,NA,"","","b0fda208d2b56648cfc87e7cde951c2cdae386ca","2020-03-10T20:00:00Z",NA,NA,396,241,241,12,0,0,82,1,83
"4409",20200310,"GA",17,NA,NA,NA,NA,NA,NA,NA,NA,NA,"","","8f8a65df093f47241910352b46d2feea39cc5593","2020-03-10T20:00:00Z",NA,NA,17,17,17,13,0,0,0,5,5
"4410",20200310,"HI",2,NA,NA,NA,NA,NA,NA,NA,NA,NA,"","","a4345d576b19ef312be056ccc8a47d3d07788c20","2020-03-10T20:00:00Z",NA,NA,2,2,2,15,0,0,0,0,0
"4411",20200310,"IA",8,32,11,NA,NA,NA,NA,NA,NA,NA,"","","939388d7f2e84de1e3aaba70d448e167de3481b9","2020-03-10T20:00:00Z",NA,NA,51,40,40,19,0,0,6,5,11
"4412",20200310,"ID",0,41,NA,NA,NA,NA,NA,NA,NA,NA,"","","c1ebeb10a4474a95cd5c68e27b35ed840bae1b1b","2020-03-10T20:00:00Z",NA,NA,41,41,41,16,0,0,0,0,0
"4413",20200310,"IL",19,244,63,NA,NA,NA,NA,NA,NA,NA,"","","11df7db73830bcff295941a0519a6fac87cd9b66","2020-03-10T20:00:00Z",NA,NA,326,263,263,17,0,0,53,12,65
"4414",20200310,"IN",6,30,NA,NA,NA,NA,NA,NA,NA,NA,"","","87388c6aa5b3c11751b6bce081f05259038c528a","2020-03-10T20:00:00Z",NA,NA,36,36,36,18,0,0,30,4,34
"4415",20200310,"KS",1,17,21,NA,NA,NA,NA,NA,NA,NA,"","","c6bca0b0680cbcafd2e35513703ac1b853a132c8","2020-03-10T20:00:00Z",NA,NA,39,18,18,20,0,0,6,0,6
"4416",20200310,"KY",6,28,NA,NA,NA,NA,NA,NA,NA,NA,"","","a94a38c1e140208d2603b2afda2d42be33ebc681","2020-03-10T20:00:00Z",NA,NA,34,34,34,21,0,0,11,2,13
"4417",20200310,"LA",1,11,NA,NA,NA,NA,NA,NA,NA,NA,"","","359ed3be2532bb96f427b5b89a56938ca9480ce5","2020-03-10T20:00:00Z",NA,NA,12,12,12,22,0,0,6,0,6
"4418",20200310,"MD",6,89,NA,NA,NA,NA,NA,NA,NA,NA,"","","488eae7cee4e37e69139928af6421b7aa41c7c00","2020-03-10T20:00:00Z",NA,NA,95,95,95,24,0,0,16,1,17
"4419",20200310,"ME",0,20,5,NA,NA,NA,NA,NA,NA,NA,"","","b0e0dbf007a9a9fcbbebeb82e267755cd026e953","2020-03-10T20:00:00Z",NA,NA,25,20,20,23,0,0,19,0,19
"4420",20200310,"MI",358,39,24,NA,NA,NA,NA,NA,NA,NA,"","","1dd36776e499a4697f2ab9f07b6ab2fdabaf22d8","2020-03-10T20:00:00Z",NA,NA,421,397,397,26,0,0,3,104,107
"4421",20200310,"MN",3,132,NA,NA,NA,NA,NA,NA,NA,NA,"","","e1bfbb03bca27ec7e7797e6c212d1d02fdbb4e0f","2020-03-10T20:00:00Z",NA,NA,135,135,135,27,0,0,52,1,53
"4422",20200310,"MO",1,NA,NA,NA,NA,NA,NA,NA,NA,NA,"","","fe9d3dc01407c6959d9c0f092c43b1b73565d872","2020-03-10T20:00:00Z",NA,NA,1,1,1,29,0,0,0,0,0
"4423",20200310,"MS",0,NA,NA,NA,NA,NA,NA,NA,NA,NA,"","","1a422b939eaff2655d3ae45649aaf19af62a4f86","2020-03-10T20:00:00Z",NA,NA,0,0,0,28,0,0,0,0,0
"4424",20200310,"MT",0,15,NA,NA,NA,NA,NA,NA,NA,NA,"","","57eda92ebbef98d7b70c8cc5107565bf39cd53e3","2020-03-10T20:00:00Z",NA,NA,15,15,15,30,0,0,4,0,4
"4425",20200310,"NC",7,NA,NA,NA,NA,NA,NA,NA,NA,NA,"","","a10b191f176149f5664cd01e625714253ac9b5c3","2020-03-10T20:00:00Z",NA,NA,7,7,7,37,0,0,0,5,5
"4426",20200310,"ND",0,6,2,NA,NA,NA,NA,NA,NA,NA,"","","ada6c1f9a68785d97faa58ac7f7c84c39d1c18b8","2020-03-10T20:00:00Z",NA,NA,8,6,6,38,0,0,6,0,6
"4427",20200310,"NE",3,47,16,NA,NA,NA,NA,NA,NA,NA,"","","fe24d76ce16aba1481419c8d2c4ac36516bf2214","2020-03-10T20:00:00Z",NA,NA,66,50,50,31,0,0,11,0,11
"4428",20200310,"NH",4,38,5,NA,NA,NA,NA,NA,NA,NA,"","","dc219020cc0d324aa724add379febca0df24ae64","2020-03-10T20:00:00Z",NA,NA,47,42,42,33,0,0,0,0,0
"4429",20200310,"NJ",15,44,20,NA,NA,NA,NA,NA,NA,NA,"","","9320a466c773bef36cb9863c57c4c3fce5fb8ce9","2020-03-10T20:00:00Z",NA,NA,79,59,59,34,0,0,9,4,13
"4430",20200310,"NM",0,69,NA,NA,NA,NA,NA,NA,NA,NA,"","","49b4f8774968ab71c883f408328894622fbe3d75","2020-03-10T20:00:00Z",NA,NA,69,69,69,35,0,0,12,0,12
"4431",20200310,"NV",1,14,NA,NA,NA,NA,NA,NA,NA,NA,"","","6381ada46e31bf651fa0846a504c825a8ab1cf76","2020-03-10T20:00:00Z",NA,NA,15,15,15,32,0,0,0,0,0
"4432",20200310,"NY",173,92,NA,NA,NA,NA,NA,NA,NA,NA,"","","f5e6ba4c432f0d12e5c954511fc9ca0c6fcc4234","2020-03-10T20:00:00Z",NA,NA,265,265,265,36,0,0,0,31,31
"4433",20200310,"OH",3,14,15,NA,NA,NA,NA,NA,NA,NA,"","","faf34d6c3eb97dd3a3c45a32816d21f6420c88c8","2020-03-10T20:00:00Z",NA,NA,32,17,17,39,0,0,3,0,3
"4434",20200310,"OK",2,15,11,NA,NA,NA,NA,NA,NA,NA,"","","00d7578add0d5b5021386a6e92390b3ca0182bbf","2020-03-10T20:00:00Z",NA,NA,28,17,17,40,0,0,7,1,8
"4435",20200310,"OR",15,213,67,NA,NA,NA,NA,NA,NA,NA,"","","499425850c460ce9d95996930a8b678c3ac36e44","2020-03-10T20:00:00Z",NA,NA,295,228,228,41,0,0,48,1,49
"4436",20200310,"PA",12,NA,NA,NA,NA,NA,NA,NA,NA,NA,"","","423c1493e2ea8ce4e24b87a9ded7c0b1301b6894","2020-03-10T20:00:00Z",NA,NA,12,12,12,42,0,0,0,2,2
"4437",20200310,"RI",3,58,6,NA,NA,NA,NA,NA,NA,NA,"","","7ac89ff1276334fa31b0f4c22f39acdfaaecca15","2020-03-10T20:00:00Z",NA,NA,67,61,61,44,0,0,28,0,28
"4438",20200310,"SC",7,24,NA,NA,NA,NA,NA,NA,NA,NA,"","","9fa59a047857d667e058c22285356f6b4a4b2f40","2020-03-10T20:00:00Z",NA,NA,31,31,31,45,0,0,0,0,0
"4439",20200310,"SD",0,11,0,NA,NA,NA,NA,NA,NA,NA,"","","23dc68f9dd57592ed7d606c90fefcc6b012fe14d","2020-03-10T20:00:00Z",NA,NA,11,11,11,46,0,0,6,0,6
"4440",20200310,"TN",7,NA,NA,NA,NA,NA,NA,NA,NA,NA,"","","de6fc234b4875a8de09df905b925df491f38cadb","2020-03-10T20:00:00Z",NA,NA,7,7,7,47,0,0,0,4,4
"4441",20200310,"TX",13,NA,NA,NA,NA,NA,NA,NA,NA,NA,"","","8f2767e624ec9bd082250395a3bae8433810be92","2020-03-10T20:00:00Z",NA,NA,13,13,13,48,0,0,0,1,1
"4442",20200310,"UT",2,NA,NA,NA,NA,NA,NA,NA,NA,NA,"","","3fa8b23eb9dbba9fab7dcb4a8afca76dfd5159da","2020-03-10T20:00:00Z",NA,NA,2,2,2,49,0,0,0,1,1
"4443",20200310,"VA",8,53,NA,NA,NA,NA,NA,NA,NA,NA,"","","dff7e6291d2a23f5be90bcb158183a4251f44e51","2020-03-10T20:00:00Z",NA,NA,61,61,61,51,0,0,15,5,20
"4444",20200310,"VT",1,60,NA,NA,NA,NA,NA,NA,NA,NA,"","3/10/2020 00:00","3543d7546c0d29c3058536871b89ee981787a481","2020-03-10T20:00:00Z",NA,NA,61,61,61,50,0,0,24,0,24
"4445",20200310,"WA",488,4848,NA,NA,NA,NA,NA,NA,NA,NA,"","3/10/2020 00:00","68b3f486ec7a0c581f7e2e8502855fe6da84c4ff","2020-03-10T20:00:00Z",37,NA,5336,5336,5336,53,2,0,1675,110,1785
"4446",20200310,"WI",2,36,NA,NA,NA,NA,NA,NA,NA,NA,"","","113c8c888f93662c07661d47ddcb4fc1a1a47792","2020-03-10T20:00:00Z",NA,NA,38,38,38,55,0,0,0,1,1
"4447",20200310,"WV",0,2,3,NA,NA,NA,NA,NA,NA,NA,"","","31efe909b589c654b765ac4ebbdcbfc6119b42a2","2020-03-10T20:00:00Z",NA,NA,5,2,2,54,0,0,0,0,0
"4448",20200310,"WY",0,0,0,NA,NA,NA,NA,NA,NA,NA,"","","5e201400cd4b8f675ef3d9705b5f0b3a91e180fe","2020-03-10T20:00:00Z",NA,NA,0,0,0,56,0,0,0,0,0
"4449",20200309,"AK",0,23,9,NA,NA,NA,NA,NA,NA,NA,"","","3c498dcf81280452872d02ad5f1e513e76aec6db","2020-03-09T20:00:00Z",0,NA,32,23,23,2,0,0,9,0,9
"4450",20200309,"AL",0,NA,NA,NA,NA,NA,NA,NA,NA,NA,"","","c391f721afe45510e1c1c86223e438174db9baf8","2020-03-09T20:00:00Z",NA,NA,0,0,0,1,0,0,0,0,0
"4451",20200309,"AR",0,12,0,NA,NA,NA,NA,NA,NA,NA,"","","d67372efe7e353dd1f68faaf3909a28904d33c10","2020-03-09T20:00:00Z",NA,NA,12,12,12,5,0,0,6,0,6
"4452",20200309,"AZ",5,44,7,NA,NA,NA,NA,NA,NA,NA,"","","727fe27849aa2e43a49fc7d85a66281caceef335","2020-03-09T20:00:00Z",NA,NA,56,49,49,4,0,0,0,0,0
"4453",20200309,"CA",114,690,NA,NA,NA,NA,NA,NA,NA,NA,"","","1ceaa8d0d7e0d8e3ceb1ba651358f9284c65cfad","2020-03-09T20:00:00Z",NA,NA,804,804,804,6,0,0,228,26,254
"4454",20200309,"CO",9,133,NA,NA,NA,NA,NA,NA,NA,NA,"","","34f03a150c95fd69c775088ec8bb507a00b70ca7","2020-03-09T20:00:00Z",NA,NA,142,142,142,8,0,0,29,1,30
"4455",20200309,"CT",1,46,NA,NA,NA,NA,NA,NA,NA,NA,"","","669fd750555d7977be56e3bdf4cc3a74feff2ac7","2020-03-09T20:00:00Z",NA,NA,47,47,47,9,0,0,17,0,17
"4456",20200309,"DC",1,14,3,NA,NA,NA,NA,NA,NA,NA,"","","5ef46bfe8f536df13a967100f1fb48002b12c50a","2020-03-09T20:00:00Z",NA,NA,18,15,15,11,0,0,4,0,4
"4457",20200309,"DE",0,15,3,NA,NA,NA,NA,NA,NA,NA,"","","7c51337d94bcfabab82c327a971d3a80651fa30f","2020-03-09T20:00:00Z",NA,NA,18,15,15,10,0,0,5,0,5
"4458",20200309,"FL",18,140,115,NA,NA,NA,NA,NA,NA,NA,"","","f7927f370dbe171e9a73ec5670b83379d7ad2be0","2020-03-09T20:00:00Z",NA,NA,273,158,158,12,0,0,22,1,23
"4459",20200309,"GA",12,NA,NA,NA,NA,NA,NA,NA,NA,NA,"","","0fbf01765ded5020e80a3175a463a6521d57dbf8","2020-03-09T20:00:00Z",NA,NA,12,12,12,13,0,0,0,5,5
"4460",20200309,"HI",2,NA,NA,NA,NA,NA,NA,NA,NA,NA,"","","4e0cf85cd8727d5a4e4149ef401265cb28dc7e75","2020-03-09T20:00:00Z",NA,NA,2,2,2,15,0,0,0,1,1
"4461",20200309,"IA",3,26,8,NA,NA,NA,NA,NA,NA,NA,"","","8c1f818dbee68bba4818f6ad1854233c117c6937","2020-03-09T20:00:00Z",NA,NA,37,29,29,19,0,0,11,3,14
"4462",20200309,"ID",0,41,NA,NA,NA,NA,NA,NA,NA,NA,"","","1e5be216e0fe922c8600be7ad195fa2e43793e95","2020-03-09T20:00:00Z",NA,NA,41,41,41,16,0,0,14,0,14
"4463",20200309,"IL",7,191,44,NA,NA,NA,NA,NA,NA,NA,"","","dc093bf66830aba5a6d67537dea6f1585aa0c3a2","2020-03-09T20:00:00Z",NA,NA,242,198,198,17,0,0,0,1,1
"4464",20200309,"IN",2,NA,NA,NA,NA,NA,NA,NA,NA,NA,"","","99c5bc2a8f43601caefdbfafbed8ead17fe99383","2020-03-09T20:00:00Z",NA,NA,2,2,2,18,0,0,0,0,0
"4465",20200309,"KS",1,11,0,NA,NA,NA,NA,NA,NA,NA,"","","448e16b98086ad2c26474874e672b32fa5908d7c","2020-03-09T20:00:00Z",NA,NA,12,12,12,20,0,0,0,0,0
"4466",20200309,"KY",4,17,NA,NA,NA,NA,NA,NA,NA,NA,"","","a5620dea9561538bfdd8ed0055db067113e3476a","2020-03-09T20:00:00Z",NA,NA,21,21,21,21,0,0,4,3,7
"4467",20200309,"LA",1,5,NA,NA,NA,NA,NA,NA,NA,NA,"","","6fce2175ae402c29f015b4cd8fa23e24725fcdc3","2020-03-09T20:00:00Z",NA,NA,6,6,6,22,0,0,0,1,1
"4468",20200309,"MD",5,73,NA,NA,NA,NA,NA,NA,NA,NA,"","","bc6492d93531172381cf3debb19db8f5f9da278c","2020-03-09T20:00:00Z",NA,NA,78,78,78,24,0,0,21,2,23
"4469",20200309,"ME",0,1,NA,NA,NA,NA,NA,NA,NA,NA,"","","232bbbf5b1d6623364f1624cdceca7b7e4ffb988","2020-03-09T20:00:00Z",NA,NA,1,1,1,23,0,0,0,0,0
"4470",20200309,"MI",254,36,11,NA,NA,NA,NA,NA,NA,NA,"","","dbede44656da71b55009c6472a56b2ef7a65b656","2020-03-09T20:00:00Z",NA,NA,301,290,290,26,0,0,10,86,96
"4471",20200309,"MN",2,80,NA,NA,NA,NA,NA,NA,NA,NA,"","","6175956e53af5d9d3e3d1a73715cfa374ec933aa","2020-03-09T20:00:00Z",NA,NA,82,82,82,27,0,0,32,1,33
"4472",20200309,"MO",1,NA,NA,NA,NA,NA,NA,NA,NA,NA,"","","3265e61b1bc002b1526c6f3c5edea16048a5e84f","2020-03-09T20:00:00Z",NA,NA,1,1,1,29,0,0,0,0,0
"4473",20200309,"MS",0,NA,NA,NA,NA,NA,NA,NA,NA,NA,"","","2bdea2f6c500751a901d7c8919976f27de7eac46","2020-03-09T20:00:00Z",NA,NA,0,0,0,28,0,0,0,0,0
"4474",20200309,"MT",0,11,NA,NA,NA,NA,NA,NA,NA,NA,"","","f6819f90117fa709c8ef0832df658498b334960b","2020-03-09T20:00:00Z",NA,NA,11,11,11,30,0,0,0,0,0
"4475",20200309,"NC",2,NA,NA,NA,NA,NA,NA,NA,NA,NA,"","","c831a500b66fc8689c46677043ebb3622e40223f","2020-03-09T20:00:00Z",NA,NA,2,2,2,37,0,0,0,0,0
"4476",20200309,"ND",0,0,NA,NA,NA,NA,NA,NA,NA,NA,"","","5885fd57e5596a6a3b56e153e63d32b9b6e6550e","2020-03-09T20:00:00Z",NA,NA,0,0,0,38,0,0,0,0,0
"4477",20200309,"NE",3,36,9,NA,NA,NA,NA,NA,NA,NA,"","","6cf406a9f3175cfc2177d5d12d328ba636840e85","2020-03-09T20:00:00Z",NA,NA,48,39,39,31,0,0,19,2,21
"4478",20200309,"NH",4,38,5,NA,NA,NA,NA,NA,NA,NA,"","","039e3f63afe2af4b1484141ceab697ce4ccd7556","2020-03-09T20:00:00Z",NA,NA,47,42,42,33,0,0,0,0,0
"4479",20200309,"NJ",11,35,14,NA,NA,NA,NA,NA,NA,NA,"","","b21196c553fc8be6533debdf45253264d9575ec8","2020-03-09T20:00:00Z",NA,NA,60,46,46,34,0,0,4,5,9
"4480",20200309,"NM",0,57,0,NA,NA,NA,NA,NA,NA,NA,"","","a866586692a35d3ffdcb61523909d8e8719a0c64","2020-03-09T20:00:00Z",NA,NA,57,57,57,35,0,0,9,0,9
"4481",20200309,"NV",1,14,NA,NA,NA,NA,NA,NA,NA,NA,"","","5220c98d865af5f5d7787aad7340147efb242185","2020-03-09T20:00:00Z",NA,NA,15,15,15,32,0,0,0,0,0
"4482",20200309,"NY",142,92,NA,NA,NA,NA,NA,NA,NA,NA,"","","cb36363f3eca57c7bfddd3d8ea4234ed33dda5f9","2020-03-09T20:00:00Z",NA,NA,234,234,234,36,0,0,0,37,37
"4483",20200309,"OH",3,11,5,NA,NA,NA,NA,NA,NA,NA,"","","03232f19ae6839c940887ff62c54d456be5cffd2","2020-03-09T20:00:00Z",NA,NA,19,14,14,39,0,0,1,3,4
"4484",20200309,"OK",1,8,10,NA,NA,NA,NA,NA,NA,NA,"","","eeb142eebe82d403131a95b29e77fbf5c1cf12bb","2020-03-09T20:00:00Z",NA,NA,19,9,9,40,0,0,0,0,0
"4485",20200309,"OR",14,165,52,NA,NA,NA,NA,NA,NA,NA,"","","d8aa8b6c66110003d1d369da2f60b767baa6ca92","2020-03-09T20:00:00Z",NA,NA,231,179,179,41,0,0,65,0,65
"4486",20200309,"PA",10,NA,NA,NA,NA,NA,NA,NA,NA,NA,"","","c43be13c78ee5621148a56dafd11a999207463e6","2020-03-09T20:00:00Z",NA,NA,10,10,10,42,0,0,0,4,4
"4487",20200309,"RI",3,30,6,NA,NA,NA,NA,NA,NA,NA,"","","d52c254e15dd06ac41a9f7d098cc0135fde41601","2020-03-09T20:00:00Z",NA,NA,39,33,33,44,0,0,0,0,0
"4488",20200309,"SC",7,24,NA,NA,NA,NA,NA,NA,NA,NA,"","","223368d6c07b9e6c7aa28a16aff61089e68a8132","2020-03-09T20:00:00Z",NA,NA,31,31,31,45,0,0,16,5,21
"4489",20200309,"SD",0,5,0,NA,NA,NA,NA,NA,NA,NA,"","","c920e44f382cffa1219af5e3dba905975991ef00","2020-03-09T20:00:00Z",NA,NA,5,5,5,46,0,0,0,0,0
"4490",20200309,"TN",3,NA,NA,NA,NA,NA,NA,NA,NA,NA,"","","7bbb0a16ab7399a4a1c6c928deeef265d30844aa","2020-03-09T20:00:00Z",NA,NA,3,3,3,47,0,0,0,0,0
"4491",20200309,"TX",12,NA,NA,NA,NA,NA,NA,NA,NA,NA,"","","ce1a7b6da123358ddb3f0468becb807dcd2e379e","2020-03-09T20:00:00Z",NA,NA,12,12,12,48,0,0,0,4,4
"4492",20200309,"UT",1,NA,NA,NA,NA,NA,NA,NA,NA,NA,"","","edb9926d0e443abdec9d7b95d8de47943ccd9471","2020-03-09T20:00:00Z",NA,NA,1,1,1,49,0,0,0,0,0
"4493",20200309,"VA",3,38,9,NA,NA,NA,NA,NA,NA,NA,"","","080de474c5e2acc342f9e95a790c798cc3191da4","2020-03-09T20:00:00Z",NA,NA,50,41,41,51,0,0,2,1,3
"4494",20200309,"VT",1,36,NA,NA,NA,NA,NA,NA,NA,NA,"","3/9/2020 00:00","7944b7c2f381dcff48d6769b113b8285196281ed","2020-03-09T20:00:00Z",NA,NA,37,37,37,50,0,0,6,0,6
"4495",20200309,"WA",378,3173,NA,NA,NA,NA,NA,NA,NA,NA,"","3/9/2020 00:00","2b608e0a050dae0c791ebbcc5f0ad5d87ad4debd","2020-03-09T20:00:00Z",35,NA,3551,3551,3551,53,4,0,965,61,1026
"4496",20200309,"WI",1,36,NA,NA,NA,NA,NA,NA,NA,NA,"","","9f5c23676b5962084cfea511246d46c497acf2be","2020-03-09T20:00:00Z",NA,NA,37,37,37,55,0,0,5,0,5
"4497",20200309,"WV",0,2,3,NA,NA,NA,NA,NA,NA,NA,"","","3ff06cf60953e9f7c7d16f0c36c0265202e16e2a","2020-03-09T20:00:00Z",NA,NA,5,2,2,54,0,0,0,0,0
"4498",20200309,"WY",0,NA,NA,NA,NA,NA,NA,NA,NA,NA,"","","a327a5a21744148696b5cc37e660eb8c6f78bb4e","2020-03-09T20:00:00Z",NA,NA,0,0,0,56,0,0,0,0,0
"4499",20200308,"AK",0,14,6,NA,NA,NA,NA,NA,NA,NA,"","","528a8fb92237aff1573242df365fac0172b5c6ef","2020-03-08T20:00:00Z",0,NA,20,14,14,2,0,0,2,0,2
"4500",20200308,"AL",0,NA,NA,NA,NA,NA,NA,NA,NA,NA,"","","cef5c30ef98434091f43d4339edbbda536a2b1e3","2020-03-08T20:00:00Z",NA,NA,0,0,0,1,0,0,0,0,0
"4501",20200308,"AR",0,6,0,NA,NA,NA,NA,NA,NA,NA,"","","2d0e28c3150765d723fa0efa3029de462580560f","2020-03-08T20:00:00Z",NA,NA,6,6,6,5,0,0,0,0,0
"4502",20200308,"AZ",5,44,7,NA,NA,NA,NA,NA,NA,NA,"","","0e1f5c7dfa29131f97f502cd9f3c9da424ba9726","2020-03-08T20:00:00Z",NA,NA,56,49,49,4,0,0,0,0,0
"4503",20200308,"CA",88,462,NA,NA,NA,NA,NA,NA,NA,NA,"","","a34b3bacf8a39873680d04e62a718fc240a6ab06","2020-03-08T20:00:00Z",NA,NA,550,550,550,6,0,0,0,19,19
"4504",20200308,"CO",8,104,NA,NA,NA,NA,NA,NA,NA,NA,"","","803a4c98a110ae556ea9974cadf43697af4fdaf6","2020-03-08T20:00:00Z",NA,NA,112,112,112,8,0,0,49,0,49
"4505",20200308,"CT",1,29,8,NA,NA,NA,NA,NA,NA,NA,"","","4028da95cf5c5dc0b039bb3df0eaf316cecd9cec","2020-03-08T20:00:00Z",NA,NA,38,30,30,9,0,0,29,1,30
"4506",20200308,"DC",1,10,0,NA,NA,NA,NA,NA,NA,NA,"","","5396774a83765e303e4b6e5ecaf4c91b61899664","2020-03-08T20:00:00Z",NA,NA,11,11,11,11,0,0,2,1,3
"4507",20200308,"DE",0,10,0,NA,NA,NA,NA,NA,NA,NA,"","","39576788f956e07563de6035710046d8c3dc186f","2020-03-08T20:00:00Z",NA,NA,10,10,10,10,0,0,0,0,0
"4508",20200308,"FL",17,118,108,NA,NA,NA,NA,NA,NA,NA,"","","6fe85d0dc53d6860063f38e98dccf29e36f035c3","2020-03-08T20:00:00Z",NA,NA,243,135,135,12,0,0,18,3,21
"4509",20200308,"GA",7,NA,NA,NA,NA,NA,NA,NA,NA,NA,"","","45a994c2b31af670e6050c1b172d364897e1b947","2020-03-08T20:00:00Z",NA,NA,7,7,7,13,0,0,0,1,1
"4510",20200308,"HI",1,NA,NA,NA,NA,NA,NA,NA,NA,NA,"","","7b212dc2407d970ad0f094667a31328ef7b8092e","2020-03-08T20:00:00Z",NA,NA,1,1,1,15,0,0,0,0,0
"4511",20200308,"IA",0,15,2,NA,NA,NA,NA,NA,NA,NA,"","","8c409911e1a89656417015d497cb9b849927ee6c","2020-03-08T20:00:00Z",NA,NA,17,15,15,19,0,0,0,0,0
"4512",20200308,"ID",0,27,NA,NA,NA,NA,NA,NA,NA,NA,"","","74d79887a243364c4c2fe7a6ad62ccbb83226f11","2020-03-08T20:00:00Z",NA,NA,27,27,27,16,0,0,0,0,0
"4513",20200308,"IL",6,191,44,NA,NA,NA,NA,NA,NA,NA,"","","47d431f003050a39633e3e95d92ff5b1cdf36a48","2020-03-08T20:00:00Z",NA,NA,241,197,197,17,0,0,0,0,0
"4514",20200308,"IN",2,NA,NA,NA,NA,NA,NA,NA,NA,NA,"","","7670698a2c61ca9b45619f6f8d88da4cff52a00a","2020-03-08T20:00:00Z",NA,NA,2,2,2,18,0,0,0,1,1
"4515",20200308,"KS",1,11,0,NA,NA,NA,NA,NA,NA,NA,"","","3e2b2c3293e7d6325ea3c825b469948ef11daf7e","2020-03-08T20:00:00Z",NA,NA,12,12,12,20,0,0,0,1,1
"4516",20200308,"KY",1,13,NA,NA,NA,NA,NA,NA,NA,NA,"","","52c55102ec7eee6a54b80075369c8be5c91bb032","2020-03-08T20:00:00Z",NA,NA,14,14,14,21,0,0,4,0,4
"4517",20200308,"LA",0,5,NA,NA,NA,NA,NA,NA,NA,NA,"","","2a463172f3bbea55dc4b4a53b87bb3b66e4e7913","2020-03-08T20:00:00Z",NA,NA,5,5,5,22,0,0,5,0,5
"4518",20200308,"MD",3,52,NA,NA,NA,NA,NA,NA,NA,NA,"","","38e304fe40863f3ded54ddeab964f486e923a482","2020-03-08T20:00:00Z",NA,NA,55,55,55,24,0,0,11,0,11
"4519",20200308,"ME",0,1,NA,NA,NA,NA,NA,NA,NA,NA,"","","3d24dd61bfa082a97f29b84ef0dc60f6f2380b32","2020-03-08T20:00:00Z",NA,NA,1,1,1,23,0,0,0,0,0
"4520",20200308,"MI",168,26,10,NA,NA,NA,NA,NA,NA,NA,"","","b49f3d2f69affd288189a802203dc7a5ece93b40","2020-03-08T20:00:00Z",NA,NA,204,194,194,26,0,0,8,40,48
"4521",20200308,"MN",1,48,NA,NA,NA,NA,NA,NA,NA,NA,"","","7d153b18b6336551aad4dbcdbdd4a8a97b1fa8de","2020-03-08T20:00:00Z",NA,NA,49,49,49,27,0,0,0,0,0
"4522",20200308,"MO",1,NA,NA,NA,NA,NA,NA,NA,NA,NA,"","","0a1ee3936fc3d9b360c1b01063f24e521206b1e4","2020-03-08T20:00:00Z",NA,NA,1,1,1,29,0,0,0,1,1
"4523",20200308,"MS",0,NA,NA,NA,NA,NA,NA,NA,NA,NA,"","","aa2b94c74cebbdf8cd2e045e4b97924f09af65b2","2020-03-08T20:00:00Z",NA,NA,0,0,0,28,0,0,0,0,0
"4524",20200308,"MT",0,11,NA,NA,NA,NA,NA,NA,NA,NA,"","","a5c6f8a22086b58fb50b8deb0e2720e835c9db52","2020-03-08T20:00:00Z",NA,NA,11,11,11,30,0,0,0,0,0
"4525",20200308,"NC",2,NA,NA,NA,NA,NA,NA,NA,NA,NA,"","","c56e8a8ce34107a07d0f172c1aef704fc63fd2d6","2020-03-08T20:00:00Z",NA,NA,2,2,2,37,0,0,0,0,0
"4526",20200308,"ND",0,0,NA,NA,NA,NA,NA,NA,NA,NA,"","","97b4ec337606cb0c007c83e239e2423501d6e9fc","2020-03-08T20:00:00Z",NA,NA,0,0,0,38,0,0,0,0,0
"4527",20200308,"NE",1,17,5,NA,NA,NA,NA,NA,NA,NA,"","","4abc76fe92b57a5ca22a4a9cc44eb3e10b8536c4","2020-03-08T20:00:00Z",NA,NA,23,18,18,31,0,0,0,0,0
"4528",20200308,"NH",4,38,5,NA,NA,NA,NA,NA,NA,NA,"","","e446f431c1e396669b38931c08c5675f38727c82","2020-03-08T20:00:00Z",NA,NA,47,42,42,33,0,0,18,2,20
"4529",20200308,"NJ",6,31,0,NA,NA,NA,NA,NA,NA,NA,"","","a883188c8540b90101e8194970d91f8635c0045b","2020-03-08T20:00:00Z",NA,NA,37,37,37,34,0,0,31,2,33
"4530",20200308,"NM",0,48,0,NA,NA,NA,NA,NA,NA,NA,"","","932f7b01ed175adfe7533762e661dac4314e538b","2020-03-08T20:00:00Z",NA,NA,48,48,48,35,0,0,0,0,0
"4531",20200308,"NV",1,14,NA,NA,NA,NA,NA,NA,NA,NA,"","","ec3ae86bb05bdaa622f016c7a41bdf6ca23b6d30","2020-03-08T20:00:00Z",NA,NA,15,15,15,32,0,0,0,0,0
"4532",20200308,"NY",105,92,NA,NA,NA,NA,NA,NA,NA,NA,"","","d5e8dc460e38951e9c4ed83ea6116f3d1ef964e9","2020-03-08T20:00:00Z",NA,NA,197,197,197,36,0,0,0,29,29
"4533",20200308,"OH",0,10,4,NA,NA,NA,NA,NA,NA,NA,"","","7e96c001631c8cd5e22fa14d37cfb456d3e0288f","2020-03-08T20:00:00Z",NA,NA,14,10,10,39,0,0,1,0,1
"4534",20200308,"OK",1,8,2,NA,NA,NA,NA,NA,NA,NA,"","","924a45bae75321c8d772ec5cf95374daa4e3f36c","2020-03-08T20:00:00Z",NA,NA,11,9,9,40,0,0,8,0,8
"4535",20200308,"OR",14,100,53,NA,NA,NA,NA,NA,NA,NA,"","","8cb87639adfd052a620ef024dbfdba4ce37850dd","2020-03-08T20:00:00Z",NA,NA,167,114,114,41,0,0,23,7,30
"4536",20200308,"PA",6,NA,NA,NA,NA,NA,NA,NA,NA,NA,"","","024f7678b7ba386ef3db12d5d2cff80b0a096097","2020-03-08T20:00:00Z",NA,NA,6,6,6,42,0,0,0,2,2
"4537",20200308,"RI",3,30,12,NA,NA,NA,NA,NA,NA,NA,"","","8a61432a89cb8ee366a6f31c0552938ccd45f234","2020-03-08T20:00:00Z",NA,NA,45,33,33,44,0,0,0,1,1
"4538",20200308,"SC",2,8,NA,NA,NA,NA,NA,NA,NA,NA,"","","6282293c5005c6e64adfe7c6c43fe80237a9b58f","2020-03-08T20:00:00Z",NA,NA,10,10,10,45,0,0,0,0,0
"4539",20200308,"SD",0,5,0,NA,NA,NA,NA,NA,NA,NA,"","","847d91d10e9b651b7fde11dfab0e1cd40ea3b24f","2020-03-08T20:00:00Z",NA,NA,5,5,5,46,0,0,0,0,0
"4540",20200308,"TN",3,NA,NA,NA,NA,NA,NA,NA,NA,NA,"","","84012fc684aa24edacbcf7048cf2fe352374c9a8","2020-03-08T20:00:00Z",NA,NA,3,3,3,47,0,0,0,2,2
"4541",20200308,"TX",8,NA,NA,NA,NA,NA,NA,NA,NA,NA,"","","7b7ff681a1cb8859cd033406312dd877625949cc","2020-03-08T20:00:00Z",NA,NA,8,8,8,48,0,0,0,0,0
"4542",20200308,"UT",1,NA,NA,NA,NA,NA,NA,NA,NA,NA,"","","aca21610710d71183f28850e9c4a09901e7c89a7","2020-03-08T20:00:00Z",NA,NA,1,1,1,49,0,0,0,0,0
"4543",20200308,"VA",2,36,6,NA,NA,NA,NA,NA,NA,NA,"","","25c7c86566b6b73735ff2f01affe1efda76f9c02","2020-03-08T20:00:00Z",NA,NA,44,38,38,51,0,0,5,2,7
"4544",20200308,"VT",1,30,NA,NA,NA,NA,NA,NA,NA,NA,"","3/8/2020 00:00","6e49773277f7164d05be35a80a55c8eaefa0d739","2020-03-08T20:00:00Z",NA,NA,31,31,31,50,0,0,5,0,5
"4545",20200308,"WA",317,2208,60,NA,NA,NA,NA,NA,NA,NA,"","3/8/2020 00:00","2213b44ea634d1773077d3e54708eba10e353a87","2020-03-08T20:00:00Z",31,NA,2585,2525,2525,53,4,0,462,61,523
"4546",20200308,"WI",1,31,12,NA,NA,NA,NA,NA,NA,NA,"","","416e23670e5b1cdcdf19c947fd91477903e4d014","2020-03-08T20:00:00Z",NA,NA,44,32,32,55,0,0,0,0,0
"4547",20200308,"WV",0,2,3,NA,NA,NA,NA,NA,NA,NA,"","","23d551d0036a7850fae4acd1fadafa18db6e9938","2020-03-08T20:00:00Z",NA,NA,5,2,2,54,0,0,0,0,0
"4548",20200308,"WY",0,NA,NA,NA,NA,NA,NA,NA,NA,NA,"","","f34722fad92d14f0b2aeb3647935ec142ce30a4c","2020-03-08T20:00:00Z",NA,NA,0,0,0,56,0,0,0,0,0
"4549",20200307,"AK",0,12,2,NA,NA,NA,NA,NA,NA,NA,"","","dc09f2d4469f39130b5a0ecbfa19b60ef5857480","2020-03-07T21:00:00Z",0,NA,14,12,12,2,0,0,4,0,4
"4550",20200307,"AL",0,NA,NA,NA,NA,NA,NA,NA,NA,NA,"","","b7229e74444e63e1bf4c7acf02ecd69fd3f2d44f","2020-03-07T21:00:00Z",NA,NA,0,0,0,1,NA,NA,NA,NA,NA
"4551",20200307,"AR",0,6,0,NA,NA,NA,NA,NA,NA,NA,"","","734900f24a21b559b28afbb315dfe8dc42bb4eb6","2020-03-07T21:00:00Z",NA,NA,6,6,6,5,0,0,0,0,0
"4552",20200307,"AZ",5,44,7,NA,NA,NA,NA,NA,NA,NA,"","","61c59593799d19e4e92b6ca87984aaf35bb1159e","2020-03-07T21:00:00Z",NA,NA,56,49,49,4,0,0,11,2,13
"4553",20200307,"CA",69,462,NA,NA,NA,NA,NA,NA,NA,NA,"","","e233a4c19e477fd4f7bcf450c3a73790f87a5680","2020-03-07T21:00:00Z",NA,NA,531,531,531,6,0,0,0,9,9
"4554",20200307,"CO",8,55,69,NA,NA,NA,NA,NA,NA,NA,"","","52e0ae0b9b943a8199565c17fdd422a91bc0162d","2020-03-07T21:00:00Z",NA,NA,132,63,63,8,0,0,9,6,15
"4555",20200307,"CT",0,NA,NA,NA,NA,NA,NA,NA,NA,NA,"","","2f09a532955d32bd664bac2729c875dda06ecd30","2020-03-07T21:00:00Z",NA,NA,0,0,0,9,NA,NA,NA,NA,NA
"4556",20200307,"DC",0,8,1,NA,NA,NA,NA,NA,NA,NA,"","","625498f528c86ac63a9d6f58348739aa95c1f201","2020-03-07T21:00:00Z",NA,NA,9,8,8,11,0,0,0,0,0
"4557",20200307,"DE",0,10,0,NA,NA,NA,NA,NA,NA,NA,"","","2a4904083f3c5d06e34971c48e2dc95d2034d4b7","2020-03-07T21:00:00Z",NA,NA,10,10,10,10,0,0,0,0,0
"4558",20200307,"FL",14,100,88,NA,NA,NA,NA,NA,NA,NA,"","","78b1ecd25b46274b2fb969cd705c9ce078f24642","2020-03-07T21:00:00Z",NA,NA,202,114,114,12,0,0,45,5,50
"4559",20200307,"GA",6,NA,NA,NA,NA,NA,NA,NA,NA,NA,"","","ff812a8ca7c6b59e1ad8cbbed8f7479e0952c55f","2020-03-07T21:00:00Z",NA,NA,6,6,6,13,0,0,0,4,4
"4560",20200307,"HI",1,NA,NA,NA,NA,NA,NA,NA,NA,NA,"","","2ee6cf94f78c08eb4424f7230dfe68c21aa2ebe8","2020-03-07T21:00:00Z",NA,NA,1,1,1,15,NA,NA,NA,NA,NA
"4561",20200307,"IA",0,15,2,NA,NA,NA,NA,NA,NA,NA,"","","89cf92a8e0405889858783ea6b57ebc820c4b026","2020-03-07T21:00:00Z",NA,NA,17,15,15,19,0,0,0,0,0
"4562",20200307,"ID",0,27,NA,NA,NA,NA,NA,NA,NA,NA,"","","0bf2b8edd7255d08414ebd685e078de7e1ec37d8","2020-03-07T21:00:00Z",NA,NA,27,27,27,16,NA,NA,NA,NA,NA
"4563",20200307,"IL",6,191,44,NA,NA,NA,NA,NA,NA,NA,"","","3e201a16e027059f8d3be49bd6e844e95e481780","2020-03-07T21:00:00Z",NA,NA,241,197,197,17,0,0,11,1,12
"4564",20200307,"IN",1,NA,NA,NA,NA,NA,NA,NA,NA,NA,"","","191980e05e1e2589713f548f53686748c05d9711","2020-03-07T21:00:00Z",NA,NA,1,1,1,18,0,0,0,0,0
"4565",20200307,"KS",0,11,2,NA,NA,NA,NA,NA,NA,NA,"","","b6565e5de52f29c2a932405afa210c5fe0449ac2","2020-03-07T21:00:00Z",NA,NA,13,11,11,20,0,0,7,0,7
"4566",20200307,"KY",1,9,NA,NA,NA,NA,NA,NA,NA,NA,"","","89643393d479c1d4f9b22201bf9374f983538c5c","2020-03-07T21:00:00Z",NA,NA,10,10,10,21,0,0,2,1,3
"4567",20200307,"LA",0,NA,NA,NA,NA,NA,NA,NA,NA,NA,"","","7d07dd36414e2fc61fb9a73c7a06cc8447db3530","2020-03-07T21:00:00Z",NA,NA,0,0,0,22,NA,NA,NA,NA,NA
"4568",20200307,"MD",3,41,NA,NA,NA,NA,NA,NA,NA,NA,"","","0c20b23be3f19a6682068932991fedc37dd7067a","2020-03-07T21:00:00Z",NA,NA,44,44,44,24,0,0,15,0,15
"4569",20200307,"ME",0,1,NA,NA,NA,NA,NA,NA,NA,NA,"","","afeaee168d226837676a11a7aca8114cb50f864b","2020-03-07T21:00:00Z",NA,NA,1,1,1,23,NA,NA,NA,NA,NA
"4570",20200307,"MI",128,18,9,NA,NA,NA,NA,NA,NA,NA,"","","2f6cb47591f067a90241ecadcc014a4e07df57d2","2020-03-07T21:00:00Z",NA,NA,155,146,146,26,0,0,10,30,40
"4571",20200307,"MN",1,48,NA,NA,NA,NA,NA,NA,NA,NA,"","","0dcf33b4923666ce04eb228497ee56d2206ad2d7","2020-03-07T21:00:00Z",NA,NA,49,49,49,27,0,0,12,1,13
"4572",20200307,"MO",0,NA,NA,NA,NA,NA,NA,NA,NA,NA,"","","e33e1d45dd81ff303affa23c8eef9cd21b248f5f","2020-03-07T21:00:00Z",NA,NA,0,0,0,29,NA,NA,NA,NA,NA
"4573",20200307,"MS",0,NA,NA,NA,NA,NA,NA,NA,NA,NA,"","","40dea4d35d2040a06761e09b925181e8adf39c86","2020-03-07T21:00:00Z",NA,NA,0,0,0,28,NA,NA,NA,NA,NA
"4574",20200307,"MT",0,11,NA,NA,NA,NA,NA,NA,NA,NA,"","","349b051740ecea1fa29094692e6362c54bffde25","2020-03-07T21:00:00Z",NA,NA,11,11,11,30,NA,NA,NA,NA,NA
"4575",20200307,"NC",2,NA,NA,NA,NA,NA,NA,NA,NA,NA,"","","93461a3ca9a1af26be01f4545b04ae1bccacd4e4","2020-03-07T21:00:00Z",NA,NA,2,2,2,37,0,0,0,0,0
"4576",20200307,"ND",0,0,NA,NA,NA,NA,NA,NA,NA,NA,"","","8d295a105c5096f6ad7d6b54ad041a5f581c0c75","2020-03-07T21:00:00Z",NA,NA,0,0,0,38,NA,NA,NA,NA,NA
"4577",20200307,"NE",1,17,5,NA,NA,NA,NA,NA,NA,NA,"","","59f574e17c5d499448ef13332a96c79a5dd9dc4a","2020-03-07T21:00:00Z",NA,NA,23,18,18,31,0,0,0,1,1
"4578",20200307,"NH",2,20,3,NA,NA,NA,NA,NA,NA,NA,"","","1b5f43397f84d6acc68d8c0d82fa50018168f06f","2020-03-07T21:00:00Z",NA,NA,25,22,22,33,0,0,0,0,0
"4579",20200307,"NJ",4,NA,1,NA,NA,NA,NA,NA,NA,NA,"","","f9f434b0dd27b6c1b26acd9ad561bdefd0b38df0","2020-03-07T21:00:00Z",NA,NA,5,4,4,34,0,0,0,3,3
"4580",20200307,"NM",0,48,0,NA,NA,NA,NA,NA,NA,NA,"","","4ace6733958491a30cb32f07d8ba715aa24a9bac","2020-03-07T21:00:00Z",NA,NA,48,48,48,35,0,0,32,0,32
"4581",20200307,"NV",1,14,NA,NA,NA,NA,NA,NA,NA,NA,"","","21f61d85dbb166b2528c70c1a2b3e726846945c9","2020-03-07T21:00:00Z",NA,NA,15,15,15,32,0,0,0,0,0
"4582",20200307,"NY",76,92,236,NA,NA,NA,NA,NA,NA,NA,"","","4cc604c6ed1a38fd0eac5f9526682d5eb68a6b96","2020-03-07T21:00:00Z",NA,NA,404,168,168,36,0,0,0,43,43
"4583",20200307,"OH",0,9,5,NA,NA,NA,NA,NA,NA,NA,"","","d5faabefafefb9ad659d49f395c57e30cf9fe9c3","2020-03-07T21:00:00Z",NA,NA,14,9,9,39,0,0,1,0,1
"4584",20200307,"OK",1,NA,NA,NA,NA,NA,NA,NA,NA,NA,"","","ef50aa38dd0f9cb294fe6cfef9797134aaf15bcb","2020-03-07T21:00:00Z",NA,NA,1,1,1,40,NA,NA,NA,NA,NA
"4585",20200307,"OR",7,77,40,NA,NA,NA,NA,NA,NA,NA,"","","621f6ebb4cd33d642301e2298173d3db7c507dbd","2020-03-07T21:00:00Z",NA,NA,124,84,84,41,0,0,13,4,17
"4586",20200307,"PA",4,NA,NA,NA,NA,NA,NA,NA,NA,NA,"","","358ccf1927a2d3976020a2cc1ca6669f5987023b","2020-03-07T21:00:00Z",NA,NA,4,4,4,42,0,0,0,2,2
"4587",20200307,"RI",2,30,NA,NA,NA,NA,NA,NA,NA,NA,"","","bd42f0883d970f1d66a5cb4011769a21736f640c","2020-03-07T21:00:00Z",NA,NA,32,32,32,44,0,0,13,-1,12
"4588",20200307,"SC",2,8,NA,NA,NA,NA,NA,NA,NA,NA,"","","d342d6e7dfb7888c27f82d50ff67ebf73713c166","2020-03-07T21:00:00Z",NA,NA,10,10,10,45,0,0,3,2,5
"4589",20200307,"SD",0,5,0,NA,NA,NA,NA,NA,NA,NA,"","","114e4f8c3e43256bd84142fe8553272b432738ae","2020-03-07T21:00:00Z",NA,NA,5,5,5,46,NA,NA,NA,NA,NA
"4590",20200307,"TN",1,NA,NA,NA,NA,NA,NA,NA,NA,NA,"","","295af9c9f94bbd15e48bd76f6d5df4054f43632c","2020-03-07T21:00:00Z",NA,NA,1,1,1,47,0,0,0,0,0
"4591",20200307,"TX",8,NA,NA,NA,NA,NA,NA,NA,NA,NA,"","","6f1d6b5cca3d79a52466dd2371baee6aa137ca72","2020-03-07T21:00:00Z",NA,NA,8,8,8,48,0,0,0,3,3
"4592",20200307,"UT",1,NA,NA,NA,NA,NA,NA,NA,NA,NA,"","","b2de542338594c9200868fcb319a20835811ae26","2020-03-07T21:00:00Z",NA,NA,1,1,1,49,NA,NA,NA,NA,NA
"4593",20200307,"VA",0,31,7,NA,NA,NA,NA,NA,NA,NA,"","","f57f02f3b488f662a1da12fae886280d7a6725c0","2020-03-07T21:00:00Z",NA,NA,38,31,31,51,0,0,10,0,10
"4594",20200307,"VT",1,25,NA,NA,NA,NA,NA,NA,NA,NA,"","3/7/2020 00:00","865a5514af25d155ed502a720a07819dbc019255","2020-03-07T21:00:00Z",NA,NA,26,26,26,50,0,0,25,1,26
"4595",20200307,"WA",256,1746,66,NA,NA,NA,NA,NA,NA,NA,"","3/7/2020 00:00","d07cf12b2a5433d074f2154306225deb6991f076","2020-03-07T21:00:00Z",27,NA,2068,2002,2002,53,1,0,367,38,405
"4596",20200307,"WI",1,31,12,NA,NA,NA,NA,NA,NA,NA,"","","7fb53bd86152b81a94d0f23175e632ab8ca55c8a","2020-03-07T21:00:00Z",NA,NA,44,32,32,55,0,0,0,0,0
"4597",20200307,"WV",0,2,3,NA,NA,NA,NA,NA,NA,NA,"","","2ce3c48268517c6a16ed1e6ffaf4532f2a8e00e7","2020-03-07T21:00:00Z",NA,NA,5,2,2,54,0,0,1,0,1
"4598",20200307,"WY",0,NA,NA,NA,NA,NA,NA,NA,NA,NA,"","","70465374deb70fa7e688ec57a6014d9f884bc06a","2020-03-07T21:00:00Z",NA,NA,0,0,0,56,NA,NA,NA,NA,NA
"4599",20200306,"AK",0,8,1,NA,NA,NA,NA,NA,NA,NA,"","","f84bd2a87b65a5dbf74e4e21d6162ef74c26d1ab","2020-03-06T21:00:00Z",0,NA,9,8,8,2,NA,NA,NA,NA,NA
"4600",20200306,"AR",0,6,0,NA,NA,NA,NA,NA,NA,NA,"","","bf45b38cc58815dd2725a8343da007be2062ed3f","2020-03-06T21:00:00Z",NA,NA,6,6,6,5,NA,NA,NA,NA,NA
"4601",20200306,"AZ",3,33,15,NA,NA,NA,NA,NA,NA,NA,"","","b3aa46dca9bcbc583984646aaf51c908609413de","2020-03-06T21:00:00Z",NA,NA,51,36,36,4,0,0,5,1,6
"4602",20200306,"CA",60,462,NA,NA,NA,NA,NA,NA,NA,NA,"","","0bb79dc4f15a1eb8575ec0ca84b4e6b1f801756f","2020-03-06T21:00:00Z",NA,NA,522,522,522,6,0,0,0,7,7
"4603",20200306,"CO",2,46,30,NA,NA,NA,NA,NA,NA,NA,"","","b3d2fdf73afc502a22c747b9ac6ad62fb48f732c","2020-03-06T21:00:00Z",NA,NA,78,48,48,8,0,0,27,2,29
"4604",20200306,"DC",0,8,1,NA,NA,NA,NA,NA,NA,NA,"","","c66fa751e4187703cfa5804cf1bb65cfaa006c60","2020-03-06T21:00:00Z",NA,NA,9,8,8,11,0,0,2,0,2
"4605",20200306,"DE",0,10,0,NA,NA,NA,NA,NA,NA,NA,"","","4837103cbe437f027aa75ec8b86a6d01e323e08a","2020-03-06T21:00:00Z",NA,NA,10,10,10,10,NA,NA,NA,NA,NA
"4606",20200306,"FL",9,55,51,NA,NA,NA,NA,NA,NA,NA,"","","6b75ea058687eb6f8643e53e3f75f8739b986534","2020-03-06T21:00:00Z",NA,NA,115,64,64,12,0,0,24,0,24
"4607",20200306,"GA",2,NA,NA,NA,NA,NA,NA,NA,NA,NA,"","","6c3aa0a20f9b02db48845fd1c0ecb9cc13a0aca0","2020-03-06T21:00:00Z",NA,NA,2,2,2,13,0,0,0,0,0
"4608",20200306,"IA",0,15,2,NA,NA,NA,NA,NA,NA,NA,"","","5d24d17b9892cda7e5d7d7f6e5f63c84ec763546","2020-03-06T21:00:00Z",NA,NA,17,15,15,19,NA,NA,NA,NA,NA
"4609",20200306,"IL",5,180,35,NA,NA,NA,NA,NA,NA,NA,"","","aefb5dd0fb4dbe0d96e672bd50ed1334e39bf71f","2020-03-06T21:00:00Z",NA,NA,220,185,185,17,0,0,15,0,15
"4610",20200306,"IN",1,NA,NA,NA,NA,NA,NA,NA,NA,NA,"","","f8579a8ab1c335a0a01b06ee9e40dedce5e346ef","2020-03-06T21:00:00Z",NA,NA,1,1,1,18,NA,NA,NA,NA,NA
"4611",20200306,"KS",0,4,0,NA,NA,NA,NA,NA,NA,NA,"","","043a41366454b33e5ea110d7b997b8f21cfff928","2020-03-06T21:00:00Z",NA,NA,4,4,4,20,NA,NA,NA,NA,NA
"4612",20200306,"KY",0,7,3,NA,NA,NA,NA,NA,NA,NA,"","","2c997ac3a43d91e37583346c0d64bcf428958298","2020-03-06T21:00:00Z",NA,NA,10,7,7,21,NA,NA,NA,NA,NA
"4613",20200306,"MD",3,26,12,NA,NA,NA,NA,NA,NA,NA,"","","a4122db6651a784e6386395db74ff158427569b9","2020-03-06T21:00:00Z",NA,NA,41,29,29,24,0,0,9,3,12
"4614",20200306,"MI",98,8,8,NA,NA,NA,NA,NA,NA,NA,"","","cf7574b935cf64ed2da4920f61015c16e3e7752f","2020-03-06T21:00:00Z",NA,NA,114,106,106,26,0,0,0,26,26
"4615",20200306,"MN",0,36,NA,NA,NA,NA,NA,NA,NA,NA,"","","3f99c55624ce49a84bd26e05225c3c7da95c303f","2020-03-06T21:00:00Z",NA,NA,36,36,36,27,NA,NA,NA,NA,NA
"4616",20200306,"NC",2,NA,NA,NA,NA,NA,NA,NA,NA,NA,"","","76b370143afbf8a55b52fba203cb806bd7ea5abf","2020-03-06T21:00:00Z",NA,NA,2,2,2,37,0,0,0,1,1
"4617",20200306,"NE",0,17,5,NA,NA,NA,NA,NA,NA,NA,"","","4da4aa1917093700e076592f71964a143da1f0a6","2020-03-06T21:00:00Z",NA,NA,22,17,17,31,0,0,0,0,0
"4618",20200306,"NH",2,20,3,NA,NA,NA,NA,NA,NA,NA,"","","d68d89a7bae5125de1462192e799c357f3ca5e1c","2020-03-06T21:00:00Z",NA,NA,25,22,22,33,0,0,4,0,4
"4619",20200306,"NJ",1,NA,NA,NA,NA,NA,NA,NA,NA,NA,"","","bab7daac1ddebe5a0f49e05738b02a4283889af3","2020-03-06T21:00:00Z",NA,NA,1,1,1,34,0,0,0,0,0
"4620",20200306,"NM",0,16,0,NA,NA,NA,NA,NA,NA,NA,"","","4a5936fa06b30f2cfec504eea1a5c3a5e43bdc99","2020-03-06T21:00:00Z",NA,NA,16,16,16,35,NA,NA,NA,NA,NA
"4621",20200306,"NV",1,14,NA,NA,NA,NA,NA,NA,NA,NA,"","","22766bb1621325fedc23d37400659fb20577e245","2020-03-06T21:00:00Z",NA,NA,15,15,15,32,0,0,0,0,0
"4622",20200306,"NY",33,92,236,NA,NA,NA,NA,NA,NA,NA,"","","a4269189c0f37537baee7e4fd80167aa7237fa7e","2020-03-06T21:00:00Z",NA,NA,361,125,125,36,0,0,16,11,27
"4623",20200306,"OH",0,8,2,NA,NA,NA,NA,NA,NA,NA,"","","381b4ac05cf9c9e9b11df2790badd5a3ce445f99","2020-03-06T21:00:00Z",NA,NA,10,8,8,39,0,0,1,0,1
"4624",20200306,"OR",3,64,28,NA,NA,NA,NA,NA,NA,NA,"","","b4194ac3c360c03d1042fc1b6fe3d55acfc579ec","2020-03-06T21:00:00Z",NA,NA,95,67,67,41,0,0,19,0,19
"4625",20200306,"PA",2,NA,NA,NA,NA,NA,NA,NA,NA,NA,"","","76fdd2be8ba3baed7c28d19260169f85c79cba55","2020-03-06T21:00:00Z",NA,NA,2,2,2,42,NA,NA,NA,NA,NA
"4626",20200306,"RI",3,17,NA,NA,NA,NA,NA,NA,NA,NA,"","","3044928061ca806a3ba5285d03c8a41ccdbba4db","2020-03-06T21:00:00Z",NA,NA,20,20,20,44,0,0,0,1,1
"4627",20200306,"SC",0,5,NA,NA,NA,NA,NA,NA,NA,NA,"","","717d2fb0a3b3819a0b36edd41aacf1c8e965b529","2020-03-06T21:00:00Z",NA,NA,5,5,5,45,0,0,0,0,0
"4628",20200306,"TN",1,NA,NA,NA,NA,NA,NA,NA,NA,NA,"","","871f71ee9dc8f32c817b68b2990dbb0d47598e7a","2020-03-06T21:00:00Z",NA,NA,1,1,1,47,0,0,0,0,0
"4629",20200306,"TX",5,NA,NA,NA,NA,NA,NA,NA,NA,NA,"","","ed908d3a1d66ac92c0d1c0ef6c35fa2240318f4c","2020-03-06T21:00:00Z",NA,NA,5,5,5,48,0,0,0,4,4
"4630",20200306,"VA",0,21,10,NA,NA,NA,NA,NA,NA,NA,"","","a37f4ab43acf50fb833c15616bc1653115833851","2020-03-06T21:00:00Z",NA,NA,31,21,21,51,0,0,3,0,3
"4631",20200306,"VT",0,0,NA,NA,NA,NA,NA,NA,NA,NA,"","3/6/2020 00:00","e869bee6400919dc636a15ee8147612931ccdfa7","2020-03-06T21:00:00Z",NA,NA,0,0,0,50,NA,NA,NA,NA,NA
"4632",20200306,"WA",218,1379,NA,NA,NA,NA,NA,NA,NA,NA,"","3/6/2020 00:00","551798555aca0477715289795d1fae8c39cc1275","2020-03-06T21:00:00Z",26,NA,1597,1597,1597,53,6,0,435,39,474
"4633",20200306,"WI",1,31,12,NA,NA,NA,NA,NA,NA,NA,"","","84cdaa589e61cd0a42543df50385ae8b5226296a","2020-03-06T21:00:00Z",NA,NA,44,32,32,55,0,0,12,0,12
"4634",20200306,"WV",0,1,4,NA,NA,NA,NA,NA,NA,NA,"","","af1a54e43d59e8b207a190e767fbf8d803f58bdf","2020-03-06T21:00:00Z",NA,NA,5,1,1,54,NA,NA,NA,NA,NA
"4635",20200305,"AZ",2,28,6,NA,NA,NA,NA,NA,NA,NA,"","","c87d6d5ea43957a2cd8958ee222c2778276682a2","2020-03-05T21:00:00Z",NA,NA,36,30,30,4,0,0,1,0,1
"4636",20200305,"CA",53,462,NA,NA,NA,NA,NA,NA,NA,NA,"","","29660d4104d8a82ef4d69e5359cc586629d587ef","2020-03-05T21:00:00Z",NA,NA,515,515,515,6,0,0,0,0,0
"4637",20200305,"CO",0,19,21,NA,NA,NA,NA,NA,NA,NA,"","","2624823cd4f6fe855e1175557d8f0d7f2600c1cc","2020-03-05T21:00:00Z",NA,NA,40,19,19,8,NA,NA,NA,NA,NA
"4638",20200305,"DC",0,6,2,NA,NA,NA,NA,NA,NA,NA,"","","abf10dfd297bfa25aa2c3aaaa4577a1a92b684b1","2020-03-05T21:00:00Z",NA,NA,8,6,6,11,NA,NA,NA,NA,NA
"4639",20200305,"FL",9,31,69,NA,NA,NA,NA,NA,NA,NA,"","","be40a4f79a747d11e86a789e72624d9fb7e87651","2020-03-05T21:00:00Z",NA,NA,109,40,40,12,0,0,7,7,14
"4640",20200305,"GA",2,NA,NA,NA,NA,NA,NA,NA,NA,NA,"","","e29aedce13f22c232241760cf4102cd7031bff56","2020-03-05T21:00:00Z",NA,NA,2,2,2,13,0,0,0,0,0
"4641",20200305,"IL",5,165,27,NA,NA,NA,NA,NA,NA,NA,"","","52ad35bdf8d9cfe96f12d24fa265e523d7287785","2020-03-05T21:00:00Z",NA,NA,197,170,170,17,0,0,41,1,42
"4642",20200305,"MD",0,17,14,NA,NA,NA,NA,NA,NA,NA,"","","85fa1a3fe9701ca65cb1541f48b9113f4072c654","2020-03-05T21:00:00Z",NA,NA,31,17,17,24,NA,NA,NA,NA,NA
"4643",20200305,"MI",72,8,0,NA,NA,NA,NA,NA,NA,NA,"","","63da318bb6edb4505ec09639b6162218c96702a2","2020-03-05T21:00:00Z",NA,NA,80,80,80,26,0,0,8,20,28
"4644",20200305,"NC",1,NA,NA,NA,NA,NA,NA,NA,NA,NA,"","","617c543b5123f7c3799ae001f61986ced141caa0","2020-03-05T21:00:00Z",NA,NA,1,1,1,37,0,0,0,0,0
"4645",20200305,"NE",0,17,5,NA,NA,NA,NA,NA,NA,NA,"","","78fdecb8b138d96a697d162fdab1f17ed2a654a2","2020-03-05T21:00:00Z",NA,NA,22,17,17,31,NA,NA,NA,NA,NA
"4646",20200305,"NH",2,16,4,NA,NA,NA,NA,NA,NA,NA,"","","f583e0349115a83f612799f6a9de5cc96c63609c","2020-03-05T21:00:00Z",NA,NA,22,18,18,33,0,0,6,0,6
"4647",20200305,"NJ",1,NA,NA,NA,NA,NA,NA,NA,NA,NA,"","","69bcab169ca4ab08ad22162b4d96c297f77857f4","2020-03-05T21:00:00Z",NA,NA,1,1,1,34,NA,NA,NA,NA,NA
"4648",20200305,"NV",1,14,NA,NA,NA,NA,NA,NA,NA,NA,"","","22715b4a4714c5578e8c754efce40ee572260a8d","2020-03-05T21:00:00Z",NA,NA,15,15,15,32,NA,NA,NA,NA,NA
"4649",20200305,"NY",22,76,24,NA,NA,NA,NA,NA,NA,NA,"","","f5fa9d458bf8fb40664458e2710437c5e5a89aaf","2020-03-05T21:00:00Z",NA,NA,122,98,98,36,0,0,28,16,44
"4650",20200305,"OH",0,7,3,NA,NA,NA,NA,NA,NA,NA,"","","29c0768399eb917222bece81ac7fd820319c81ba","2020-03-05T21:00:00Z",NA,NA,10,7,7,39,NA,NA,NA,NA,NA
"4651",20200305,"OR",3,45,13,NA,NA,NA,NA,NA,NA,NA,"","","b4d76ee38f86a421639c3e8a96d0dd5cf8013fbb","2020-03-05T21:00:00Z",NA,NA,61,48,48,41,0,0,16,0,16
"4652",20200305,"RI",2,17,NA,NA,NA,NA,NA,NA,NA,NA,"","","be60d675a2a6f0854da54d7eb735dcfdf01ee0f5","2020-03-05T21:00:00Z",NA,NA,19,19,19,44,0,0,6,0,6
"4653",20200305,"SC",0,5,NA,NA,NA,NA,NA,NA,NA,NA,"","","da8785eac11bfc847a62da7830707fcb73eeaf2c","2020-03-05T21:00:00Z",NA,NA,5,5,5,45,0,0,0,0,0
"4654",20200305,"TN",1,NA,NA,NA,NA,NA,NA,NA,NA,NA,"","","4b1a83a6240dc10f7ba70b346bac53114f3c9404","2020-03-05T21:00:00Z",NA,NA,1,1,1,47,NA,NA,NA,NA,NA
"4655",20200305,"TX",1,NA,NA,NA,NA,NA,NA,NA,NA,NA,"","","28da5dda553a784e6fc042af8ae84b8a273e51b0","2020-03-05T21:00:00Z",NA,NA,1,1,1,48,0,0,0,0,0
"4656",20200305,"VA",0,18,3,NA,NA,NA,NA,NA,NA,NA,"","","dc40dd5c7d0be5cc62e4bb9e6a957cce674f70cd","2020-03-05T21:00:00Z",NA,NA,21,18,18,51,NA,NA,NA,NA,NA
"4657",20200305,"WA",179,944,NA,NA,NA,NA,NA,NA,NA,NA,"","3/5/2020 00:00","a91d8b2943361ac4121b37bb350110831482f24f","2020-03-05T21:00:00Z",20,NA,1123,1123,1123,53,4,0,311,51,362
"4658",20200305,"WI",1,19,6,NA,NA,NA,NA,NA,NA,NA,"","","345fe70cd769ce188677fc5c9d9999d447c6e006","2020-03-05T21:00:00Z",NA,NA,26,20,20,55,0,0,0,0,0
"4659",20200304,"AZ",2,27,5,NA,NA,NA,NA,NA,NA,NA,"","","31eac9d068b131adfdece3071661e7ce77d4bb6d","2020-03-04T21:00:00Z",NA,NA,34,29,29,4,NA,NA,NA,NA,NA
"4660",20200304,"CA",53,462,NA,NA,NA,NA,NA,NA,NA,NA,"","","4a075d5c57bdb3c2b68cdc0024a0f5c14b77cb67","2020-03-04T21:00:00Z",NA,NA,515,515,515,6,NA,NA,NA,NA,NA
"4661",20200304,"FL",2,24,16,NA,NA,NA,NA,NA,NA,NA,"","","4a35e4c46f23402dcdc6bf216f34d0a541398420","2020-03-04T21:00:00Z",NA,NA,42,26,26,12,NA,NA,NA,NA,NA
"4662",20200304,"GA",2,NA,NA,NA,NA,NA,NA,NA,NA,NA,"","","48907991a8aa8649a5af7d42f420ebff2edf484c","2020-03-04T21:00:00Z",NA,NA,2,2,2,13,NA,NA,NA,NA,NA
"4663",20200304,"IL",4,124,27,NA,NA,NA,NA,NA,NA,NA,"","","1f4666a02ed2c20f3501329a11f21dd241c9f440","2020-03-04T21:00:00Z",NA,NA,155,128,128,17,NA,NA,NA,NA,NA
"4664",20200304,"MI",52,NA,NA,NA,NA,NA,NA,NA,NA,NA,"","","7450e2ddfe6040869d0eb1f53d62b1394e8420e3","2020-03-04T21:00:00Z",NA,NA,52,52,52,26,0,0,0,18,18
"4665",20200304,"NC",1,NA,NA,NA,NA,NA,NA,NA,NA,NA,"","","d8fbccf4201c099f09e0f4eb0dc3ac8efc3960d0","2020-03-04T21:00:00Z",NA,NA,1,1,1,37,NA,NA,NA,NA,NA
"4666",20200304,"NH",2,10,7,NA,NA,NA,NA,NA,NA,NA,"","","fa607ecdd159feac0bac39d9b098bf1b400130f7","2020-03-04T21:00:00Z",NA,NA,19,12,12,33,NA,NA,NA,NA,NA
"4667",20200304,"NY",6,48,24,NA,NA,NA,NA,NA,NA,NA,"","","3662a819d9896d5c0e253b9738b4d6160e0f9f4d","2020-03-04T21:00:00Z",NA,NA,78,54,54,36,NA,NA,NA,NA,NA
"4668",20200304,"OR",3,29,18,NA,NA,NA,NA,NA,NA,NA,"","","e17f49c9a097c9a3311bfb27c58e642343493148","2020-03-04T21:00:00Z",NA,NA,50,32,32,41,NA,NA,NA,NA,NA
"4669",20200304,"RI",2,11,NA,NA,NA,NA,NA,NA,NA,NA,"","","550dafb36925904ea374620f86cfa92c948777c5","2020-03-04T21:00:00Z",NA,NA,13,13,13,44,0,0,5,0,5
"4670",20200304,"SC",0,5,NA,NA,NA,NA,NA,NA,NA,NA,"","","13b66aaf5024719271ff3c749705be58cc1e7105","2020-03-04T21:00:00Z",NA,NA,5,5,5,45,NA,NA,NA,NA,NA
"4671",20200304,"TX",1,NA,NA,NA,NA,NA,NA,NA,NA,NA,"","","475388a7b62cf53115b57ee3b3fef9f25be7d22a","2020-03-04T21:00:00Z",NA,NA,1,1,1,48,NA,NA,NA,NA,NA
"4672",20200304,"WA",128,633,NA,NA,NA,NA,NA,NA,NA,NA,"","3/4/2020 00:00","b8b39e23113cd7fc4ffd6027237b30ea1bb4f4f0","2020-03-04T21:00:00Z",16,NA,761,761,761,53,2,0,206,38,244
"4673",20200304,"WI",1,19,6,NA,NA,NA,NA,NA,NA,NA,"","","547cee4e2fed7189d8282e253500c27ceb555539","2020-03-04T21:00:00Z",NA,NA,26,20,20,55,NA,NA,NA,NA,NA
"4674",20200303,"MI",34,NA,NA,NA,NA,NA,NA,NA,NA,NA,"","","613f7e791dccdeb9ae2e48572f3d09042e14e713","2020-03-03T21:00:00Z",NA,NA,34,34,34,26,0,0,0,16,16
"4675",20200303,"RI",2,6,NA,NA,NA,NA,NA,NA,NA,NA,"","","bbc5e860d9a83e7c9505a64bcad19a7946486933","2020-03-03T21:00:00Z",NA,NA,8,8,8,44,0,0,6,1,7
"4676",20200303,"WA",90,427,NA,NA,NA,NA,NA,NA,NA,NA,"","3/3/2020 00:00","4bcfecb37283508afbca4bbef79e913883ead7e9","2020-03-03T21:00:00Z",14,NA,517,517,517,53,3,0,198,25,223
"4677",20200302,"MI",18,NA,NA,NA,NA,NA,NA,NA,NA,NA,"","","3d890472b4a0b5933dffc2a439eae075d4e30b5f","2020-03-02T21:00:00Z",NA,NA,18,18,18,26,0,0,0,9,9
"4678",20200302,"RI",1,NA,NA,NA,NA,NA,NA,NA,NA,NA,"","","96d29f406ed1a56e5431d47fe0ff5933625087a0","2020-03-02T21:00:00Z",NA,NA,1,1,1,44,0,0,0,0,0
"4679",20200302,"WA",65,229,NA,NA,NA,NA,NA,NA,NA,NA,"","3/2/2020 00:00","e090a6e0dbeca262f8cb642a40ce5755097ed2ef","2020-03-02T21:00:00Z",11,NA,294,294,294,53,3,0,148,31,179
"4680",20200301,"MI",9,NA,NA,NA,NA,NA,NA,NA,NA,NA,"","","71fa7b135fe366ace844861e259e735627b78ea9","2020-03-01T21:00:00Z",NA,NA,9,9,9,26,NA,NA,NA,NA,NA
"4681",20200301,"RI",1,NA,NA,NA,NA,NA,NA,NA,NA,NA,"","","a47f35b3ae0d55f3f465e6c83f78f53e7a701a98","2020-03-01T21:00:00Z",NA,NA,1,1,1,44,NA,NA,NA,NA,NA
"4682",20200301,"WA",34,81,NA,NA,NA,NA,NA,NA,NA,NA,"","3/1/2020 00:00","123bd0b8caa9b1317f97e9cea9d8f5c5d4f4e203","2020-03-01T21:00:00Z",8,NA,115,115,115,53,3,0,58,16,74
"4683",20200229,"WA",18,23,NA,NA,NA,NA,NA,NA,NA,NA,"","2/29/2020 00:00","75e9a7c47fd7834609ac6c6ed2ed77fbcbed4842","2020-02-29T21:00:00Z",5,NA,41,41,41,53,1,0,23,9,32
"4684",20200228,"WA",9,NA,NA,NA,NA,NA,NA,NA,NA,NA,"","","1e4f949413a87be6de5ca163050115969db6fb1c","2020-02-28T21:00:00Z",4,NA,9,9,9,53,2,0,0,7,7
"4685",20200227,"WA",2,NA,NA,NA,NA,NA,NA,NA,NA,NA,"","","01ac7f81a660f85c1ed60a285843950e2cc0ce32","2020-02-27T21:00:00Z",2,NA,2,2,2,53,0,0,0,0,0
"4686",20200226,"WA",2,NA,NA,NA,NA,NA,NA,NA,NA,NA,"","","944e5207e198723c9d20d053df7060836edd189c","2020-02-26T21:00:00Z",2,NA,2,2,2,53,2,0,0,0,0
"4687",20200225,"WA",2,NA,NA,NA,NA,NA,NA,NA,NA,NA,"","","3217275e0c627e3c5f4af980585e2ca517ba96a7","2020-02-25T21:00:00Z",NA,NA,2,2,2,53,0,0,0,0,0
"4688",20200224,"WA",2,NA,NA,NA,NA,NA,NA,NA,NA,NA,"","","4328beff7eb38c007011b4a8c5ec0866ab96471d","2020-02-24T21:00:00Z",NA,NA,2,2,2,53,0,0,0,0,0
"4689",20200223,"WA",2,NA,NA,NA,NA,NA,NA,NA,NA,NA,"","","27654080785d26b87e86057347f4181fc55219fc","2020-02-23T21:00:00Z",NA,NA,2,2,2,53,0,0,0,0,0
"4690",20200222,"WA",2,NA,NA,NA,NA,NA,NA,NA,NA,NA,"","","1483c7b91147d8ec370116d6f243c51a098e7725","2020-02-22T21:00:00Z",NA,NA,2,2,2,53,0,0,0,0,0
"4691",20200221,"WA",2,NA,NA,NA,NA,NA,NA,NA,NA,NA,"","","ebc579842322775d31ef3a6afcbb4133527cabf2","2020-02-21T21:00:00Z",NA,NA,2,2,2,53,0,0,0,0,0
"4692",20200220,"WA",2,NA,NA,NA,NA,NA,NA,NA,NA,NA,"","","7f2eea1ad5f019a6fa3cac948b6adca15d5a44f3","2020-02-20T21:00:00Z",NA,NA,2,2,2,53,0,0,0,0,0
"4693",20200219,"WA",2,NA,NA,NA,NA,NA,NA,NA,NA,NA,"","","2df58c613477ed9bc5bf9532ed830c81cc0e2dc9","2020-02-19T21:00:00Z",NA,NA,2,2,2,53,0,0,0,0,0
"4694",20200218,"WA",2,NA,NA,NA,NA,NA,NA,NA,NA,NA,"","","36fd64fc1c6186614ba86ac3816334712f704cc2","2020-02-18T21:00:00Z",NA,NA,2,2,2,53,0,0,0,0,0
"4695",20200217,"WA",2,NA,NA,NA,NA,NA,NA,NA,NA,NA,"","","6020f3048e7c1185f3107f883487aa7e943f72d9","2020-02-17T21:00:00Z",NA,NA,2,2,2,53,0,0,0,0,0
"4696",20200216,"WA",2,NA,NA,NA,NA,NA,NA,NA,NA,NA,"","","6b9d4fa32007a4d1d391699e9bdc1ab7674b8a9c","2020-02-16T21:00:00Z",NA,NA,2,2,2,53,0,0,0,0,0
"4697",20200215,"WA",2,NA,NA,NA,NA,NA,NA,NA,NA,NA,"","","b9ebce8685d2b47689383be0afdde83dbcf94684","2020-02-15T21:00:00Z",NA,NA,2,2,2,53,0,0,0,0,0
"4698",20200214,"WA",2,NA,NA,NA,NA,NA,NA,NA,NA,NA,"","","3696aaab27fdae852ccffbfcbe4f8e64bb945bc4","2020-02-14T21:00:00Z",NA,NA,2,2,2,53,0,0,0,0,0
"4699",20200213,"WA",2,NA,NA,NA,NA,NA,NA,NA,NA,NA,"","","9a044e156460f214d33d657234625399448de812","2020-02-13T21:00:00Z",NA,NA,2,2,2,53,0,0,0,0,0
"4700",20200212,"WA",2,NA,NA,NA,NA,NA,NA,NA,NA,NA,"","","ac0c134896e8d2534947c75f792713b416f2e159","2020-02-12T21:00:00Z",NA,NA,2,2,2,53,0,0,0,0,0
"4701",20200211,"WA",2,NA,NA,NA,NA,NA,NA,NA,NA,NA,"","","b8431bd8980d160575a23b50745754e0c4c77581","2020-02-11T21:00:00Z",NA,NA,2,2,2,53,0,0,0,0,0
"4702",20200210,"WA",2,NA,NA,NA,NA,NA,NA,NA,NA,NA,"","","139fc77fa684ad9b3bb564ca5247fdc3f0ad5903","2020-02-10T21:00:00Z",NA,NA,2,2,2,53,0,0,0,0,0
"4703",20200209,"WA",2,NA,NA,NA,NA,NA,NA,NA,NA,NA,"","","2a03366510b5d22465dcadab8d014a7dfdd7daaa","2020-02-09T21:00:00Z",NA,NA,2,2,2,53,0,0,0,0,0
"4704",20200208,"WA",2,NA,NA,NA,NA,NA,NA,NA,NA,NA,"","","b1150c8a8b70c16bad361cdd6334b39ba7d70674","2020-02-08T21:00:00Z",NA,NA,2,2,2,53,0,0,0,0,0
"4705",20200207,"WA",2,NA,NA,NA,NA,NA,NA,NA,NA,NA,"","","cbb1796a5a10a0cf18a802cb08e3ba856f0b4356","2020-02-07T21:00:00Z",NA,NA,2,2,2,53,0,0,0,1,1
"4706",20200206,"WA",1,NA,NA,NA,NA,NA,NA,NA,NA,NA,"","","f8ba1775462d80b62cb2b9dcafb9a9d4971d246f","2020-02-06T21:00:00Z",NA,NA,1,1,1,53,0,0,0,0,0
"4707",20200205,"WA",1,NA,NA,NA,NA,NA,NA,NA,NA,NA,"","","b1da43ee3ebf7ea2bbb5688c7dd79509680b2dda","2020-02-05T21:00:00Z",NA,NA,1,1,1,53,0,0,0,0,0
"4708",20200204,"WA",1,NA,NA,NA,NA,NA,NA,NA,NA,NA,"","","1d4ab25063ae3bbcbdcb6504e28ae592d423aa17","2020-02-04T21:00:00Z",NA,NA,1,1,1,53,0,0,0,0,0
"4709",20200203,"WA",1,NA,NA,NA,NA,NA,NA,NA,NA,NA,"","","6711797840e1fddd44a71d5049b4659eac04bcff","2020-02-03T21:00:00Z",NA,NA,1,1,1,53,0,0,0,0,0
"4710",20200202,"WA",1,NA,NA,NA,NA,NA,NA,NA,NA,NA,"","","20d9b4f6a7c50465178f5dfb35b12b3868057b9f","2020-02-02T21:00:00Z",NA,NA,1,1,1,53,0,0,0,0,0
"4711",20200201,"WA",1,NA,NA,NA,NA,NA,NA,NA,NA,NA,"","","617c6316a2e30eda558ccbb6ec544d8e360793a9","2020-02-01T21:00:00Z",NA,NA,1,1,1,53,0,0,0,0,0
"4712",20200131,"WA",1,NA,NA,NA,NA,NA,NA,NA,NA,NA,"","","73d54f0012b6bab87d58feaee3160928c500cea5","2020-01-31T21:00:00Z",NA,NA,1,1,1,53,0,0,0,0,0
"4713",20200130,"WA",1,NA,NA,NA,NA,NA,NA,NA,NA,NA,"","","b0be01a2246d9f5eb343c33e6ddbbc045d7adecb","2020-01-30T21:00:00Z",NA,NA,1,1,1,53,0,0,0,0,0
"4714",20200129,"WA",1,NA,NA,NA,NA,NA,NA,NA,NA,NA,"","","909c6573be9fce1cc2a0d03c2492f04709701ee9","2020-01-29T21:00:00Z",NA,NA,1,1,1,53,0,0,0,0,0
"4715",20200128,"WA",1,NA,NA,NA,NA,NA,NA,NA,NA,NA,"","","a692268e30d939a797338ae0b9b922704e9b2a6c","2020-01-28T21:00:00Z",NA,NA,1,1,1,53,0,0,0,0,0
"4716",20200127,"WA",1,NA,NA,NA,NA,NA,NA,NA,NA,NA,"","","831f6f502feb84713b75fe37b52637247be4ba48","2020-01-27T21:00:00Z",NA,NA,1,1,1,53,0,0,0,0,0
"4717",20200126,"WA",1,NA,NA,NA,NA,NA,NA,NA,NA,NA,"","","609165307f5d60e495d9eaed0e0f3387c7bf8eca","2020-01-26T21:00:00Z",NA,NA,1,1,1,53,0,0,0,0,0
"4718",20200125,"WA",1,NA,NA,NA,NA,NA,NA,NA,NA,NA,"","","a8aa0b13ab29023a1508b6ab3eb78f0f5c9db331","2020-01-25T21:00:00Z",NA,NA,1,1,1,53,0,0,0,0,0
"4719",20200124,"WA",1,NA,NA,NA,NA,NA,NA,NA,NA,NA,"","","2a78947c0c03661f5387e9e6835cb9643765943a","2020-01-24T21:00:00Z",NA,NA,1,1,1,53,0,0,0,0,0
"4720",20200123,"WA",1,NA,NA,NA,NA,NA,NA,NA,NA,NA,"","","24102d7fccb764d4f7c6ee847522451af42a7e2b","2020-01-23T21:00:00Z",NA,NA,1,1,1,53,0,0,0,0,0
"4721",20200122,"WA",1,NA,NA,NA,NA,NA,NA,NA,NA,NA,"","","c6e052d394e31103a4c7fd6f1c408b9e0008a455","2020-01-22T21:00:00Z",NA,NA,1,1,1,53,NA,NA,NA,NA,NA
