"","date","state","positive","negative","pending","hospitalizedCurrently","hospitalizedCumulative","inIcuCurrently","inIcuCumulative","onVentilatorCurrently","onVentilatorCumulative","recovered","hash","dateChecked","death","hospitalized","total","totalTestResults","posNeg","fips","deathIncrease","hospitalizedIncrease","negativeIncrease","positiveIncrease","totalTestResultsIncrease"
"1",20200423,"AK",337,11824,NA,42,NA,NA,NA,NA,NA,209,"59a03ea91067d205ddc33b0e77890986c467ae17","2020-04-23T20:00:00Z",9,NA,12161,12161,12161,2,0,0,0,2,2
"2",20200423,"AL",5778,46863,NA,NA,768,NA,288,NA,170,NA,"78a9b97c7fb690ae69dcfa0f2e6a789f0ca0171b","2020-04-23T20:00:00Z",197,768,52641,52641,52641,1,3,38,3568,313,3881
"3",20200423,"AR",2465,29125,NA,101,291,NA,NA,24,57,902,"bd177e23b3ca561ac31a19a983ccf50f778418a8","2020-04-23T20:00:00Z",45,291,31590,31590,31590,5,3,0,1688,189,1877
"4",20200423,"AS",0,3,17,NA,NA,NA,NA,NA,NA,NA,"7c31cc9e7b2d28fc0c28bc256c0b308db76eb64d","2020-04-23T20:00:00Z",NA,NA,20,3,3,60,0,0,0,0,0
"5",20200423,"AZ",5769,52928,NA,699,NA,305,NA,201,NA,1282,"51879cc631415d5645d3798bf6a354bad9d85098","2020-04-23T20:00:00Z",249,NA,58697,58697,58697,4,20,0,1786,310,2096
"6",20200423,"CA",37369,444728,NA,4929,NA,1531,NA,NA,NA,NA,"eccfc506140d6c27c2c6c46e6c69e5a874433028","2020-04-23T20:00:00Z",1469,NA,482097,482097,482097,6,115,0,14797,1973,16770
"7",20200423,"CO",10878,39767,NA,859,2123,NA,NA,NA,NA,NA,"951c9b0fd52846205397a6106ad8599d53da1ad0","2020-04-23T20:00:00Z",508,2123,50645,50645,50645,8,22,120,1510,431,1941
"8",20200423,"CT",23100,48397,NA,1947,NA,NA,NA,NA,NA,NA,"5992678999a7d5ef8b2297241fc9af3ab3db6207","2020-04-23T20:00:00Z",1639,NA,71497,71497,71497,9,95,0,948,631,1579
"9",20200423,"DC",3361,12569,NA,402,NA,120,NA,200,NA,648,"72dcd05b81106507a4b294d05d6c1b9a7f54e24e","2020-04-23T20:00:00Z",139,NA,15930,15930,15930,11,12,0,273,155,428
"10",20200423,"DE",3308,13604,NA,290,NA,NA,NA,NA,NA,643,"ac5dc066723ea288a993943ed710da099f74ef9a","2020-04-23T20:00:00Z",92,NA,16912,16912,16912,10,3,0,251,108,359
"11",20200423,"FL",28832,267876,1301,NA,4693,NA,NA,NA,NA,NA,"3ba322cf9574a404507b53da1d1a3b614ebb7edf","2020-04-23T20:00:00Z",979,4693,298009,296708,296708,12,69,224,7558,523,8081
"12",20200423,"GA",21512,79550,NA,NA,4069,NA,NA,NA,NA,NA,"35914be999993cf4648e58b6412ac0a59debca47","2020-04-23T20:00:00Z",872,4069,101062,101062,101062,13,36,110,6218,772,6990
"13",20200423,"GU",135,1180,NA,2,NA,NA,NA,NA,NA,126,"33446da4ca15b06922f36ce426c3d6501257e857","2020-04-23T20:00:00Z",5,NA,1315,1315,1315,66,0,0,94,1,95
"14",20200423,"HI",592,25536,NA,NA,63,NA,NA,NA,NA,444,"f9b8c542c68f9ac40215d0074fab036ab927832b","2020-04-23T20:00:00Z",12,63,26128,26128,26128,15,0,7,776,10,786
"15",20200423,"IA",3924,25338,NA,282,NA,102,NA,55,NA,1492,"2f57b0c1c91300dcdcce90d1cf8e34677e2ccd34","2020-04-23T20:00:00Z",96,NA,29262,29262,29262,19,6,0,842,176,1018
"16",20200423,"ID",1802,16290,NA,NA,162,NA,60,NA,NA,767,"b757b69da6b057e2b0dab77c9af64e77496ded45","2020-04-23T20:00:00Z",54,162,18092,18092,18092,16,3,4,326,36,362
"17",20200423,"IL",36934,136382,NA,4877,NA,1268,NA,766,NA,NA,"c877cdfb8918f0fd0fef4f7e8fdc1533029089f7","2020-04-23T20:00:00Z",1688,NA,173316,173316,173316,17,123,0,7144,1826,8970
"18",20200423,"IN",13039,59001,NA,NA,NA,652,NA,333,NA,NA,"41aa8a245965eec8c20014cab47e6b20f4c8d32e","2020-04-23T20:00:00Z",706,NA,72040,72040,72040,18,45,0,1969,601,2570
"19",20200423,"KS",2482,18836,NA,NA,442,NA,NA,NA,NA,NA,"8914a9cc9531a63ffb3cf1c02d945d0667084924","2020-04-23T20:00:00Z",112,442,21318,21318,21318,20,2,10,844,271,1115
"20",20200423,"KY",3373,32702,NA,301,1105,161,564,NA,NA,1311,"e2aacff8a5e9eabe7918b815ad4558585c306d6a","2020-04-23T20:00:00Z",185,1105,36075,36075,36075,21,14,29,2566,181,2747
"21",20200423,"LA",25739,117576,NA,1727,NA,NA,NA,274,NA,NA,"1ad45a496a09b4651310c715c7c3f6d771121f01","2020-04-23T20:00:00Z",1540,NA,143315,143315,143315,22,67,0,0,481,481
"22",20200423,"MA",46023,149053,NA,3890,4493,1034,NA,NA,NA,NA,"bf9b3a5e9ca0bbf90d2e9b8a4adfd5850d7bc843","2020-04-23T20:00:00Z",2360,4493,195076,195076,195076,25,178,4493,11535,3079,14614
"23",20200423,"MD",15737,64363,NA,1405,3477,515,NA,NA,NA,1040,"99cd5fdf1a12129b3862f58f0c681ab83f0af3c5","2020-04-23T20:00:00Z",748,3477,80100,80100,80100,24,117,152,2609,962,3571
"24",20200423,"ME",937,16784,NA,42,150,18,NA,11,NA,485,"6c869cbae85b6106924d5dc464b6681fa01d97bd","2020-04-23T20:00:00Z",44,150,17721,17721,17721,23,5,6,0,30,30
"25",20200423,"MI",35291,93030,NA,3611,NA,1148,NA,1027,NA,3237,"1e1b7f955a01792c910e4e4aa917e2c08cc6c6bc","2020-04-23T20:00:00Z",2977,NA,128321,128321,128321,26,164,0,8771,1325,10096
"26",20200423,"MN",2942,48606,NA,268,712,104,274,NA,NA,1536,"77ead2e737d28379a3c18e4ce8a3d643858858ef","2020-04-23T20:00:00Z",200,712,51548,51548,51548,27,21,52,1983,221,2204
"27",20200423,"MO",6321,53129,NA,884,NA,NA,NA,NA,NA,NA,"48e48812ff001c374231449a834049dbba052d95","2020-04-23T20:00:00Z",218,NA,59450,59450,59450,29,10,0,1110,184,1294
"28",20200423,"MP",14,51,NA,NA,NA,NA,NA,NA,NA,11,"f8895b560c75d346cec0fcd0b01b315dc33e5843","2020-04-23T20:00:00Z",2,NA,65,65,65,69,0,0,0,0,0
"29",20200423,"MS",5153,50236,NA,595,946,156,NA,78,NA,NA,"d26dcf04ba8de0169951fbbc06275b175ad5e510","2020-04-23T20:00:00Z",201,946,55389,55389,55389,28,8,36,1295,259,1554
"30",20200423,"MT",442,11433,NA,13,59,NA,NA,NA,NA,306,"3e1927838461f9d67a17151a1b875d7b32c5e049","2020-04-23T20:00:00Z",14,59,11875,11875,11875,30,0,0,289,3,292
"31",20200423,"NC",7608,88577,NA,486,NA,NA,NA,NA,NA,NA,"bbf9bdc14956aaa478b0fb2f52cdb24cc7e80af2","2020-04-23T20:00:00Z",253,NA,96185,96185,96185,37,11,0,5461,388,5849
"32",20200423,"ND",709,15621,NA,18,65,NA,NA,NA,NA,269,"7fc1a021491fdba4639bcc64f3fd6069ab8decd4","2020-04-23T20:00:00Z",15,65,16330,16330,16330,38,1,3,711,30,741
"33",20200423,"NE",1813,15547,NA,NA,NA,NA,NA,NA,NA,NA,"f2fd230daa72e688681febd9ff6169824ff5dbdd","2020-04-23T20:00:00Z",45,NA,17360,17360,17360,31,7,0,590,91,681
"34",20200423,"NH",1588,14424,265,91,213,NA,NA,NA,NA,550,"2209e432aa2d24a070e051a80b6edfc571c3df64","2020-04-23T20:00:00Z",48,213,16277,16012,16012,33,6,7,874,97,971
"35",20200423,"NJ",99989,100159,NA,7240,NA,1990,NA,1462,NA,NA,"bacfc6e489570442eea13e5a50c80950924f48b6","2020-04-23T20:00:00Z",5368,NA,200148,200148,200148,34,305,0,4365,4124,8489
"36",20200423,"NM",2210,39022,NA,121,331,NA,NA,NA,NA,547,"b2fe34c110d328badefbe2bc59e124a91496c1ad","2020-04-23T20:00:00Z",71,331,41232,41232,41232,35,6,25,217,138,355
"37",20200423,"NV",4208,30541,NA,NA,NA,NA,NA,NA,NA,NA,"2c1813b9cfe100470c90d449bdd539fa36ce944a","2020-04-23T20:00:00Z",189,NA,34749,34749,34749,32,17,0,734,127,861
"38",20200423,"NY",263460,432460,NA,15021,57103,5016,NA,NA,NA,23887,"5159bd7b7ed3f6196cf82ae36d84c72ce69c37ad","2020-04-23T20:00:00Z",15740,57103,695920,695920,695920,36,438,0,19694,6244,25938
"39",20200423,"OH",14142,88183,NA,NA,2960,NA,900,NA,NA,NA,"df903b7ce15ac22749d5b6e985b304d3dfd5225f","2020-04-23T20:00:00Z",656,2960,102325,102325,102325,39,46,78,3794,533,4327
"40",20200423,"OK",3017,43019,NA,284,622,156,NA,NA,NA,1884,"73483ad72dbf7359d6fd1100f76a5e6d346ff606","2020-04-23T20:00:00Z",179,622,46036,46036,46036,40,9,34,0,123,123
"41",20200423,"OR",2127,41849,NA,304,512,74,NA,36,NA,NA,"a42174d07b916ab1e53bcfb9f972cd4352208b84","2020-04-23T20:00:00Z",83,512,43976,43976,43976,41,5,24,2723,68,2791
"42",20200423,"PA",36647,142061,NA,2750,NA,NA,NA,679,NA,NA,"5b4b9feeb40866177d8dcca6e71fa6a67eb324e1","2020-04-23T20:00:00Z",1421,NA,178708,178708,178708,42,-201,0,5789,1602,7391
"43",20200423,"PR",915,9313,1951,NA,NA,NA,NA,NA,NA,NA,"bcd4a4a30d22306240afc42cba0e4c8382065ec3","2020-04-23T20:00:00Z",69,NA,12179,10228,10228,72,2,0,471,0,471
"44",20200423,"RI",6256,38163,NA,267,576,72,NA,45,NA,342,"287d363ac81742fe94cd704d82b4061d37b17071","2020-04-23T20:00:00Z",189,576,44419,44419,44419,44,8,0,2282,415,2697
"45",20200423,"SC",4917,39546,NA,NA,837,NA,NA,NA,NA,3317,"ad9c0d4b3f0603214bbfd86f321618fd3fe71293","2020-04-23T20:00:00Z",150,837,44463,44463,44463,45,10,0,1196,156,1352
"46",20200423,"SD",1956,12109,NA,58,119,NA,NA,NA,NA,1064,"96707585cf451dd251e90bb5c7efd8bc85664d72","2020-04-23T20:00:00Z",9,119,14065,14065,14065,46,1,8,521,98,619
"47",20200423,"TN",8266,114834,NA,NA,793,NA,NA,NA,NA,4193,"98c0d438a93613acd8a010874b94cdd4c459e889","2020-04-23T20:00:00Z",170,793,123100,123100,123100,47,4,18,7696,424,8120
"48",20200423,"TX",21944,203134,NA,1649,NA,NA,NA,NA,NA,8025,"595c3ac676dde2fd5ad65d57f664bd3549aa03ac","2020-04-23T20:00:00Z",561,NA,225078,225078,225078,48,18,0,7420,875,8295
"49",20200423,"UT",3612,77015,NA,NA,301,NA,NA,NA,NA,1050,"e522a322f86c92b93f6b7d8152dcb81a167b3f4d","2020-04-23T20:00:00Z",35,301,80627,80627,80627,49,1,13,4000,167,4167
"50",20200423,"VA",10627,53891,492,1379,1753,400,NA,249,NA,1567,"01de09d9974c76207a644dc64bdb24ba34ff2ca1","2020-04-23T20:00:00Z",372,1753,65010,64518,64518,51,48,172,4988,1176,6164
"51",20200423,"VI",54,583,31,NA,NA,NA,NA,NA,NA,48,"8cdd69b69a346fa00fcbcaefd686f1f180dfcc01","2020-04-23T20:00:00Z",3,NA,668,637,637,78,0,0,0,0,0
"52",20200423,"VT",825,13027,NA,44,NA,NA,NA,NA,NA,1710,"e40c5a413adfa77801d4a16c0b7bdbeb118f5ead","2020-04-23T20:00:00Z",43,NA,13852,13852,13852,50,3,0,388,2,390
"53",20200423,"WA",12494,135459,NA,544,NA,151,NA,NA,NA,NA,"56fbb9b38b753bd176d9f69f969dc88bf2542405","2020-04-23T20:00:00Z",692,NA,147953,147953,147953,53,10,0,2710,0,2710
"54",20200423,"WI",5052,51456,201,349,1318,146,342,NA,NA,NA,"887d8ba88412dbf71f9991bb452a51cc602551a9","2020-04-23T20:00:00Z",257,1318,56709,56508,56508,55,11,16,1954,207,2161
"55",20200423,"WV",967,26938,NA,108,NA,44,NA,24,NA,380,"68e08a56ec77bd4371a5b9f3d88fd511ceed31fe","2020-04-23T20:00:00Z",29,NA,27905,27905,27905,54,3,0,2041,28,2069
"56",20200423,"WY",326,7241,NA,NA,52,NA,NA,NA,NA,275,"726fb1321e617cbd2ba7b1408f0a7c1d5aac14b4","2020-04-23T20:00:00Z",7,52,7567,7567,7567,56,1,0,-60,4,-56
"57",20200422,"AK",335,11824,NA,39,36,NA,NA,NA,NA,196,"67838ce525ff91e697603d8a18cbd34dfee4bda2","2020-04-22T20:00:00Z",9,36,12159,12159,12159,2,0,0,1034,6,1040
"58",20200422,"AL",5465,43295,NA,NA,730,NA,288,NA,170,NA,"30072566e40dbd50379cb264023c0557ca771763","2020-04-22T20:00:00Z",194,730,48760,48760,48760,1,17,31,0,234,234
"59",20200422,"AR",2276,27437,NA,97,291,NA,NA,23,57,863,"2ca508f112fb6c88a1351199b82f167554e25d1e","2020-04-22T20:00:00Z",42,291,29713,29713,29713,5,-1,0,2223,49,2272
"60",20200422,"AS",0,3,17,NA,NA,NA,NA,NA,NA,NA,"be2004b5531125c7d1afafb0f304da440c7c4353","2020-04-22T20:00:00Z",NA,NA,20,3,3,60,0,0,0,0,0
"61",20200422,"AZ",5459,51142,NA,664,NA,300,NA,195,NA,1265,"c37cfe22570db99f0291554055f45f06541b3af3","2020-04-22T20:00:00Z",229,NA,56601,56601,56601,4,21,0,1241,208,1449
"62",20200422,"CA",35396,429931,NA,4984,NA,1551,NA,NA,NA,NA,"773232f6cb8a7d915ce247a32f45b4f3723b638a","2020-04-22T20:00:00Z",1354,NA,465327,465327,465327,6,86,0,163092,2135,165227
"63",20200422,"CO",10447,38257,NA,851,2003,NA,NA,NA,NA,NA,"3f7e7acba50a1ed4237da788ae570ba65071812a","2020-04-22T20:00:00Z",486,2003,48704,48704,48704,8,37,123,897,341,1238
"64",20200422,"CT",22469,47449,NA,1972,NA,NA,NA,NA,NA,NA,"4a0dfde544802f68208579d8734b333cc4b9ea99","2020-04-22T20:00:00Z",1544,NA,69918,69918,69918,9,121,0,3617,2109,5726
"65",20200422,"DC",3206,12296,NA,402,NA,120,NA,69,NA,645,"41dc68d78fc7c9cb9d59d5715dad29d717fd42f7","2020-04-22T20:00:00Z",127,NA,15502,15502,15502,11,15,0,455,108,563
"66",20200422,"DE",3200,13353,NA,269,NA,NA,NA,NA,NA,599,"732f6952f3c5017dc17e8c792823028c2360c977","2020-04-22T20:00:00Z",89,NA,16553,16553,16553,10,7,0,-372,269,-103
"67",20200422,"FL",28309,260318,1258,NA,4469,NA,NA,NA,NA,NA,"ff3403374f6ef6a6101f7f53793be4d41973c3f3","2020-04-22T20:00:00Z",910,4469,289885,288627,288627,12,54,234,10754,814,11568
"68",20200422,"GA",20740,73332,NA,NA,3959,NA,NA,NA,NA,NA,"d19c77af4ab1e054fc09ae6d03f94e611d1f87fe","2020-04-22T20:00:00Z",836,3959,94072,94072,94072,13,37,180,5073,859,5932
"69",20200422,"GU",134,1086,NA,3,NA,2,NA,NA,NA,119,"557df63373c44246af8793dab7b4f4fc970eff8b","2020-04-22T20:00:00Z",5,NA,1220,1220,1220,66,0,0,53,1,54
"70",20200422,"HI",582,24760,NA,NA,56,NA,NA,NA,NA,437,"3e7bad690dd39f057ff77c1a3de466a04e750eb7","2020-04-22T20:00:00Z",12,56,25342,25342,25342,15,2,1,648,-2,646
"71",20200422,"IA",3748,24496,NA,272,NA,92,NA,57,NA,1428,"852074c0ecbb6ace525096033c5b0251175dcb5d","2020-04-22T20:00:00Z",90,NA,28244,28244,28244,19,7,0,522,107,629
"72",20200422,"ID",1766,15964,NA,NA,158,NA,58,NA,NA,710,"1c6afa273193b88f4ddc24cf3d2b5b020aae3fa0","2020-04-22T20:00:00Z",51,158,17730,17730,17730,16,3,1,40,30,70
"73",20200422,"IL",35108,129238,NA,4665,NA,1220,NA,747,NA,NA,"0372392446bfb9441f1fc04ff3a7dfb8fc875317","2020-04-22T20:00:00Z",1565,NA,164346,164346,164346,17,97,0,7300,2049,9349
"74",20200422,"IN",12438,57032,NA,NA,NA,633,NA,334,NA,NA,"926b8f7bb7554be9a6e99cd7e468e0caefaca4e4","2020-04-22T20:00:00Z",661,NA,69470,69470,69470,18,31,0,1865,341,2206
"75",20200422,"KS",2211,17992,NA,NA,432,NA,NA,NA,NA,NA,"456014232e36fb91c21c21aa9febc3122214389e","2020-04-22T20:00:00Z",110,432,20203,20203,20203,20,3,13,916,186,1102
"76",20200422,"KY",3192,30136,NA,286,1076,165,558,NA,NA,1266,"cc6b60504396551f42726b0ecf9d3cdc72b2c1a8","2020-04-22T20:00:00Z",171,1076,33328,33328,33328,21,17,17,366,142,508
"77",20200422,"LA",25258,117576,NA,1747,NA,NA,NA,287,NA,NA,"19be1bd59dbf8234fbc24aaff741a97f9038a268","2020-04-22T20:00:00Z",1473,NA,142834,142834,142834,22,68,0,0,404,404
"78",20200422,"MA",42944,137518,NA,3977,NA,1050,NA,NA,NA,NA,"e07c12c798b7cc9ebdfc88cbf5561e48b4f168e3","2020-04-22T20:00:00Z",2182,NA,180462,180462,180462,25,221,0,3345,1745,5090
"79",20200422,"MD",14775,61754,NA,1432,3325,527,NA,NA,NA,981,"e26d6343fb1297e4af61be1c7aa39a69a27ac7fe","2020-04-22T20:00:00Z",631,3325,76529,76529,76529,24,47,167,2312,582,2894
"80",20200422,"ME",907,16784,NA,42,144,18,NA,10,NA,455,"988383238139014683890477a7617bad2c218775","2020-04-22T20:00:00Z",39,144,17691,17691,17691,23,3,5,2708,19,2727
"81",20200422,"MI",33966,84259,NA,3305,NA,1350,NA,1065,NA,3237,"f16af44eafa16d95c6c4089edf972beff6ec8271","2020-04-22T20:00:00Z",2813,NA,118225,118225,118225,26,113,0,0,999,999
"82",20200422,"MN",2721,46623,NA,240,660,107,262,NA,NA,1317,"c229760eeaecd3e0f89a64b60dd55b0a5cc64e78","2020-04-22T20:00:00Z",179,660,49344,49344,49344,27,19,31,1493,154,1647
"83",20200422,"MO",6137,52019,NA,1001,NA,NA,NA,NA,NA,NA,"35a73f53b0a0d35e6822d4bdc5b40d56f461659d","2020-04-22T20:00:00Z",208,NA,58156,58156,58156,29,19,0,840,196,1036
"84",20200422,"MP",14,51,NA,NA,NA,NA,NA,NA,NA,11,"540e46fa4bb76c4ab5160d92985ce9eb860963cb","2020-04-22T20:00:00Z",2,NA,65,65,65,69,0,0,0,0,0
"85",20200422,"MS",4894,48941,NA,628,910,162,NA,86,NA,NA,"103ca03e2c13f06e80906d32c0f9c08939836f62","2020-04-22T20:00:00Z",193,910,53835,53835,53835,28,10,52,1293,178,1471
"86",20200422,"MT",439,11144,NA,13,59,NA,NA,NA,NA,296,"33bffc0beb1f1f60d5c069f46385261805790397","2020-04-22T20:00:00Z",14,59,11583,11583,11583,30,2,0,340,2,342
"87",20200422,"NC",7220,83116,NA,434,NA,NA,NA,NA,NA,NA,"060d914673ad86ebfbe9f63da4016cf41bbcfb29","2020-04-22T20:00:00Z",242,NA,90336,90336,90336,37,29,0,6736,269,7005
"88",20200422,"ND",679,14910,NA,23,62,NA,NA,NA,NA,229,"eaf19b04bac7a012792bdccdb062bca9d4a6c49d","2020-04-22T20:00:00Z",14,62,15589,15589,15589,38,1,8,567,35,602
"89",20200422,"NE",1722,14957,NA,NA,NA,NA,NA,NA,NA,NA,"ff59643fc0fd1b8bd484f52955b851efc8b9a473","2020-04-22T20:00:00Z",38,NA,16679,16679,16679,31,5,0,233,74,307
"90",20200422,"NH",1491,13550,225,94,206,NA,NA,NA,NA,546,"c4ac07e77350805afafeccd9476abfe068ddcfab","2020-04-22T20:00:00Z",42,206,15266,15041,15041,33,0,0,702,0,702
"91",20200422,"NJ",95865,95794,NA,7210,NA,1983,NA,1570,NA,NA,"b551e40bb5a294b994122858cdd140c1f2b81fb1","2020-04-22T20:00:00Z",5063,NA,191659,191659,191659,34,310,0,3355,3478,6833
"92",20200422,"NM",2072,38805,NA,119,306,NA,NA,NA,NA,529,"d0e86efadb91d97c2b5b691831cc63e878627ece","2020-04-22T20:00:00Z",65,306,40877,40877,40877,35,7,15,2021,101,2122
"93",20200422,"NV",4081,29807,NA,NA,NA,NA,NA,NA,NA,NA,"78fe226417f91248f04a310d82d2cdf160283a81","2020-04-22T20:00:00Z",172,NA,33888,33888,33888,32,9,0,689,144,833
"94",20200422,"NY",257216,412766,NA,15599,57103,5016,NA,NA,NA,23887,"063ae170f1554db9bab018095725657f5607b627","2020-04-22T20:00:00Z",15302,57103,669982,669982,669982,36,474,0,15131,5526,20657
"95",20200422,"OH",13609,84389,NA,NA,2882,NA,880,NA,NA,NA,"4276a04e7d1b2091e0ed74fe01c290d625796ad6","2020-04-22T20:00:00Z",610,2882,97998,97998,97998,39,53,103,3400,359,3759
"96",20200422,"OK",2894,43019,NA,298,588,147,NA,NA,NA,1772,"2363e500b22e951895202ea58f79e93bdbe14c66","2020-04-22T20:00:00Z",170,588,45913,45913,45913,40,6,27,1482,87,1569
"97",20200422,"OR",2059,39126,NA,302,488,67,NA,35,NA,NA,"204c027327e97ea0cd4d1647f6ae8dc4169eeff0","2020-04-22T20:00:00Z",78,488,41185,41185,41185,41,0,17,0,57,57
"98",20200422,"PA",35045,136272,NA,2764,NA,NA,NA,685,NA,NA,"95aeb541ffe8ecfcb488e4fcc7d322a382b3dd08","2020-04-22T20:00:00Z",1622,NA,171317,171317,171317,42,58,0,3949,517,4466
"99",20200422,"PR",915,8842,1954,NA,NA,NA,NA,NA,NA,NA,"44e95a0d429cf5114529630c00ba4c8ff5c97ebc","2020-04-22T20:00:00Z",67,NA,11711,9757,9757,72,3,0,53,-383,-330
"100",20200422,"RI",5841,35881,NA,270,576,71,NA,44,NA,315,"fca0bf6bfcb785246ac597dc53cbc3f6e533c7d4","2020-04-22T20:00:00Z",181,576,41722,41722,41722,44,10,0,2048,341,2389
"101",20200422,"SC",4761,38350,NA,NA,837,NA,NA,NA,NA,3317,"0f5b22ad5d71ad37cc08168f14a40b2e5172e0d9","2020-04-22T20:00:00Z",140,837,43111,43111,43111,45,16,61,1512,322,1834
"102",20200422,"SD",1858,11588,NA,62,111,NA,NA,NA,NA,937,"f3e2e8022d2e2795a47e8bcc27e3a93897c49814","2020-04-22T20:00:00Z",8,111,13446,13446,13446,46,0,11,528,103,631
"103",20200422,"TN",7842,107138,NA,NA,775,NA,NA,NA,NA,4012,"f32b1e84f5167aa75a9e2d0fedd3c5926c50efa3","2020-04-22T20:00:00Z",166,775,114980,114980,114980,47,9,15,6350,448,6798
"104",20200422,"TX",21069,195714,NA,1678,NA,NA,NA,NA,NA,7341,"0823a164a5f99725e4f3c6722033850131fa840c","2020-04-22T20:00:00Z",543,NA,216783,216783,216783,48,26,0,10511,873,11384
"105",20200422,"UT",3445,73015,NA,NA,288,NA,NA,NA,NA,970,"2d2ef65991db156c73b1d97334160ea47f256998","2020-04-22T20:00:00Z",34,288,76460,76460,76460,49,2,11,3953,149,4102
"106",20200422,"VA",9451,48903,477,1374,1581,419,NA,244,NA,1497,"daab090b5da34d76ec13f894a6bdec01c655e237","2020-04-22T20:00:00Z",324,1581,58831,58354,58354,51,0,0,0,0,0
"107",20200422,"VI",54,583,31,NA,NA,NA,NA,NA,NA,48,"923864d2c6383c6d09b2f5e3e3bb564945903f10","2020-04-22T20:00:00Z",3,NA,668,637,637,78,0,0,9,0,9
"108",20200422,"VT",823,12639,NA,37,NA,NA,NA,NA,NA,1710,"3fe4f6824f9a92f38ee6001b74f0d7fb815e17f5","2020-04-22T20:00:00Z",40,NA,13462,13462,13462,50,0,0,346,5,351
"109",20200422,"WA",12494,132749,NA,543,NA,161,NA,NA,NA,NA,"097636733a986cbd2b6f33be0bcc454ab88f91fb","2020-04-22T20:00:00Z",682,NA,145243,145243,145243,53,30,0,3823,0,3823
"110",20200422,"WI",4845,49502,229,355,1302,139,324,NA,NA,NA,"2390095d515f94486dad5fa495f7f8eb4bf2640b","2020-04-22T20:00:00Z",246,1302,54576,54347,54347,55,4,50,1661,225,1886
"111",20200422,"WV",939,24897,NA,103,NA,41,NA,23,NA,330,"9727ad867f50e9b9f694c029a9e261b446769dbd","2020-04-22T20:00:00Z",26,NA,25836,25836,25836,54,0,0,3048,25,3073
"112",20200422,"WY",322,7301,NA,19,52,NA,NA,NA,NA,254,"66dd15128cd950b48a239380340d70a23272c16f","2020-04-22T20:00:00Z",6,52,7623,7623,7623,56,0,0,0,2,2
"113",20200421,"AK",329,10790,NA,42,36,NA,NA,NA,NA,168,"10d6907c6ec12caa4a5896fc50c4a3f06c836c0c","2020-04-21T20:00:00Z",9,36,11119,11119,11119,2,0,0,987,8,995
"114",20200421,"AL",5231,43295,NA,NA,699,NA,260,NA,157,NA,"15be9201bc9d81ab58bf59be774f06a82952cdf7","2020-04-21T20:00:00Z",177,699,48526,48526,48526,1,10,58,2420,206,2626
"115",20200421,"AR",2227,25214,NA,86,291,NA,NA,27,57,809,"c06b4ad615195a2c20654842d3c404cb48159ee5","2020-04-21T20:00:00Z",43,291,27441,27441,27441,5,1,0,584,304,888
"116",20200421,"AS",0,3,17,NA,NA,NA,NA,NA,NA,NA,"afa8b4a6d80b0cf70a2968a2a992a6a71043ef8e","2020-04-21T20:00:00Z",NA,NA,20,3,3,60,0,0,0,0,0
"117",20200421,"AZ",5251,49901,NA,637,NA,285,NA,181,NA,1155,"4a69e8a6cc27cbb70acca9544164c6a14767ec94","2020-04-21T20:00:00Z",208,NA,55152,55152,55152,4,21,0,465,187,652
"118",20200421,"CA",33261,266839,NA,4886,NA,1502,NA,NA,NA,NA,"130999e1dae6a15d665ea5cc4f161cd7681a5a73","2020-04-21T20:00:00Z",1268,NA,300100,300100,300100,6,60,0,7317,2283,9600
"119",20200421,"CO",10106,37360,NA,861,1880,NA,NA,NA,NA,NA,"22187aac3cc890945d5c4dfbc2e48b512bf82d5c","2020-04-21T20:00:00Z",449,1880,47466,47466,47466,8,27,67,895,376,1271
"120",20200421,"CT",20360,43832,NA,1949,NA,NA,NA,NA,NA,NA,"f39f1fb2973519f49a34aedc8a1765d0e03e75cc","2020-04-21T20:00:00Z",1423,NA,64192,64192,64192,9,92,0,841,545,1386
"121",20200421,"DC",3098,11841,NA,402,NA,120,NA,69,NA,636,"75a46a86c32f291b33808cf89aebfe736e271561","2020-04-21T20:00:00Z",112,NA,14939,14939,14939,11,7,0,655,171,826
"122",20200421,"DE",2931,13725,NA,263,NA,NA,NA,NA,NA,565,"aed23d700f3f936849e58824043aa8cedcb48ab1","2020-04-21T20:00:00Z",82,NA,16656,16656,16656,10,10,0,0,186,186
"123",20200421,"FL",27495,249564,1203,NA,4235,NA,NA,NA,NA,NA,"9f821074949d5d6047e4448cf38da1ff4ef699a6","2020-04-21T20:00:00Z",856,4235,278262,277059,277059,12,50,225,9999,835,10834
"124",20200421,"GA",19881,68259,NA,NA,3779,NA,NA,NA,NA,NA,"4cd0f63f74e65ce4fe77f7841f5fd68d9fd5a2f9","2020-04-21T20:00:00Z",799,3779,88140,88140,88140,13,66,229,2878,934,3812
"125",20200421,"GU",133,1033,NA,3,NA,2,NA,NA,NA,114,"e1e6bf7e31b6ecdaa4fe52ac6b055bbeee1b3e62","2020-04-21T20:00:00Z",5,NA,1166,1166,1166,66,0,0,42,0,42
"126",20200421,"HI",584,24112,NA,NA,55,NA,NA,NA,NA,423,"c24d2e957ec3c4227bf88c8223b8eb449d28aef1","2020-04-21T20:00:00Z",10,55,24696,24696,24696,15,0,3,517,4,521
"127",20200421,"IA",3641,23974,NA,214,NA,89,NA,60,NA,1293,"9ccc924133e13cff1762c594b1db6ea8d487032a","2020-04-21T20:00:00Z",83,NA,27615,27615,27615,19,4,0,1313,482,1795
"128",20200421,"ID",1736,15924,NA,NA,157,NA,58,NA,NA,660,"7256a7eac201794f186cb67fc6d3ae8e67561913","2020-04-21T20:00:00Z",48,157,17660,17660,17660,16,3,6,151,64,215
"129",20200421,"IL",33059,121938,NA,4776,NA,1226,NA,781,NA,NA,"257205aa1fd354cb30d3f55ba5f8f56d0e715faf","2020-04-21T20:00:00Z",1468,NA,154997,154997,154997,17,119,0,5088,1551,6639
"130",20200421,"IN",12097,55167,NA,NA,NA,676,NA,368,NA,NA,"d923aa798ebae153ddd35dc86b37e0ef673da7f5","2020-04-21T20:00:00Z",630,NA,67264,67264,67264,18,61,0,2214,411,2625
"131",20200421,"KS",2025,17076,NA,NA,419,NA,NA,NA,NA,NA,"b5a3ebc0e46a44c9dc3ec83e1c65428096f38f6d","2020-04-21T20:00:00Z",107,419,19101,19101,19101,20,7,14,301,39,340
"132",20200421,"KY",3050,29770,NA,263,1059,147,582,NA,NA,1174,"b63fcad8418ac13d0eb4b332c147714c2b1e339d","2020-04-21T20:00:00Z",154,1059,32820,32820,32820,21,6,0,158,90,248
"133",20200421,"LA",24854,117576,NA,1798,NA,NA,NA,297,NA,NA,"9fd12aed6e2d0c1164da15bb2d997bafac142731","2020-04-21T20:00:00Z",1405,NA,142430,142430,142430,22,77,0,0,331,331
"134",20200421,"MA",41199,134173,NA,3872,NA,1040,NA,NA,NA,NA,"18456ceafde2e31e1be2315d3ad9244478483067","2020-04-21T20:00:00Z",1961,NA,175372,175372,175372,25,255,0,10009,3122,13131
"135",20200421,"MD",14193,59442,NA,1433,3158,526,NA,NA,NA,930,"d928ff0a8db82d249852a56a747a46b7085c7751","2020-04-21T20:00:00Z",584,3158,73635,73635,73635,24,68,144,1729,509,2238
"136",20200421,"ME",888,14076,NA,40,139,16,NA,8,NA,443,"8dddf2b2c6af68e683803bf7b037e46f999eb44b","2020-04-21T20:00:00Z",36,139,14964,14964,14964,23,1,1,0,13,13
"137",20200421,"MI",32967,84259,NA,3357,NA,1346,NA,1107,NA,3237,"799cb0263c02e9c25fc4f490ffe3823b1f184d5f","2020-04-21T20:00:00Z",2700,NA,117226,117226,117226,26,232,0,2461,967,3428
"138",20200421,"MN",2567,45130,NA,237,629,117,253,NA,NA,1254,"1587a9753ec1e71fad13e5ed4c26f37409ab2260","2020-04-21T20:00:00Z",160,629,47697,47697,47697,27,17,27,750,97,847
"139",20200421,"MO",5941,51179,NA,1001,NA,NA,NA,NA,NA,NA,"3bbec91451c5e9fcf1b50cffbba417ad675ab670","2020-04-21T20:00:00Z",189,NA,57120,57120,57120,29,12,0,973,134,1107
"140",20200421,"MP",14,51,NA,NA,NA,NA,NA,NA,NA,11,"10f9265b9e76c116da07d29fbf55c56ecfd90e5f","2020-04-21T20:00:00Z",2,NA,65,65,65,69,0,0,0,0,0
"141",20200421,"MS",4716,47648,NA,548,858,146,NA,89,NA,NA,"f9f79cd912be26a8aa5c3e2f11a09a99e4a3ea10","2020-04-21T20:00:00Z",183,858,52364,52364,52364,28,14,39,726,204,930
"142",20200421,"MT",437,10804,NA,14,59,NA,NA,NA,NA,273,"38f1e6145db866e6eae026b84569358b8a052b59","2020-04-21T20:00:00Z",12,59,11241,11241,11241,30,2,2,186,4,190
"143",20200421,"NC",6951,76380,NA,427,NA,NA,NA,NA,NA,NA,"8fa4e757ffff03abd933aeb93b47bd3a938257a9","2020-04-21T20:00:00Z",213,NA,83331,83331,83331,37,34,0,3660,187,3847
"144",20200421,"ND",644,14343,NA,17,54,NA,NA,NA,NA,214,"0db523306c3b9caf0f6f06a7d891e5561afa0073","2020-04-21T20:00:00Z",13,54,14987,14987,14987,38,0,1,223,17,240
"145",20200421,"NE",1648,14724,NA,NA,NA,NA,NA,NA,NA,NA,"cadd8d4ce3aa8615505fa04e80ceac585d1529fa","2020-04-21T20:00:00Z",33,NA,16372,16372,16372,31,5,0,518,174,692
"146",20200421,"NH",1491,12848,244,78,206,NA,NA,NA,NA,521,"d9a7e24923af437b104565949b43d3c5a22816d4","2020-04-21T20:00:00Z",42,206,14583,14339,14339,33,1,8,122,99,221
"147",20200421,"NJ",92387,92439,NA,7594,NA,1930,NA,1501,NA,NA,"e7abeea8698f39b4c754e9cb9a40c4e7f4daa693","2020-04-21T20:00:00Z",4753,NA,184826,184826,184826,34,376,0,3188,3581,6769
"148",20200421,"NM",1971,36784,NA,116,291,NA,NA,NA,NA,501,"f96906d540264026ef1795afb8aac5375bf7cfb9","2020-04-21T20:00:00Z",58,291,38755,38755,38755,35,3,17,1587,126,1713
"149",20200421,"NV",3937,29118,NA,NA,NA,NA,NA,NA,NA,NA,"e7ce94534f79a1964d8f76ed7aa4bd5673420d5b","2020-04-21T20:00:00Z",163,NA,33055,33055,33055,32,5,0,601,107,708
"150",20200421,"NY",251690,397635,NA,16076,57103,5016,NA,NA,NA,23887,"970040b6c9f0cd9cfedb38634b362787b8d13738","2020-04-21T20:00:00Z",14828,57103,649325,649325,649325,36,481,0,11286,4178,15464
"151",20200421,"OH",13250,80989,NA,NA,2779,NA,838,NA,NA,NA,"822843310ab3872aef275a097144d9e0dd86682d","2020-04-21T20:00:00Z",557,2779,94239,94239,94239,39,48,126,3069,734,3803
"152",20200421,"OK",2807,41537,NA,346,561,164,NA,NA,NA,1702,"b537e80c977846fcf7e6b1115987151223748622","2020-04-21T20:00:00Z",164,561,44344,44344,44344,40,21,20,8571,127,8698
"153",20200421,"OR",2002,39126,NA,297,471,70,NA,35,NA,NA,"3c4c05e8c1f3e79f04d3b608620a1c840fc57480","2020-04-21T20:00:00Z",78,471,41128,41128,41128,41,3,6,1037,46,1083
"154",20200421,"PA",34528,132323,NA,2743,NA,NA,NA,673,NA,NA,"e8d43bb845371f9d38e1c3596ca0ddcd730756e5","2020-04-21T20:00:00Z",1564,NA,166851,166851,166851,42,360,0,2603,1296,3899
"155",20200421,"PR",1298,8789,1761,NA,NA,NA,NA,NA,NA,NA,"fcf6f50813c81c72d8854ad6b98d208e7a8f1d5e","2020-04-21T20:00:00Z",64,NA,11848,10087,10087,72,1,0,303,46,349
"156",20200421,"RI",5500,33833,NA,271,576,67,NA,43,NA,315,"18b3d53f8682ff567fc3f07e8a66e1b7e33cab7e","2020-04-21T20:00:00Z",171,576,39333,39333,39333,44,16,245,1843,410,2253
"157",20200421,"SC",4439,36838,NA,NA,776,NA,NA,NA,NA,2063,"a6cab844e1e2a7b3478efa2fb21c544f1811ba15","2020-04-21T20:00:00Z",124,776,41277,41277,41277,45,4,0,735,62,797
"158",20200421,"SD",1755,11060,NA,65,100,NA,NA,NA,NA,824,"992dc98887eb13afda521772d9999e3507038157","2020-04-21T20:00:00Z",8,100,12815,12815,12815,46,1,13,419,70,489
"159",20200421,"TN",7394,100788,NA,NA,760,NA,NA,NA,NA,3828,"5ba03884448b10adc6a50ed0e1010abfcf498b54","2020-04-21T20:00:00Z",157,760,108182,108182,108182,47,5,30,7337,156,7493
"160",20200421,"TX",20196,185203,NA,1419,NA,NA,NA,NA,NA,6486,"739a953d703356c070852d4c873827207ab43210","2020-04-21T20:00:00Z",517,NA,205399,205399,205399,48,22,0,14267,738,15005
"161",20200421,"UT",3296,69062,NA,NA,277,NA,NA,NA,NA,888,"944b4791fd93c9696980641689ce71ef01189065","2020-04-21T20:00:00Z",32,277,72358,72358,72358,49,4,9,3964,83,4047
"162",20200421,"VA",9451,48903,477,1331,1581,403,NA,251,NA,1418,"216bd911bd6b635ea70a2388f4f315e3ef71145c","2020-04-21T20:00:00Z",324,1581,58831,58354,58354,51,24,81,1158,461,1619
"163",20200421,"VI",54,574,35,NA,NA,NA,NA,NA,NA,48,"054e65dc64000f399e63e2186fc0c2ccd18e1d41","2020-04-21T20:00:00Z",3,NA,663,628,628,78,0,0,20,1,21
"164",20200421,"VT",818,12293,NA,41,NA,NA,NA,NA,NA,1710,"91159c0759d24f14884efa79ac45ede968e53e75","2020-04-21T20:00:00Z",40,NA,13111,13111,13111,50,2,0,128,2,130
"165",20200421,"WA",12494,128926,NA,503,NA,161,NA,NA,NA,NA,"ee7e9461f1da855c5dea3d16dbf1b0d4eb6cdde9","2020-04-21T20:00:00Z",652,NA,141420,141420,141420,53,18,0,2074,208,2282
"166",20200421,"WI",4620,47841,219,358,1252,137,324,NA,NA,NA,"e9ffd1a1dcd6cd7776bc0e7d03204b1e6eabac5f","2020-04-21T20:00:00Z",242,1252,52680,52461,52461,55,12,41,1238,121,1359
"167",20200421,"WV",914,21849,NA,85,NA,42,NA,24,NA,330,"d34d48ec6ad8964bd9d0424c7731b0e5d5d41257","2020-04-21T20:00:00Z",26,NA,22763,22763,22763,54,2,0,596,12,608
"168",20200421,"WY",320,7301,NA,19,52,NA,NA,NA,NA,237,"229d05fbf3c4684fd09c2466f4cccd8e29a577cb","2020-04-21T20:00:00Z",6,52,7621,7621,7621,56,4,1,228,7,235
"169",20200420,"AK",321,9803,NA,46,36,NA,NA,NA,NA,161,"1c99a7e1c363a89f2f8ab241524c88d328e3448f","2020-04-20T20:00:00Z",9,36,10124,10124,10124,2,0,0,227,2,229
"170",20200420,"AL",5025,40875,NA,NA,641,NA,260,NA,157,NA,"30c15cf3832f06f00b16592718072b2f8c548ef4","2020-04-20T20:00:00Z",167,641,45900,45900,45900,1,13,0,0,188,188
"171",20200420,"AR",1923,24630,NA,93,291,NA,NA,24,57,749,"1400a7da3fce5e813078b940af03430e86e35236","2020-04-20T20:00:00Z",42,291,26553,26553,26553,5,2,0,2202,142,2344
"172",20200420,"AS",0,3,17,NA,NA,NA,NA,NA,NA,NA,"a7c4bff380f29737760fb7ce0ab2cecb89c6d188","2020-04-20T20:00:00Z",NA,NA,20,3,3,60,0,0,0,0,0
"173",20200420,"AZ",5064,49436,NA,637,NA,285,NA,181,NA,1155,"c9850364cfb5a53d0e9ea8d7bf56fb68b7810895","2020-04-20T20:00:00Z",187,NA,54500,54500,54500,4,3,0,1375,135,1510
"174",20200420,"CA",30978,259522,NA,4674,NA,1480,NA,NA,NA,NA,"41576d2aea97b9aeda709ef2fc0ca31cedad7b7a","2020-04-20T20:00:00Z",1208,NA,290500,290500,290500,6,42,0,8955,645,9600
"175",20200420,"CO",9730,36465,NA,874,1813,NA,NA,NA,NA,NA,"44b06613b46ed33221077ce6b0eafc3ad972717b","2020-04-20T20:00:00Z",422,1813,46195,46195,46195,8,11,16,1292,297,1589
"176",20200420,"CT",19815,42991,NA,1919,NA,NA,NA,NA,NA,NA,"48cfc5676164821e66c31464dc4489db83b53cfd","2020-04-20T20:00:00Z",1331,NA,62806,62806,62806,9,245,0,2328,2265,4593
"177",20200420,"DC",2927,11186,NA,402,NA,120,NA,69,NA,630,"ba1352bb1343d135719500198fb5285f4cf02312","2020-04-20T20:00:00Z",105,NA,14113,14113,14113,11,9,0,280,134,414
"178",20200420,"DE",2745,13725,NA,256,NA,NA,NA,NA,NA,495,"eb8aefc88630769f3f3713ae9863d989c4155192","2020-04-20T20:00:00Z",72,NA,16470,16470,16470,10,5,0,1469,207,1676
"179",20200420,"FL",26660,239565,1104,NA,4010,NA,NA,NA,NA,NA,"48713e4b862f27a7754d18ed675b070c79ed41b3","2020-04-20T20:00:00Z",806,4010,267329,266225,266225,12,25,80,9482,664,10146
"180",20200420,"GA",18947,65381,NA,NA,3550,NA,NA,NA,NA,NA,"52bbf3b141deb058e8e4c3c95d60c677879c8497","2020-04-20T20:00:00Z",733,3550,84328,84328,84328,13,46,86,3749,646,4395
"181",20200420,"GU",133,991,NA,3,NA,2,NA,NA,NA,112,"d3cc796bda2181c4beff41042751382967b6296f","2020-04-20T20:00:00Z",5,NA,1124,1124,1124,66,0,0,48,-3,45
"182",20200420,"HI",580,23595,NA,NA,52,NA,NA,NA,NA,414,"f86f0830219bde224a6f3177e795b563a7e523aa","2020-04-20T20:00:00Z",10,52,24175,24175,24175,15,1,1,699,6,705
"183",20200420,"IA",3159,22661,NA,214,NA,91,NA,58,NA,1235,"b5492a5df365f18995800ea856c8df68284b7367","2020-04-20T20:00:00Z",79,NA,25820,25820,25820,19,4,0,1013,257,1270
"184",20200420,"ID",1672,15773,NA,NA,151,NA,53,NA,NA,585,"5b4507852c8be04b3979dd2b1c5150270ecc7985","2020-04-20T20:00:00Z",45,151,17445,17445,17445,16,1,0,572,4,576
"185",20200420,"IL",31508,116850,NA,4599,NA,1239,NA,757,NA,NA,"a7cde33ab8ab9bd3b8a8701a731bea46c1895dbc","2020-04-20T20:00:00Z",1349,NA,148358,148358,148358,17,59,0,3889,1151,5040
"186",20200420,"IN",11686,52953,NA,NA,NA,669,NA,353,NA,NA,"464f563cfbea566a0f09415f44711f25b1c8e361","2020-04-20T20:00:00Z",569,NA,64639,64639,64639,18,7,0,3021,476,3497
"187",20200420,"KS",1986,16775,NA,NA,405,NA,NA,NA,NA,NA,"8a4c6c22b95af6ad13d6f74e821750e2b3a9ad13","2020-04-20T20:00:00Z",100,405,18761,18761,18761,20,8,15,494,137,631
"188",20200420,"KY",2960,29612,NA,274,1059,155,534,NA,NA,1174,"24fd02d223bedfc30658c7616f6607de13542820","2020-04-20T20:00:00Z",148,1059,32572,32572,32572,21,4,0,94,253,347
"189",20200420,"LA",24523,117576,NA,1794,NA,NA,NA,332,NA,NA,"6582b5d51a3083441560e329643a398040adee2d","2020-04-20T20:00:00Z",1328,NA,142099,142099,142099,22,32,0,0,595,595
"190",20200420,"MA",38077,124164,NA,3729,NA,987,NA,NA,NA,NA,"6f0f233cd1d3c8c92b71ce535ca72bb655ff556d","2020-04-20T20:00:00Z",1706,NA,162241,162241,162241,25,0,0,0,0,0
"191",20200420,"MD",13684,57713,NA,NA,3014,NA,NA,NA,NA,917,"f8ad78c1b5a28e1553fc763631f9daa83e4977f3","2020-04-20T20:00:00Z",516,3014,71397,71397,71397,24,30,128,2652,854,3506
"192",20200420,"ME",875,14076,NA,39,138,16,NA,9,NA,414,"0b77d62611e8535de65897d5d3364e85b3b48204","2020-04-20T20:00:00Z",35,138,14951,14951,14951,23,1,2,0,8,8
"193",20200420,"MI",32000,81798,NA,3374,NA,1346,NA,1102,NA,3237,"392ae0c020c21dbbc1b892209cceb53cf9870110","2020-04-20T20:00:00Z",2468,NA,113798,113798,113798,26,77,0,3561,576,4137
"194",20200420,"MN",2470,44380,NA,237,602,126,241,NA,NA,1202,"30d5ab7a9755878cf6bf27605a060a04dceb2f8b","2020-04-20T20:00:00Z",143,602,46850,46850,46850,27,9,28,1020,114,1134
"195",20200420,"MO",5807,50206,NA,873,NA,NA,NA,NA,NA,NA,"4af4d88f885569d2f6257445a4dfeeca5944a5c1","2020-04-20T20:00:00Z",177,NA,56013,56013,56013,29,1,0,1964,140,2104
"196",20200420,"MP",14,51,NA,NA,NA,NA,NA,NA,NA,11,"d1a10e0647bc614d31772b798ad25e7657071f90","2020-04-20T20:00:00Z",2,NA,65,65,65,69,0,0,9,0,9
"197",20200420,"MS",4512,46922,NA,548,819,146,NA,89,NA,NA,"b83b01e3c5b28f2744892025a35a818eadc4d161","2020-04-20T20:00:00Z",169,819,51434,51434,51434,28,10,11,12131,238,12369
"198",20200420,"MT",433,10618,NA,19,57,NA,NA,NA,NA,243,"43b620f2e8e6847b386bcc5c1c26b00bf629c5ef","2020-04-20T20:00:00Z",10,57,11051,11051,11051,30,0,2,153,0,153
"199",20200420,"NC",6764,72720,NA,373,NA,NA,NA,NA,NA,NA,"5be41a497b5b5d214e51ac349c5e29a1ddbd443e","2020-04-20T20:00:00Z",179,NA,79484,79484,79484,37,7,0,441,271,712
"200",20200420,"ND",627,14120,NA,17,53,NA,NA,NA,NA,189,"a91cac8977af5b41f3177b1df9d02e5cc48b1c40","2020-04-20T20:00:00Z",13,53,14747,14747,14747,38,3,2,1075,42,1117
"201",20200420,"NE",1474,14206,NA,NA,NA,NA,NA,NA,NA,NA,"81b5f8ee0ee4fef36e9ad19133ee77eb59e10667","2020-04-20T20:00:00Z",28,NA,15680,15680,15680,31,0,0,918,187,1105
"202",20200420,"NH",1392,12726,298,79,198,NA,NA,NA,NA,521,"7de4c492da4e4977587cbd0351972d0a63921b2e","2020-04-20T20:00:00Z",41,198,14416,14118,14118,33,3,6,644,50,694
"203",20200420,"NJ",88806,89251,NA,6986,NA,2018,NA,1594,NA,NA,"475f85db6197c72804957a10154695964ecb1734","2020-04-20T20:00:00Z",4377,NA,178057,178057,178057,34,175,0,3864,3505,7369
"204",20200420,"NM",1845,35197,NA,103,274,NA,NA,NA,NA,487,"6bce6cdfad3d7f7d56cda6e86127c1cdf1582674","2020-04-20T20:00:00Z",55,274,37042,37042,37042,35,2,16,363,47,410
"205",20200420,"NV",3830,28517,NA,NA,NA,NA,NA,NA,NA,NA,"6597d6167cd367d35368d50b4f763775bf3fc8ae","2020-04-20T20:00:00Z",158,NA,32347,32347,32347,32,3,0,647,102,749
"206",20200420,"NY",247512,386349,NA,16103,57103,5016,NA,NA,NA,23887,"00fbff9168f7d91ad7b8b24e214b002b3d5bef6b","2020-04-20T20:00:00Z",14347,57103,633861,633861,633861,36,478,1380,11580,4726,16306
"207",20200420,"OH",12516,77920,NA,NA,2653,NA,798,NA,NA,NA,"7ec883d7476955c4012c40d78cbd4bbbfd32e0ba","2020-04-20T20:00:00Z",509,2653,90436,90436,90436,39,38,88,2223,1224,3447
"208",20200420,"OK",2680,32966,NA,307,541,136,NA,NA,NA,1614,"c1c68e1a81370eb7d4eeef17f88b8385c3223ff0","2020-04-20T20:00:00Z",143,541,35646,35646,35646,40,3,0,0,81,81
"209",20200420,"OR",1956,38089,NA,303,465,74,NA,35,NA,NA,"c1e439a175412090f4a043eefba3e2754e477cd6","2020-04-20T20:00:00Z",75,465,40045,40045,40045,41,1,9,961,46,1007
"210",20200420,"PA",33232,129720,NA,2701,NA,NA,NA,659,NA,NA,"b93e1d0f1b270a69f742a0992ff0924bf498fd39","2020-04-20T20:00:00Z",1204,NA,162952,162952,162952,42,92,0,3150,948,4098
"211",20200420,"PR",1252,8486,1895,NA,NA,NA,NA,NA,NA,NA,"f9af3f76cd935a4b930bed17b1a1f1498e456936","2020-04-20T20:00:00Z",63,NA,11633,9738,9738,72,1,0,206,39,245
"212",20200420,"RI",5090,31990,NA,272,331,62,NA,45,NA,267,"7eeca6d20edcdd054bea6d6dd4e6bfbe76f74dcd","2020-04-20T20:00:00Z",155,331,37080,37080,37080,44,5,0,1997,384,2381
"213",20200420,"SC",4377,36103,NA,NA,776,NA,NA,NA,NA,2063,"f5e68b7b953689577424337933c68d8101e4ca7a","2020-04-20T20:00:00Z",120,776,40480,40480,40480,45,0,0,0,0,0
"214",20200420,"SD",1685,10641,0,NA,87,NA,NA,NA,NA,709,"543469daaca0f0e8a222eb3a9f588834b1d9a6bf","2020-04-20T20:00:00Z",7,87,12326,12326,12326,46,0,13,214,50,264
"215",20200420,"TN",7238,93451,NA,NA,730,NA,NA,NA,NA,3575,"27a1a741ebcaa1665c87ecac9c56d22915c7e7f5","2020-04-20T20:00:00Z",152,730,100689,100689,100689,47,4,6,3423,168,3591
"216",20200420,"TX",19458,170936,NA,1411,NA,NA,NA,NA,NA,5706,"aa618d940c111264f2522c4cfeae1275aee43b81","2020-04-20T20:00:00Z",495,NA,190394,190394,190394,48,18,0,7149,535,7684
"217",20200420,"UT",3213,65098,NA,NA,268,NA,NA,NA,NA,776,"d7ce1632b3287fa512ade724a644335c0a1cdcf5","2020-04-20T20:00:00Z",28,268,68311,68311,68311,49,1,9,4612,144,4756
"218",20200420,"VA",8990,47745,468,1296,1500,396,NA,237,NA,1324,"2ea7ba60d3c4cf97b3aeeb0bdd023eb3482e6bc9","2020-04-20T20:00:00Z",300,1500,57203,56735,56735,51,23,78,1549,453,2002
"219",20200420,"VI",53,554,18,NA,NA,NA,NA,NA,NA,48,"a28571d6bba244a615bedfe60519ae3388f419b5","2020-04-20T20:00:00Z",3,NA,625,607,607,78,0,0,6,0,6
"220",20200420,"VT",816,12165,NA,49,NA,NA,NA,NA,NA,15,"9f5e1896b278870fc9a50fbb682e6f8cc927a6f2","2020-04-20T20:00:00Z",38,NA,12981,12981,12981,50,0,0,251,4,255
"221",20200420,"WA",12286,126852,NA,403,NA,122,NA,NA,NA,NA,"278d356d9114a3a634c1b31775fd0512566151b5","2020-04-20T20:00:00Z",634,NA,139138,139138,139138,53,10,0,2948,201,3149
"222",20200420,"WI",4499,46603,237,406,1211,168,307,NA,NA,NA,"3f68df6dae55c0dc7e23cad0c5c95cd51aeb6298","2020-04-20T20:00:00Z",230,1211,51339,51102,51102,55,10,21,1280,153,1433
"223",20200420,"WV",902,21253,NA,77,NA,37,NA,23,NA,290,"9cf42f04bb516ad4d992e2e34b14bb506ace0786","2020-04-20T20:00:00Z",24,NA,22155,22155,22155,54,6,0,2085,39,2124
"224",20200420,"WY",313,7073,NA,19,51,NA,NA,NA,NA,233,"7051d0f8ffb99101d5f51760a38f9161ea6bd4e4","2020-04-20T20:00:00Z",2,51,7386,7386,7386,56,0,1,101,4,105
"225",20200419,"AK",319,9576,NA,37,36,NA,NA,NA,NA,153,"a55d5f5198d699a8859e16fc9fa49cbecbc61939","2020-04-19T20:00:00Z",9,36,9895,9895,9895,2,0,0,235,5,240
"226",20200419,"AL",4837,40875,NA,NA,641,NA,260,NA,157,NA,"e120fdc84c91ed23d5f4a2a00e930fbf90f652b3","2020-04-19T20:00:00Z",154,641,45712,45712,45712,1,8,21,2992,182,3174
"227",20200419,"AR",1781,22428,NA,88,291,NA,NA,25,57,721,"26854a8543b5740ca16b32215f7349ffc12aed4d","2020-04-19T20:00:00Z",40,291,24209,24209,24209,5,2,0,26,42,68
"228",20200419,"AS",0,3,17,NA,NA,NA,NA,NA,NA,NA,"ae71dad66ccc8f5c3aaeafe4f292e04499664e5d","2020-04-19T20:00:00Z",NA,NA,20,3,3,60,0,0,0,0,0
"229",20200419,"AZ",4929,48061,NA,631,NA,283,NA,187,NA,994,"33b8b85aadbce892fe140ca6c9c2cf3275f0e845","2020-04-19T20:00:00Z",184,NA,52990,52990,52990,4,7,0,1735,210,1945
"230",20200419,"CA",30333,250567,7200,4731,NA,1457,NA,NA,NA,NA,"6497f09e42ab49264d37a27c55e3858737d2204a","2020-04-19T20:00:00Z",1166,NA,288100,280900,280900,6,94,0,19864,1370,21234
"231",20200419,"CO",9433,35173,NA,874,1797,NA,NA,NA,NA,NA,"30b797e974be7b9e0190a948977948fa7954192b","2020-04-19T20:00:00Z",411,1797,44606,44606,44606,8,20,42,913,386,1299
"232",20200419,"CT",17550,40663,NA,1938,NA,NA,NA,NA,NA,NA,"9eb73b754fac498c79f5eecf0d740580044c13b1","2020-04-19T20:00:00Z",1086,NA,58213,58213,58213,9,50,0,2010,741,2751
"233",20200419,"DC",2793,10906,NA,313,NA,105,NA,79,NA,622,"0afdb625281746e8bc0258458e6c11dd29cb69d7","2020-04-19T20:00:00Z",96,NA,13699,13699,13699,11,5,0,304,127,431
"234",20200419,"DE",2538,12256,NA,249,NA,NA,NA,NA,NA,466,"206aa57312ec65e2c5fe68147d10b55829f2e153","2020-04-19T20:00:00Z",67,NA,14794,14794,14794,10,6,0,562,215,777
"235",20200419,"FL",25996,230083,1179,NA,3930,NA,NA,NA,NA,NA,"9134ab1468fc864b0074346757d5fe0627ef37e5","2020-04-19T20:00:00Z",781,3930,257258,256079,256079,12,27,88,8825,727,9552
"236",20200419,"GA",18301,61632,NA,NA,3464,NA,NA,NA,NA,NA,"4f81acfbb704b29fa81c86366d17e1125118df19","2020-04-19T20:00:00Z",687,3464,79933,79933,79933,13,14,44,5093,632,5725
"237",20200419,"GU",136,943,NA,6,NA,2,NA,NA,NA,112,"ffd216b126680d43d0a167f20d2d146e6eacbef8","2020-04-19T20:00:00Z",5,NA,1079,1079,1079,66,0,0,0,0,0
"238",20200419,"HI",574,22896,NA,NA,51,NA,NA,NA,NA,410,"29fb1c3ee4a32fd0dc935059219095f7cbd5626a","2020-04-19T20:00:00Z",9,51,23470,23470,23470,15,0,3,1106,21,1127
"239",20200419,"IA",2902,21648,NA,198,NA,86,NA,54,NA,1171,"82c26fb3e410a7d8aca341442728861b6f948759","2020-04-19T20:00:00Z",75,NA,24550,24550,24550,19,1,0,1214,389,1603
"240",20200419,"ID",1668,15201,NA,NA,151,NA,53,NA,NA,520,"b6ed09b610f63b8964e71a17c94d2fae3f585ef4","2020-04-19T20:00:00Z",44,151,16869,16869,16869,16,1,0,247,13,260
"241",20200419,"IL",30357,112961,NA,4314,NA,1196,NA,749,NA,NA,"171fdba34c699b38cd99d9993a0c20b5a859abc3","2020-04-19T20:00:00Z",1290,NA,143318,143318,143318,17,31,0,4717,1197,5914
"242",20200419,"IN",11210,49932,NA,NA,NA,649,NA,342,NA,NA,"5528169e11d016a0a904789cbfc475f00682c329","2020-04-19T20:00:00Z",562,NA,61142,61142,61142,18,17,0,3700,569,4269
"243",20200419,"KS",1849,16281,NA,NA,390,NA,NA,NA,NA,NA,"ed8dd64285c21138b232f1ab7fac90b4041ec9ea","2020-04-19T20:00:00Z",92,390,18130,18130,18130,20,6,7,395,59,454
"244",20200419,"KY",2707,29518,NA,274,1059,155,534,NA,NA,1174,"294401486731fa47c293d1a07099bc6abe64d708","2020-04-19T20:00:00Z",144,1059,32225,32225,32225,21,7,51,1444,185,1629
"245",20200419,"LA",23928,117576,NA,1748,NA,NA,NA,349,NA,NA,"f39da3758743c982ec8f2c6a323d32041c56dd86","2020-04-19T20:00:00Z",1296,NA,141504,141504,141504,22,29,0,3157,348,3505
"246",20200419,"MA",38077,124164,NA,3804,NA,987,NA,NA,NA,NA,"fba67048a6f2b65b88455ea1503fa2f09c2d5bff","2020-04-19T20:00:00Z",1706,NA,162241,162241,162241,25,146,0,3730,1705,5435
"247",20200419,"MD",12830,55061,NA,NA,2886,NA,NA,NA,NA,914,"67e2b09c0defce78f91f1938bfd9be7452ae881e","2020-04-19T20:00:00Z",486,2886,67891,67891,67891,24,23,129,1999,522,2521
"248",20200419,"ME",867,14076,NA,46,136,18,NA,9,NA,393,"2ee56143f665f6eef6c7c7bf2d1b233c7ccefc29","2020-04-19T20:00:00Z",34,136,14943,14943,14943,23,2,0,0,20,20
"249",20200419,"MI",31424,78237,NA,3403,NA,1344,NA,1115,NA,3237,"b3a1319a97d980ef71e08c1e9112f84ce2382a88","2020-04-19T20:00:00Z",2391,NA,109661,109661,109661,26,83,0,9301,633,9934
"250",20200419,"MN",2356,43360,NA,228,574,116,226,NA,NA,1160,"c46d9c7e491debd22437fd9e1fbffe0c11a965be","2020-04-19T20:00:00Z",134,574,45716,45716,45716,27,13,13,1305,143,1448
"251",20200419,"MO",5667,48242,NA,875,NA,NA,NA,NA,NA,NA,"847abdacfffe186deb9e5f69ba2de46e4a0f46ce","2020-04-19T20:00:00Z",176,NA,53909,53909,53909,29,1,0,0,150,150
"252",20200419,"MP",14,42,4,NA,NA,NA,NA,NA,NA,9,"d9899c4db95fdfc1b466f0df099bd5e4d73cd24b","2020-04-19T20:00:00Z",2,NA,60,56,56,69,0,0,0,0,0
"253",20200419,"MS",4274,34791,NA,NA,808,138,NA,79,NA,NA,"56b97ccde77eed01f684728fc5aee81aa4cd2251","2020-04-19T20:00:00Z",159,808,39065,39065,39065,28,7,26,0,300,300
"254",20200419,"MT",433,10465,NA,18,55,NA,NA,NA,NA,243,"01531efd541c443e1080cfb6e95eebb7dd6b2052","2020-04-19T20:00:00Z",10,55,10898,10898,10898,30,0,0,322,7,329
"255",20200419,"NC",6493,72279,NA,465,NA,NA,NA,NA,NA,NA,"33bb942114706fa830c9ff3bd5c0736ee8c5a648","2020-04-19T20:00:00Z",172,NA,78772,78772,78772,37,8,0,2208,353,2561
"256",20200419,"ND",585,13045,NA,15,51,NA,NA,NA,NA,189,"c24fc5d7f1683d70f5c4b362ca03d131da90a4a3","2020-04-19T20:00:00Z",10,51,13630,13630,13630,38,1,4,610,57,667
"257",20200419,"NE",1287,13288,NA,NA,NA,NA,NA,NA,NA,NA,"626331acb95da822b8543edb30d772eb6a727e02","2020-04-19T20:00:00Z",28,NA,14575,14575,14575,31,4,0,749,149,898
"258",20200419,"NH",1342,12082,316,85,192,NA,NA,NA,NA,513,"2228387ecb96872f72ce39a4189efd28cf4616a9","2020-04-19T20:00:00Z",38,192,13740,13424,13424,33,1,2,517,55,572
"259",20200419,"NJ",85301,85387,NA,7494,NA,1940,NA,1628,NA,NA,"bfacf58505686a7f6016e248759561bb29c71824","2020-04-19T20:00:00Z",4202,NA,170688,170688,170688,34,132,0,4271,3881,8152
"260",20200419,"NM",1798,34834,NA,92,258,NA,NA,NA,NA,465,"45b0a25516b7d3002fe45c7522626bd3af59c125","2020-04-19T20:00:00Z",53,258,36632,36632,36632,35,2,16,932,87,1019
"261",20200419,"NV",3728,27870,NA,NA,NA,NA,NA,NA,NA,NA,"dc7b0bb39e382412167e1696b5a5df37b9e90c90","2020-04-19T20:00:00Z",155,NA,31598,31598,31598,32,4,0,745,102,847
"262",20200419,"NY",242786,374769,NA,16213,55723,5016,NA,NA,NA,23887,"a31e7da9ac8b2747e083e07d2109e0dc8949cb2e","2020-04-19T20:00:00Z",13869,55723,617555,617555,617555,36,507,1384,14969,6054,21023
"263",20200419,"OH",11292,75697,NA,NA,2565,NA,765,NA,NA,NA,"4cd095edc621321b7eaeb621d8e388ef842c6363","2020-04-19T20:00:00Z",471,2565,86989,86989,86989,39,20,46,6878,1353,8231
"264",20200419,"OK",2599,32966,NA,307,541,136,NA,NA,NA,1575,"a6d29945e0f5ebbbf59fd16df1594b1519748563","2020-04-19T20:00:00Z",140,541,35565,35565,35565,40,1,0,0,29,29
"265",20200419,"OR",1910,37128,NA,290,456,74,NA,37,NA,NA,"ec661c9d973bf39cbdb160e1460ee6576ad075e0","2020-04-19T20:00:00Z",74,456,39038,39038,39038,41,2,7,1389,66,1455
"266",20200419,"PA",32284,126570,NA,2634,NA,NA,NA,657,NA,NA,"6e7208747c844734f6c1a7e4baaec23c97ffc391","2020-04-19T20:00:00Z",1112,NA,158854,158854,158854,42,276,0,3674,1215,4889
"267",20200419,"PR",1213,8280,1839,NA,NA,NA,NA,NA,NA,NA,"a721603971d92c485f34bfcc042df1eee7d98b29","2020-04-19T20:00:00Z",62,NA,11332,9493,9493,72,2,0,225,95,320
"268",20200419,"RI",4706,29993,NA,278,331,66,NA,37,NA,244,"9665fc9398589b5d582473ae54d28cadb76f2a6a","2020-04-19T20:00:00Z",150,331,34699,34699,34699,44,13,0,1658,215,1873
"269",20200419,"SC",4377,36103,NA,NA,776,NA,NA,NA,NA,2633,"7131f56d8c3cca28acea564234b76af6ff0824c7","2020-04-19T20:00:00Z",120,776,40480,40480,40480,45,1,0,1516,131,1647
"270",20200419,"SD",1635,10427,0,NA,74,NA,NA,NA,NA,646,"3f65890db33d32f46a90ea34281347b33a146882","2020-04-19T20:00:00Z",7,74,12062,12062,12062,46,0,6,309,93,402
"271",20200419,"TN",7070,90028,NA,NA,724,NA,NA,NA,NA,3344,"60d2f99d4e111f558462b9ff68cd65e6e71c7621","2020-04-19T20:00:00Z",148,724,97098,97098,97098,47,3,5,6204,308,6512
"272",20200419,"TX",18923,163787,NA,1471,NA,NA,NA,NA,NA,5334,"0fc49b2c1df281f3fedfbacd2f2010c5221109ed","2020-04-19T20:00:00Z",477,NA,182710,182710,182710,48,24,0,5808,663,6471
"273",20200419,"UT",3069,60486,NA,NA,259,NA,NA,NA,NA,679,"5fef949ff5b5a3b616e0f7af426750ffeabbdf46","2020-04-19T20:00:00Z",27,259,63555,63555,63555,49,2,8,3473,138,3611
"274",20200419,"VA",8537,46196,499,1319,1422,388,NA,231,NA,1267,"2c57acf155ca215593af4e21a3d82a98d0f1a240","2020-04-19T20:00:00Z",277,1422,55232,54733,54733,51,19,126,2318,484,2802
"275",20200419,"VI",53,548,22,NA,NA,NA,NA,NA,NA,48,"8a1ae5c337b88d929c1347d2d99cee0960020aea","2020-04-19T20:00:00Z",3,NA,623,601,601,78,0,0,158,0,158
"276",20200419,"VT",812,11914,NA,53,NA,NA,NA,NA,NA,15,"0fd8206e283903ce9d079d7a99dc577628487dca","2020-04-19T20:00:00Z",38,NA,12726,12726,12726,50,0,0,151,9,160
"277",20200419,"WA",12085,123904,NA,586,NA,193,NA,NA,NA,NA,"53521ef370e043f6e7d0c292896a9448b058571e","2020-04-19T20:00:00Z",624,NA,135989,135989,135989,53,21,0,3722,256,3978
"278",20200419,"WI",4346,45323,248,397,1190,162,307,NA,NA,NA,"7b769f633fc7090da95857b59e02c6b58d946863","2020-04-19T20:00:00Z",220,1190,49917,49669,49669,55,9,14,1361,147,1508
"279",20200419,"WV",863,19168,NA,72,NA,37,NA,25,NA,265,"b84ada6c6a8233ff6d204c06b6db3dad4dc4ffb8","2020-04-19T20:00:00Z",18,NA,20031,20031,20031,54,2,0,513,78,591
"280",20200419,"WY",309,6972,NA,19,50,NA,NA,NA,NA,227,"e267dd2b218ec12a6da6575976293932c0b3eda9","2020-04-19T20:00:00Z",2,50,7281,7281,7281,56,0,0,755,4,759
"281",20200418,"AK",314,9341,NA,39,36,NA,NA,NA,NA,147,"e01d04c1608f52dc596ef6e9cde32427d3da59b7","2020-04-18T20:00:00Z",9,36,9655,9655,9655,2,0,0,200,5,205
"282",20200418,"AL",4655,37883,NA,NA,620,NA,247,NA,148,NA,"db9e6bd49bb8fa0b75862eebb624fdb77a579372","2020-04-18T20:00:00Z",146,620,42538,42538,42538,1,2,26,4565,125,4690
"283",20200418,"AR",1739,22402,NA,86,291,NA,NA,22,57,703,"eec8a2490a89622aa7130d38b8fc3a8d59be09b7","2020-04-18T20:00:00Z",38,291,24141,24141,24141,5,1,291,603,44,647
"284",20200418,"AS",0,3,17,NA,NA,NA,NA,NA,NA,NA,"bf4a96d3c81bf1b9837fdc965967117ba4b3c5c8","2020-04-18T20:00:00Z",NA,NA,20,3,3,60,0,0,0,0,0
"285",20200418,"AZ",4719,46326,NA,566,NA,285,NA,178,NA,539,"a4301cbdf289563b0e77dc0b34c1c06d33036d08","2020-04-18T20:00:00Z",177,NA,51045,51045,51045,4,8,0,1603,212,1815
"286",20200418,"CA",28963,230703,7200,4936,NA,1490,NA,NA,NA,NA,"a9c31277a9b1ab3427316de11ad64f4b127fd51e","2020-04-18T20:00:00Z",1072,NA,266866,259666,259666,6,87,0,6617,1435,8052
"287",20200418,"CO",9047,34260,NA,843,1755,NA,NA,NA,NA,NA,"26ac73ae2504d808bf4c0f1332d68cdfd91640db","2020-04-18T20:00:00Z",391,1755,43307,43307,43307,8,17,62,1105,372,1477
"288",20200418,"CT",16809,38653,NA,1946,NA,NA,NA,NA,NA,NA,"256fef2f9d456903a1c8c6006831e589d3ebb8d3","2020-04-18T20:00:00Z",1036,NA,55462,55462,55462,9,0,0,0,0,0
"289",20200418,"DC",2666,10602,NA,313,NA,105,NA,79,NA,608,"d3a2a3fcd66b3b4757fcce3a46615e70fb6509ee","2020-04-18T20:00:00Z",91,NA,13268,13268,13268,11,5,0,435,190,625
"290",20200418,"DE",2323,11694,NA,224,NA,NA,NA,NA,NA,423,"463423f890b6020e5c40a82cd608f9aea6573a31","2020-04-18T20:00:00Z",61,NA,14017,14017,14017,10,0,0,0,0,0
"291",20200418,"FL",25269,221258,0,NA,3842,NA,NA,NA,NA,NA,"2176200a41dd3f01171fa85299fdc0f7ab3f3a90","2020-04-18T20:00:00Z",754,3842,246527,246527,246527,12,55,177,10540,1150,11690
"292",20200418,"GA",17669,56539,NA,NA,3420,NA,NA,NA,NA,NA,"2565bc253000e62f29b0da78e7eba4ac12e912f2","2020-04-18T20:00:00Z",673,3420,74208,74208,74208,13,23,96,2049,475,2524
"293",20200418,"GU",136,943,NA,6,NA,2,NA,NA,NA,110,"dca33f2fce6847da9aa89c5aa93994db30b15e73","2020-04-18T20:00:00Z",5,NA,1079,1079,1079,66,0,0,3,0,3
"294",20200418,"HI",553,21790,NA,NA,48,NA,NA,NA,NA,390,"258ad5f1ea6322a617a09ed88785f16e4ea4cc26","2020-04-18T20:00:00Z",9,48,22343,22343,22343,15,0,3,474,12,486
"295",20200418,"IA",2513,20434,NA,193,NA,84,NA,51,NA,1095,"98ef5b0bf163139ee1c1b53a0ee004255777072b","2020-04-18T20:00:00Z",74,NA,22947,22947,22947,19,10,0,974,181,1155
"296",20200418,"ID",1655,14954,NA,NA,151,NA,53,NA,NA,453,"a3d02ffb5a444e736635ba7d7c87c48d9e118f29","2020-04-18T20:00:00Z",43,151,16609,16609,16609,16,2,3,380,46,426
"297",20200418,"IL",29160,108244,NA,4340,NA,1192,NA,740,NA,NA,"c66c5c73ef01e154c6f70ccc1c7399c17cbb9b11","2020-04-18T20:00:00Z",1259,NA,137404,137404,137404,17,125,0,5656,1585,7241
"298",20200418,"IN",10641,46232,NA,NA,NA,663,NA,360,NA,NA,"4057af437d8aeeb997c248711046a829ad8666a7","2020-04-18T20:00:00Z",545,NA,56873,56873,56873,18,26,0,1601,487,2088
"299",20200418,"KS",1790,15886,NA,NA,383,NA,NA,NA,NA,NA,"d9fb96d86b079b9e15d116e72c7aa0faed677a63","2020-04-18T20:00:00Z",86,383,17676,17676,17676,20,2,8,690,85,775
"300",20200418,"KY",2522,28074,NA,360,1008,227,514,NA,NA,979,"274eaebc9b0a7226236683c1d7a64ec3c2955df9","2020-04-18T20:00:00Z",137,1008,30596,30596,30596,21,8,37,756,93,849
"301",20200418,"LA",23580,114419,NA,1761,NA,NA,NA,347,NA,NA,"55ce37dc6547f8caa1cc8430bdfc20cc29521e86","2020-04-18T20:00:00Z",1267,NA,137999,137999,137999,22,54,0,5550,462,6012
"302",20200418,"MA",36372,120434,NA,3750,NA,987,NA,NA,NA,NA,"821c89a9c2d907123e6d0d27ecae7b18978a8ceb","2020-04-18T20:00:00Z",1560,NA,156806,156806,156806,25,156,0,6092,1970,8062
"303",20200418,"MD",12308,53062,NA,NA,2757,NA,NA,NA,NA,771,"cbf14419d163fef946e49fd13a76a857f2b73129","2020-04-18T20:00:00Z",463,2757,65370,65370,65370,24,38,145,2625,736,3361
"304",20200418,"ME",847,14076,NA,49,136,20,NA,12,NA,382,"e7214ce4f707e1e8a635a3cf38e984c564a2d534","2020-04-18T20:00:00Z",32,136,14923,14923,14923,23,3,3,0,20,20
"305",20200418,"MI",30791,68936,NA,3634,NA,1423,NA,1203,NA,3237,"2e6c124c6e344d492ce72890f839c4c2aae2f299","2020-04-18T20:00:00Z",2308,NA,99727,99727,99727,26,81,0,0,768,768
"306",20200418,"MN",2213,42055,NA,239,561,111,215,NA,NA,1118,"bf427777ae6442c2e6294bd777fbbd7a87b2abae","2020-04-18T20:00:00Z",121,561,44268,44268,44268,27,10,43,1073,142,1215
"307",20200418,"MO",5517,48242,NA,875,NA,NA,NA,NA,NA,NA,"00d835600fd20e8d0680a8afccf5b922d8348b2c","2020-04-18T20:00:00Z",175,NA,53759,53759,53759,29,10,0,1808,234,2042
"308",20200418,"MP",14,42,4,NA,NA,NA,NA,NA,NA,9,"f6bcb3d42df33c91ed6a0f7dd767a1ed1dbf28a8","2020-04-18T20:00:00Z",2,NA,60,56,56,69,0,0,0,1,1
"309",20200418,"MS",3974,34791,NA,NA,782,154,NA,99,NA,NA,"a83198e0f902783d50e3de2e926f3e705e309b0b","2020-04-18T20:00:00Z",152,782,38765,38765,38765,28,12,46,0,181,181
"310",20200418,"MT",426,10143,NA,17,55,NA,NA,NA,NA,234,"2dc43c83d8c0ed53e1a880a5851671c68d19cd3d","2020-04-18T20:00:00Z",10,55,10569,10569,10569,30,2,1,321,4,325
"311",20200418,"NC",6140,70071,NA,388,NA,NA,NA,NA,NA,NA,"c37a91deaaad48e58705312e38a6baff928948af","2020-04-18T20:00:00Z",164,NA,76211,76211,76211,37,12,0,2949,281,3230
"312",20200418,"ND",528,12435,NA,13,47,NA,NA,NA,NA,183,"aad568c873238b5cd64027dc33dca766482518fc","2020-04-18T20:00:00Z",9,47,12963,12963,12963,38,0,0,532,89,621
"313",20200418,"NE",1138,12539,NA,NA,NA,NA,NA,NA,NA,NA,"430b7e2f83f537185b3964052441c2626a845b1d","2020-04-18T20:00:00Z",24,NA,13677,13677,13677,31,0,0,501,72,573
"314",20200418,"NH",1287,11565,174,86,190,NA,NA,NA,NA,468,"f605fea50f3ee8b194a5f37bf56e5329c0426eee","2020-04-18T20:00:00Z",37,190,13026,12852,12852,33,0,0,144,0,144
"315",20200418,"NJ",81420,81116,NA,7718,NA,2024,NA,1641,NA,NA,"2c98aa87acbdcab2efa4ff30b0cc10d21f35c62c","2020-04-18T20:00:00Z",4070,NA,162536,162536,162536,34,230,0,2134,2953,5087
"316",20200418,"NM",1711,33902,NA,96,242,NA,NA,NA,NA,382,"f4530150b6e41cb8496c6cf81e6826498a882d79","2020-04-18T20:00:00Z",51,242,35613,35613,35613,35,7,12,1011,114,1125
"317",20200418,"NV",3626,27125,NA,NA,NA,NA,NA,NA,NA,NA,"0463c7b5460ccaf3d387f017181f7808535a9fd4","2020-04-18T20:00:00Z",151,NA,30751,30751,30751,32,9,0,887,102,989
"318",20200418,"NY",236732,359800,NA,16967,54339,5016,NA,NA,NA,23887,"563bfe9c9f2a26f5dc16b5e8c60fae51c3220f2d","2020-04-18T20:00:00Z",13362,54339,596532,596532,596532,36,540,1915,16219,7090,23309
"319",20200418,"OH",9939,68819,NA,NA,2519,NA,760,NA,NA,NA,"b530d1c09134ce67159aca29d4d468956372c5ee","2020-04-18T20:00:00Z",451,2519,78758,78758,78758,39,33,95,0,1081,1081
"320",20200418,"OK",2570,32966,NA,307,541,136,NA,NA,NA,1515,"252c6e812512bcc3b4ecc69984d32a38511b15be","2020-04-18T20:00:00Z",139,541,35536,35536,35536,40,3,13,1811,105,1916
"321",20200418,"OR",1844,35739,NA,290,449,74,NA,37,NA,NA,"b64d78255c9b7f2dcb0331cd990d010ddf9c0390","2020-04-18T20:00:00Z",72,449,37583,37583,37583,41,2,22,1203,59,1262
"322",20200418,"PA",31069,122896,NA,2613,NA,NA,NA,660,NA,NA,"2120d7fe1eced33687fa2242ca4e2d72e225dc88","2020-04-18T20:00:00Z",836,NA,153965,153965,153965,42,80,0,4964,1628,6592
"323",20200418,"PR",1118,8055,1760,NA,NA,NA,NA,NA,NA,NA,"ebd310b1cbea796276b9c627a79eb874b6e3dac3","2020-04-18T20:00:00Z",60,NA,10933,9173,9173,72,2,0,191,50,241
"324",20200418,"RI",4491,28335,NA,255,331,67,NA,43,NA,217,"5aac9cd94170d771d8fd18f5442bf86b4327834e","2020-04-18T20:00:00Z",137,331,32826,32826,32826,44,19,0,1751,314,2065
"325",20200418,"SC",4246,34587,NA,NA,776,NA,NA,NA,NA,2633,"fbc074dd4bb4e3e76c02cac6dffa09c08417b088","2020-04-18T20:00:00Z",119,776,38833,38833,38833,45,10,101,2234,315,2549
"326",20200418,"SD",1542,10118,1,NA,68,NA,NA,NA,NA,552,"63e408f45e4b88e187c2ebb6b015764586d5ae05","2020-04-18T20:00:00Z",7,68,11661,11660,11660,46,0,5,467,131,598
"327",20200418,"TN",6762,83824,NA,NA,719,NA,NA,NA,NA,3234,"d775321820b86101ebf8a3437f125acfcc909d18","2020-04-18T20:00:00Z",145,719,90586,90586,90586,47,3,8,3140,173,3313
"328",20200418,"TX",18260,157979,NA,1321,NA,NA,NA,NA,NA,4806,"21eb573f5111b59ca48c587165ac1b22e4dc74e4","2020-04-18T20:00:00Z",453,NA,176239,176239,176239,48,25,0,5814,889,6703
"329",20200418,"UT",2931,57013,NA,NA,251,NA,NA,NA,NA,565,"543bc8845f617c2fc7fdf1c0b5baca4a71413e4e","2020-04-18T20:00:00Z",25,251,59944,59944,59944,49,2,7,4047,126,4173
"330",20200418,"VA",8053,43878,486,1307,1296,398,NA,230,NA,1228,"0ba994d2be950ed6b9023307d6ed059b6be70d6a","2020-04-18T20:00:00Z",258,1296,52417,51931,51931,51,27,75,2372,562,2934
"331",20200418,"VI",53,390,35,NA,NA,NA,NA,NA,NA,46,"671d457b1cf63196b9c46ef63410e667b8117957","2020-04-18T20:00:00Z",3,NA,478,443,443,78,1,0,17,2,19
"332",20200418,"VT",803,11763,NA,56,NA,NA,NA,NA,NA,15,"36960d6661dba9cc126639823445d0cfbcd55a3f","2020-04-18T20:00:00Z",38,NA,12566,12566,12566,50,3,0,426,24,450
"333",20200418,"WA",11829,120182,NA,518,NA,155,NA,NA,NA,NA,"2fa973a713a045eff97a1419078fcdfaca307de7","2020-04-18T20:00:00Z",603,NA,132011,132011,132011,53,20,0,2434,211,2645
"334",20200418,"WI",4199,43962,229,361,1176,135,307,NA,NA,NA,"c8533bced41a10a9ce61ad9d9def36404b71d154","2020-04-18T20:00:00Z",211,1176,48390,48161,48161,55,6,23,1597,154,1751
"335",20200418,"WV",785,18655,NA,83,NA,40,NA,27,NA,255,"a75aca4c21fff87eb0ae0f470119102cf9033ec1","2020-04-18T20:00:00Z",16,NA,19440,19440,19440,54,3,0,728,31,759
"336",20200418,"WY",305,6217,NA,19,50,NA,NA,NA,NA,206,"be9193c6ea5170561593d1cbbd0bd8ec3c02ccdc","2020-04-18T20:00:00Z",2,50,6522,6522,6522,56,0,7,86,9,95
"337",20200417,"AK",309,9141,NA,NA,36,NA,NA,NA,NA,128,"c3c164894704f8aebee11fc4f6ad0bc28ccd9bcd","2020-04-17T20:00:00Z",9,36,9450,9450,9450,2,0,1,706,9,715
"338",20200417,"AL",4530,33318,NA,NA,594,NA,247,NA,148,NA,"45dcb973e5afc9f133feabe69f3dd9bee397039d","2020-04-17T20:00:00Z",144,594,37848,37848,37848,1,11,41,1272,185,1457
"339",20200417,"AR",1695,21799,NA,83,NA,NA,NA,21,NA,593,"00867f9f13791928c5808e7a74ea2b0977d4156b","2020-04-17T20:00:00Z",37,NA,23494,23494,23494,5,0,0,744,75,819
"340",20200417,"AS",0,3,17,NA,NA,NA,NA,NA,NA,NA,"90ca343d5718470453e1b9cee714cd1df362e638","2020-04-17T20:00:00Z",NA,NA,20,3,3,60,0,0,0,0,0
"341",20200417,"AZ",4507,44723,NA,566,NA,285,NA,178,NA,539,"fb9ae32e3ee2c773d7e1d5128b796e95fe258990","2020-04-17T20:00:00Z",169,NA,49230,49230,49230,4,19,0,1559,273,1832
"342",20200417,"CA",27528,224086,7200,4892,NA,1484,NA,NA,NA,NA,"0848a86720c79066de7797bb7080a731c9a49879","2020-04-17T20:00:00Z",985,NA,258814,251614,251614,6,95,0,3868,1346,5214
"343",20200417,"CO",8675,33155,NA,858,1693,NA,NA,NA,NA,NA,"7bfd6ed89a0f9cc44bd6bd15e24dbe0b2f78465d","2020-04-17T20:00:00Z",374,1693,41830,41830,41830,8,17,57,902,395,1297
"344",20200417,"CT",16809,38653,NA,1946,NA,NA,NA,NA,NA,NA,"937ae531cbd43b25e4861134fd7b1c3d108019b8","2020-04-17T20:00:00Z",1036,NA,55462,55462,55462,9,65,0,1415,925,2340
"345",20200417,"DC",2476,10167,NA,313,NA,105,NA,79,NA,573,"324321d343090fa89ad61fc4763554ddaf591b02","2020-04-17T20:00:00Z",86,NA,12643,12643,12643,11,5,0,367,126,493
"346",20200417,"DE",2323,11694,NA,224,NA,NA,NA,NA,NA,423,"fa6c14a855f5d451c0d2917f1fa32b0be9c906cb","2020-04-17T20:00:00Z",61,NA,14017,14017,14017,10,9,0,419,248,667
"347",20200417,"FL",24119,210718,1285,NA,3665,NA,NA,NA,NA,NA,"8a55e8a0ee83d8d7159d1859c7f34038d348c42c","2020-04-17T20:00:00Z",699,3665,236122,234837,234837,12,53,205,14367,1222,15589
"348",20200417,"GA",17194,54490,NA,NA,3324,NA,NA,NA,NA,NA,"cf9cb75a5ed95172d0970a1fb552b6b3aeee75b3","2020-04-17T20:00:00Z",650,3324,71684,71684,71684,13,63,216,2220,1525,3745
"349",20200417,"GU",136,940,NA,6,NA,2,NA,NA,NA,97,"00e66352d45b488be874cc6e1fae2eac242f96b1","2020-04-17T20:00:00Z",5,NA,1076,1076,1076,66,0,0,70,1,71
"350",20200417,"HI",541,21316,NA,NA,45,NA,NA,NA,NA,374,"65fd57da094ad148b31cf321853505cad29cf13b","2020-04-17T20:00:00Z",9,45,21857,21857,21857,15,0,0,1146,11,1157
"351",20200417,"IA",2332,19460,NA,183,NA,88,NA,52,NA,1007,"743c17c0be91e3dcd96023a0b17550b906833fd6","2020-04-17T20:00:00Z",64,NA,21792,21792,21792,19,4,0,926,191,1117
"352",20200417,"ID",1609,14574,NA,NA,148,NA,51,NA,NA,390,"f668581521143edad8f8ab891e5a5c833811e568","2020-04-17T20:00:00Z",41,148,16183,16183,16183,16,0,5,330,22,352
"353",20200417,"IL",27575,102588,NA,4454,NA,1196,NA,777,NA,NA,"aed86e4a64aa42a61dd9b9d90b80ddc6f0f8f313","2020-04-17T20:00:00Z",1134,NA,130163,130163,130163,17,62,0,5732,1842,7574
"354",20200417,"IN",10154,44631,NA,NA,NA,638,NA,417,NA,NA,"fb891b635ab79ac5879b853cd6f286a95af310ec","2020-04-17T20:00:00Z",519,NA,54785,54785,54785,18,42,0,3058,612,3670
"355",20200417,"KS",1705,15196,NA,NA,375,NA,NA,NA,NA,NA,"7b4bfcfe6666776c87956a66fe9418794c69a39e","2020-04-17T20:00:00Z",84,375,16901,16901,16901,20,4,16,662,117,779
"356",20200417,"KY",2429,27318,NA,477,971,333,506,NA,NA,956,"959ae2f4da8c8312c664905ee46889190838e629","2020-04-17T20:00:00Z",129,971,29747,29747,29747,21,7,164,1285,138,1423
"357",20200417,"LA",23118,108869,NA,1868,NA,NA,NA,363,NA,NA,"e81028ceb787333a5d374df0bbc6e18dee65512e","2020-04-17T20:00:00Z",1213,NA,131987,131987,131987,22,57,0,4815,586,5401
"358",20200417,"MA",34402,114342,NA,3766,2340,987,NA,NA,NA,NA,"e924eed8760be6c791fe57b9edf59f1fa8c58425","2020-04-17T20:00:00Z",1404,2340,148744,148744,148744,25,159,0,5750,2221,7971
"359",20200417,"MD",11572,50437,NA,NA,2612,NA,NA,NA,NA,736,"dc86a5af2a6ca80e088e2e808f6cc34a9a5cfcce","2020-04-17T20:00:00Z",425,2612,62009,62009,62009,24,33,161,2378,788,3166
"360",20200417,"ME",827,14076,NA,55,133,28,NA,8,NA,352,"0d4df50e7aab010ceeaf7b19f540dad2653da0e7","2020-04-17T20:00:00Z",29,133,14903,14903,14903,23,2,3,0,31,31
"361",20200417,"MI",30023,68936,NA,3674,NA,1428,NA,1167,NA,629,"d06230acbb65a805506492581bba6e586293d304","2020-04-17T20:00:00Z",2227,NA,98959,98959,98959,26,134,0,3913,760,4673
"362",20200417,"MN",2071,40982,NA,223,518,106,202,NA,NA,1066,"5733dd18761393e8548530c42a910ad330964388","2020-04-17T20:00:00Z",111,518,43053,43053,43053,27,17,43,1219,159,1378
"363",20200417,"MO",5283,46434,NA,1043,NA,NA,NA,NA,NA,NA,"0455d0d245866e7d682abab839b2bd17ceea0edb","2020-04-17T20:00:00Z",165,NA,51717,51717,51717,29,13,0,897,172,1069
"364",20200417,"MP",13,42,4,NA,NA,NA,NA,NA,NA,NA,"5d1e30c8e3fde663e5fbe35f229964ef81e56f79","2020-04-17T20:00:00Z",2,NA,59,55,55,69,0,0,15,0,15
"365",20200417,"MS",3793,34791,NA,NA,736,154,NA,99,NA,NA,"be3208b4f3448e30b365470dbe34fd2a5ba5cd32","2020-04-17T20:00:00Z",140,736,38584,38584,38584,28,11,54,0,169,169
"366",20200417,"MT",422,9822,NA,21,54,NA,NA,NA,NA,233,"dcf104975fe661e77fdee7292f708972ddb7704a","2020-04-17T20:00:00Z",8,54,10244,10244,10244,30,1,2,301,7,308
"367",20200417,"NC",5859,67122,NA,429,NA,NA,NA,NA,NA,NA,"36c22ac0ce8eb3827d8f24b776cd22bd31759e27","2020-04-17T20:00:00Z",152,NA,72981,72981,72981,37,21,0,1670,394,2064
"368",20200417,"ND",439,11903,NA,16,47,NA,NA,NA,NA,172,"8ebc1913ded71278974a8df56e399b01f3967ba7","2020-04-17T20:00:00Z",9,47,12342,12342,12342,38,0,2,592,46,638
"369",20200417,"NE",1066,12038,NA,NA,NA,NA,NA,NA,NA,NA,"702131468cb79aacf355dfbccdebdd04ece74fee","2020-04-17T20:00:00Z",24,NA,13104,13104,13104,31,3,0,696,114,810
"370",20200417,"NH",1287,11421,174,74,190,NA,NA,NA,NA,455,"b50f444c0fe2cf7ed5056d353436c1e4e873fcec","2020-04-17T20:00:00Z",37,190,12882,12708,12708,33,5,12,394,148,542
"371",20200417,"NJ",78467,78982,NA,8011,NA,1961,NA,1594,NA,NA,"7722a23203ac41ff398af795fcc2094c7bd24cde","2020-04-17T20:00:00Z",3840,NA,157449,157449,157449,34,322,0,2469,3150,5619
"372",20200417,"NM",1597,32891,NA,90,230,NA,NA,NA,NA,353,"26835a1513b9e3079e2a32db9346f8a0485e1247","2020-04-17T20:00:00Z",44,230,34488,34488,34488,35,8,15,981,113,1094
"373",20200417,"NV",3524,26238,NA,NA,NA,NA,NA,NA,NA,NA,"3c0f7214c9269e3f1b5a0e0880e540abee1e0183","2020-04-17T20:00:00Z",142,NA,29762,29762,29762,32,5,0,1108,203,1311
"374",20200417,"NY",229642,343581,NA,17156,52424,5059,NA,NA,NA,23887,"8911812f87dcd85e5d5aab63eb027027390e68a5","2020-04-17T20:00:00Z",12822,52424,573223,573223,573223,36,630,1974,15286,7358,22644
"375",20200417,"OH",8858,68819,NA,NA,2424,NA,740,NA,NA,NA,"366867b8710ccb4873954bcf3720e21dd872cc38","2020-04-17T20:00:00Z",418,2424,77677,77677,77677,39,29,93,2393,444,2837
"376",20200417,"OK",2465,31155,NA,325,528,155,NA,NA,NA,1331,"603ffb4b425ba80e433b8ba7de9827da0e6ecfa6","2020-04-17T20:00:00Z",136,528,33620,33620,33620,40,5,0,2613,108,2721
"377",20200417,"OR",1785,34536,NA,301,427,69,NA,41,NA,NA,"88ad63feef7a476846b281e7a5ca0d06f5a2b9bf","2020-04-17T20:00:00Z",70,427,36321,36321,36321,41,6,13,1334,49,1383
"378",20200417,"PA",29441,117932,NA,2603,NA,NA,NA,661,NA,NA,"7753812f0b3fd92934a49267cfdee8d8704d2188","2020-04-17T20:00:00Z",756,NA,147373,147373,147373,42,49,0,4197,1706,5903
"379",20200417,"PR",1068,7864,1478,NA,NA,NA,NA,NA,NA,NA,"2679d31cdf8d9a2bfe948e85ac5ab1ff133a8ffc","2020-04-17T20:00:00Z",58,NA,10410,8932,8932,72,2,0,549,25,574
"380",20200417,"RI",4177,26584,NA,252,331,62,NA,43,NA,196,"c63aa5aaf5bfd7ac7c785015118a59aae01aa1bb","2020-04-17T20:00:00Z",118,331,30761,30761,30761,44,13,0,2358,339,2697
"381",20200417,"SC",3931,32353,NA,NA,675,NA,NA,NA,NA,NA,"1831fa1707525e22e14e5bd9c3004469a2a5db12","2020-04-17T20:00:00Z",109,675,36284,36284,36284,45,2,0,1276,275,1551
"382",20200417,"SD",1411,9651,0,NA,63,NA,NA,NA,NA,457,"ab6d709096e5bc28e2d2b8e89f43ed3dda957bcf","2020-04-17T20:00:00Z",7,63,11062,11062,11062,46,0,8,412,100,512
"383",20200417,"TN",6589,80684,NA,NA,711,NA,NA,NA,NA,3017,"14d476e6bb2b3510a4bd87e166ee3fd62ea61bbc","2020-04-17T20:00:00Z",142,711,87273,87273,87273,47,1,20,1897,327,2224
"384",20200417,"TX",17371,152165,NA,1522,NA,NA,NA,NA,NA,4190,"8623aff77e66ba45458a1b0a3bd58bdf7003ffa3","2020-04-17T20:00:00Z",428,NA,169536,169536,169536,48,35,0,10073,916,10989
"385",20200417,"UT",2805,52966,NA,NA,244,NA,NA,NA,NA,443,"e4d62921a010ad39f3d55f9106fcd9e0803a7648","2020-04-17T20:00:00Z",23,244,55771,55771,55771,49,2,6,5971,122,6093
"386",20200417,"VA",7491,41506,499,1308,1221,400,NA,224,NA,1110,"ff7ccb63ac538a9363756f8828b0f638e720c076","2020-04-17T20:00:00Z",231,1221,49496,48997,48997,51,23,107,1951,602,2553
"387",20200417,"VI",51,373,34,NA,NA,NA,NA,NA,NA,46,"d7c7429bb77548894a0b2ec5bdb55b2b75c80c25","2020-04-17T20:00:00Z",2,NA,458,424,424,78,1,0,16,0,16
"388",20200417,"VT",779,11337,NA,32,NA,NA,NA,NA,NA,15,"9e438cc9be758290e0a6f4a230c492d486348ddd","2020-04-17T20:00:00Z",35,NA,12116,12116,12116,50,0,0,598,11,609
"389",20200417,"WA",11618,117748,NA,622,NA,195,NA,NA,NA,NA,"36ef5ca4dcb2056bd35f89d34ea8ae353241c783","2020-04-17T20:00:00Z",583,NA,129366,129366,129366,53,16,0,4248,328,4576
"390",20200417,"WI",4045,42365,198,361,1153,141,306,348,NA,NA,"c9ef889d54f4bfde0ead54b94940b942c3470029","2020-04-17T20:00:00Z",205,1153,46608,46410,46410,55,8,32,1391,170,1561
"391",20200417,"WV",754,17927,NA,85,NA,34,NA,24,NA,223,"ad31b1e4321ce885951bf5265875a40b6bb326a5","2020-04-17T20:00:00Z",13,NA,18681,18681,18681,54,0,0,360,15,375
"392",20200417,"WY",296,6131,NA,19,43,NA,NA,NA,NA,148,"642a8ad48c6d39a9b280ab3d557e5b93916c72ca","2020-04-17T20:00:00Z",2,43,6427,6427,6427,56,0,0,0,0,0
"393",20200416,"AK",300,8435,NA,NA,35,NA,NA,NA,NA,110,"42353f78693987154276c7c482342a46ec11c180","2020-04-16T20:00:00Z",9,35,8735,8735,8735,2,0,1,64,7,71
"394",20200416,"AL",4345,32046,NA,NA,553,NA,227,NA,137,NA,"bc8d87a6ade709e9ed0c8824e73dff454277a85f","2020-04-16T20:00:00Z",133,553,36391,36391,36391,1,12,28,2082,232,2314
"395",20200416,"AR",1620,21055,NA,85,NA,NA,NA,21,NA,548,"95e15a426548163accca607e39e7c97a7e229f6e","2020-04-16T20:00:00Z",37,NA,22675,22675,22675,5,4,0,790,51,841
"396",20200416,"AS",0,3,17,NA,NA,NA,NA,NA,NA,NA,"614a57a963d84c55c40b863aaf08221f68f0387c","2020-04-16T20:00:00Z",NA,NA,20,3,3,60,0,0,0,0,0
"397",20200416,"AZ",4234,43164,NA,578,NA,278,NA,188,NA,460,"1a168d4509dfc562564670fbcf91399c32b0981a","2020-04-16T20:00:00Z",150,NA,47398,47398,47398,4,8,0,1816,272,2088
"398",20200416,"CA",26182,220218,13200,5031,NA,1568,NA,NA,NA,NA,"5dcfd2b30974d93b8a73329bff070f19d3c6b04f","2020-04-16T20:00:00Z",890,NA,259600,246400,246400,6,69,0,28156,1758,29914
"399",20200416,"CO",8280,32253,NA,859,1636,NA,NA,NA,NA,NA,"5ab00d24748f984e874dbb1cec5d4e0baa5bc875","2020-04-16T20:00:00Z",357,1636,40533,40533,40533,8,28,80,614,339,953
"400",20200416,"CT",15884,37238,NA,1926,NA,NA,NA,NA,NA,NA,"1bb94dbdf022f3759ed20948cdbc345e04c11271","2020-04-16T20:00:00Z",971,NA,53122,53122,53122,9,103,0,1850,1129,2979
"401",20200416,"DC",2350,9800,NA,313,NA,105,NA,79,NA,552,"100abd89bf88d9f88b0684c7fd04cc5c47fdbb60","2020-04-16T20:00:00Z",81,NA,12150,12150,12150,11,9,0,472,153,625
"402",20200416,"DE",2075,11275,NA,209,NA,NA,NA,NA,NA,378,"dd363b6c3c0463e2a6e649df8585db9df967656e","2020-04-16T20:00:00Z",52,NA,13350,13350,13350,10,6,0,187,61,248
"403",20200416,"FL",22897,196351,1325,NA,3460,NA,NA,NA,NA,NA,"06c954c644a662900c772814ef2f221fa53f2cfb","2020-04-16T20:00:00Z",646,3460,220573,219248,219248,12,37,116,5353,386,5739
"404",20200416,"GA",15669,52270,NA,NA,3108,NA,NA,NA,NA,NA,"8aaf9eeaa61c479d5fbdec370b859848240cbb24","2020-04-16T20:00:00Z",587,3108,67939,67939,67939,13,35,186,3167,682,3849
"405",20200416,"GU",135,870,NA,9,NA,NA,NA,NA,NA,86,"0107b4ce28700584446b713b915b5f313941df7f","2020-04-16T20:00:00Z",5,NA,1005,1005,1005,66,0,0,27,0,27
"406",20200416,"HI",530,20170,NA,NA,45,NA,NA,NA,NA,359,"e33b0740a6789b0e6c49839355dc5383946c7e82","2020-04-16T20:00:00Z",9,45,20700,20700,20700,15,0,0,884,13,897
"407",20200416,"IA",2141,18534,NA,175,NA,84,NA,48,NA,987,"811a574b1b6eb83be03e008db2fb01e26663f57a","2020-04-16T20:00:00Z",60,NA,20675,20675,20675,19,7,0,660,146,806
"408",20200416,"ID",1587,14244,NA,NA,143,NA,46,NA,NA,NA,"2760055f6b99a310921a9e6d1a2ed07aae6c7b81","2020-04-16T20:00:00Z",41,143,15831,15831,15831,16,2,2,310,123,433
"409",20200416,"IL",25733,96856,NA,4423,NA,1248,NA,797,NA,NA,"23ce0bf16b1ad45da236bf0f2008ea9c7690fa8f","2020-04-16T20:00:00Z",1072,NA,122589,122589,122589,17,124,0,4520,1140,5660
"410",20200416,"IN",9542,41573,NA,NA,NA,696,NA,426,NA,NA,"2927dc0fb6c1d5ce0ee783aad32fe18025ac0c3d","2020-04-16T20:00:00Z",477,NA,51115,51115,51115,18,41,0,2132,587,2719
"411",20200416,"KS",1588,14534,NA,NA,359,NA,NA,NA,NA,NA,"f575d83d57c7f02002f57572833006ef35cd7045","2020-04-16T20:00:00Z",80,359,16122,16122,16122,20,4,17,1360,94,1454
"412",20200416,"KY",2291,26033,NA,412,807,252,367,NA,NA,862,"cf873721a2821eccf77c5806ad0e9bf84eead44a","2020-04-16T20:00:00Z",122,807,28324,28324,28324,21,7,120,546,81,627
"413",20200416,"LA",22532,104054,NA,1914,NA,NA,NA,396,NA,NA,"6ae3a5f7f0b1e1a5c00710d1a5571702dfbff14c","2020-04-16T20:00:00Z",1156,NA,126586,126586,126586,22,53,0,4077,581,4658
"414",20200416,"MA",32181,108592,NA,3729,2340,973,NA,NA,NA,NA,"0425ffa52b8579292fdb23fe4553389cbbf419b9","2020-04-16T20:00:00Z",1245,2340,140773,140773,140773,25,137,0,6487,2263,8750
"415",20200416,"MD",10784,48059,NA,NA,2451,NA,NA,NA,NA,736,"d56e3e4ce6ef5676611c0e85ddcb6285cc9b16f3","2020-04-16T20:00:00Z",392,2451,58843,58843,58843,24,43,220,2328,752,3080
"416",20200416,"ME",796,14076,NA,47,130,20,NA,7,NA,333,"be0574a2f960338b2bd6f86c05096a5e3efe7620","2020-04-16T20:00:00Z",27,130,14872,14872,14872,23,3,4,0,26,26
"417",20200416,"MI",29263,65023,NA,3809,NA,1447,NA,1211,NA,617,"fc2f4153662699af6660687292deea26fb89bd6f","2020-04-16T20:00:00Z",2093,NA,94286,94286,94286,26,172,0,3385,1204,4589
"418",20200416,"MN",1912,39763,NA,213,475,103,188,NA,NA,1020,"b833be00de318500a4f0801f2a296db180d26ee7","2020-04-16T20:00:00Z",94,475,41675,41675,41675,27,7,30,1330,103,1433
"419",20200416,"MO",5111,45537,NA,1043,NA,NA,NA,NA,NA,NA,"53b0c28902cfc5e79cd3ef99c641acc23be5c41c","2020-04-16T20:00:00Z",152,NA,50648,50648,50648,29,5,0,1420,216,1636
"420",20200416,"MP",13,27,7,NA,NA,NA,NA,NA,NA,NA,"7d544f5f807e9f8c276238d3a04583cea4a44be8","2020-04-16T20:00:00Z",2,NA,47,40,40,69,0,0,0,0,0
"421",20200416,"MS",3624,34791,NA,NA,682,154,NA,99,NA,NA,"5717e19e747db660898e4565434b15677e31d469","2020-04-16T20:00:00Z",129,682,38415,38415,38415,28,7,37,0,264,264
"422",20200416,"MT",415,9521,NA,21,52,NA,NA,NA,NA,218,"99cabfac3936ec988dc0c385d4bee214e6ecb79e","2020-04-16T20:00:00Z",7,52,9936,9936,9936,30,0,1,342,11,353
"423",20200416,"NC",5465,65452,NA,452,NA,NA,NA,NA,NA,NA,"a2c94ae3b889dfdf1066125f7d3d2876e246863a","2020-04-16T20:00:00Z",131,NA,70917,70917,70917,37,14,0,2748,342,3090
"424",20200416,"ND",393,11311,NA,14,45,NA,NA,NA,NA,163,"7c3e7659bc28e4b0d83b64339e64eb138aa67867","2020-04-16T20:00:00Z",9,45,11704,11704,11704,38,0,1,359,28,387
"425",20200416,"NE",952,11342,NA,NA,NA,NA,NA,NA,NA,NA,"8b2863e154a48cb4ef39054af406ec77527e3bd7","2020-04-16T20:00:00Z",21,NA,12294,12294,12294,31,1,0,514,51,565
"426",20200416,"NH",1139,11027,121,70,178,NA,NA,NA,NA,365,"6397ebd7f9ef6f49d37c39a9cd815134cc8c6cec","2020-04-16T20:00:00Z",32,178,12287,12166,12166,33,0,0,0,0,0
"427",20200416,"NJ",75317,76513,NA,8224,NA,2014,NA,1645,NA,NA,"8f04a2a6fb4ff0d2e41da80b7bca3da6ae2279ff","2020-04-16T20:00:00Z",3518,NA,151830,151830,151830,34,362,0,3522,4287,7809
"428",20200416,"NM",1484,31910,NA,90,215,NA,NA,NA,NA,353,"e5c87a0fafb5269e348f0ecb57470090ffb7e441","2020-04-16T20:00:00Z",36,215,33394,33394,33394,35,0,34,467,77,544
"429",20200416,"NV",3321,25130,NA,NA,NA,NA,NA,NA,NA,NA,"d6b686120e1dfc653a79c73a2e541bc0063949c6","2020-04-16T20:00:00Z",137,NA,28451,28451,28451,32,6,0,686,110,796
"430",20200416,"NY",222284,328295,NA,17735,50450,5091,NA,NA,NA,23887,"bd386393a80d22e8b4638b53c9a00a316b7c209a","2020-04-16T20:00:00Z",12192,50450,550579,550579,550579,36,606,4249,16062,8505,24567
"431",20200416,"OH",8414,66426,NA,NA,2331,NA,707,NA,NA,NA,"d2f0dea6e94f7fef69d41e2dbbead2143d030efd","2020-04-16T20:00:00Z",389,2331,74840,74840,74840,39,28,94,2665,623,3288
"432",20200416,"OK",2357,28542,NA,236,528,163,NA,NA,NA,1240,"34565e51b7a75892769360e0777101a5ee4a420b","2020-04-16T20:00:00Z",131,528,30899,30899,30899,40,8,18,1586,94,1680
"433",20200416,"OR",1736,33202,NA,307,414,89,NA,43,NA,NA,"7687b415f103f263c88274f27175bd5f223e0fcf","2020-04-16T20:00:00Z",64,414,34938,34938,34938,41,6,13,1514,73,1587
"434",20200416,"PA",27735,113735,NA,2512,NA,NA,NA,675,NA,NA,"3451836d13d960a278308c0a8bc877668376fda8","2020-04-16T20:00:00Z",707,NA,141470,141470,141470,42,60,0,2641,1245,3886
"435",20200416,"PR",1043,7315,1465,NA,NA,NA,NA,NA,NA,NA,"0f1b0b0eccfdaeeafea3a6c037a304b113bb219d","2020-04-16T20:00:00Z",56,NA,9823,8358,8358,72,5,0,490,69,559
"436",20200416,"RI",3838,24226,NA,245,331,61,NA,43,NA,182,"bb544990f7c3e3da791f26108024f6657594c9c3","2020-04-16T20:00:00Z",105,331,28064,28064,28064,44,18,0,1858,309,2167
"437",20200416,"SC",3656,31077,NA,NA,675,NA,NA,NA,NA,NA,"4f595f8157dc108d79c5c84582734e32cad3cfe9","2020-04-16T20:00:00Z",107,675,34733,34733,34733,45,0,0,0,0,0
"438",20200416,"SD",1311,9239,2,NA,55,NA,NA,NA,NA,373,"acf65b2256b92f503485645dfd2318e10c6517d8","2020-04-16T20:00:00Z",7,55,10552,10550,10550,46,1,4,548,143,691
"439",20200416,"TN",6262,78787,NA,NA,691,NA,NA,NA,NA,2786,"eaf32844c68a683d76188caaa701c09a801e5a95","2020-04-16T20:00:00Z",141,691,85049,85049,85049,47,6,28,3970,183,4153
"440",20200416,"TX",16455,142092,NA,1459,NA,NA,NA,NA,NA,3677,"f5a1a7a1a57afbec5a59835798a8bafb84e8d661","2020-04-16T20:00:00Z",393,NA,158547,158547,158547,48,29,0,5774,963,6737
"441",20200416,"UT",2683,46995,NA,NA,238,NA,NA,NA,NA,357,"4c78de52111a12808864cd3f24c4421ed0ed2e16","2020-04-16T20:00:00Z",21,238,49678,49678,49678,49,1,17,1923,141,2064
"442",20200416,"VA",6889,39555,537,1337,1114,427,NA,238,NA,951,"eae55eac787f3e4c2e73870cc66c941eb81919a5","2020-04-16T20:00:00Z",208,1114,46981,46444,46444,51,13,66,1886,389,2275
"443",20200416,"VI",51,357,35,NA,NA,NA,NA,NA,NA,46,"143c5d6649137d1edc42de6a5dd0031c456f3d4f","2020-04-16T20:00:00Z",1,NA,443,408,408,78,0,0,26,0,26
"444",20200416,"VT",768,10739,NA,58,NA,NA,NA,NA,NA,15,"1ea60000d2e949646925602b03e1fd49dd2bfeef","2020-04-16T20:00:00Z",35,NA,11507,11507,11507,50,5,0,417,9,426
"445",20200416,"WA",11290,113500,NA,595,NA,196,NA,NA,NA,NA,"6a901351a5da9d316e0bc63ff2609d7f97d20c39","2020-04-16T20:00:00Z",567,NA,124790,124790,124790,53,26,0,1340,242,1582
"446",20200416,"WI",3875,40974,218,394,1121,147,299,NA,NA,NA,"b489f85e57a1a10a130ad9b1a778b36f397c01ab","2020-04-16T20:00:00Z",197,1121,45067,44849,44849,55,15,30,1648,154,1802
"447",20200416,"WV",739,17567,NA,85,NA,34,NA,24,NA,223,"05b379c922d4696ed601bea890c1897fb79d5174","2020-04-16T20:00:00Z",13,NA,18306,18306,18306,54,3,0,613,37,650
"448",20200416,"WY",296,6131,NA,19,43,NA,NA,NA,NA,148,"e5c5dc72231ac86d9fbfe8b9c6bd9ee605b3943c","2020-04-16T20:00:00Z",2,43,6427,6427,6427,56,0,0,89,9,98
"449",20200415,"AK",293,8371,NA,NA,34,NA,NA,NA,NA,106,"673f84f2ad0944b787570c22a3fa5081f0dee21a","2020-04-15T20:00:00Z",9,34,8664,8664,8664,2,0,2,308,8,316
"450",20200415,"AL",4113,29964,NA,NA,525,NA,219,NA,134,NA,"b67f0835fabad299a3701a2e6ba8f3214f60186b","2020-04-15T20:00:00Z",121,525,34077,34077,34077,1,11,32,723,237,960
"451",20200415,"AR",1569,20265,NA,83,130,NA,43,26,39,489,"3d44b421c28add57d694ce93d5d4fb0c52b4f1f1","2020-04-15T20:00:00Z",33,130,21834,21834,21834,5,3,0,614,89,703
"452",20200415,"AS",0,3,17,NA,NA,NA,NA,NA,NA,NA,"8e1b2a94a99618ad907f782452421342c293290e","2020-04-15T20:00:00Z",NA,NA,20,3,3,60,0,0,0,0,0
"453",20200415,"AZ",3962,41348,NA,590,NA,286,NA,202,NA,385,"cced5a2b57e0eb8fe4113e4fc7de313b92761598","2020-04-15T20:00:00Z",142,NA,45310,45310,45310,4,11,0,1058,156,1214
"454",20200415,"CA",24424,192062,13200,5163,NA,1175,NA,NA,NA,NA,"07566a23b8d837a8af05eb08dd1bbc9beabd8fef","2020-04-15T20:00:00Z",821,NA,229686,216486,216486,6,63,0,13192,1086,14278
"455",20200415,"CO",7941,31639,NA,878,1556,NA,NA,NA,NA,NA,"178915c7cf54d7841b476b3396ad50ac5e2fade6","2020-04-15T20:00:00Z",329,1556,39580,39580,39580,8,21,63,588,250,838
"456",20200415,"CT",14755,35388,NA,1908,NA,NA,NA,NA,NA,NA,"2d22b602de0610e18d57043cc51080f8edba9a01","2020-04-15T20:00:00Z",868,NA,50143,50143,50143,9,197,0,3536,766,4302
"457",20200415,"DC",2197,9328,NA,313,NA,105,NA,79,NA,530,"40f095fc5893e7b59e1156d52eef137249615c15","2020-04-15T20:00:00Z",72,NA,11525,11525,11525,11,5,0,102,139,241
"458",20200415,"DE",2014,11088,NA,208,NA,NA,NA,NA,NA,354,"16da060a7231775a11a6c916d60f30170d958dec","2020-04-15T20:00:00Z",46,NA,13102,13102,13102,10,5,0,545,253,798
"459",20200415,"FL",22511,190998,1335,NA,3344,NA,NA,NA,NA,NA,"f8fa87d0742465433075ca7eaf8ea8118844a595","2020-04-15T20:00:00Z",609,3344,214844,213509,213509,12,72,284,9185,1144,10329
"460",20200415,"GA",14987,49103,NA,NA,2922,NA,NA,NA,NA,NA,"cae9735f50c95ddb53ba6d92a2f2b3fcddd93e6c","2020-04-15T20:00:00Z",552,2922,64090,64090,64090,13,51,153,1531,764,2295
"461",20200415,"GU",135,843,NA,9,NA,2,NA,2,NA,73,"8d1942c5bf59b1ff47c23035904164b11b51ca62","2020-04-15T20:00:00Z",5,NA,978,978,978,66,0,0,32,0,32
"462",20200415,"HI",517,19286,NA,NA,45,NA,NA,NA,NA,333,"a714a697aec8c9b1f06e2418ad98376f9995f6cf","2020-04-15T20:00:00Z",9,45,19803,19803,19803,15,0,1,370,13,383
"463",20200415,"IA",1995,17874,NA,171,NA,78,NA,43,NA,908,"325bab5cc4423ccded984dc754f6627f5de425ef","2020-04-15T20:00:00Z",53,NA,19869,19869,19869,19,4,0,888,96,984
"464",20200415,"ID",1464,13934,NA,NA,141,NA,43,NA,NA,NA,"47b70ce8d525ccfe2bdcc36bf60c815557d3ef29","2020-04-15T20:00:00Z",39,141,15398,15398,15398,16,6,6,273,11,284
"465",20200415,"IL",24593,92336,NA,4283,NA,1189,NA,796,NA,NA,"0c46a8e1185cbf2da83f959bc450567d3e657902","2020-04-15T20:00:00Z",948,NA,116929,116929,116929,17,80,0,4967,1346,6313
"466",20200415,"IN",8955,39441,NA,NA,NA,737,NA,422,NA,NA,"2e66ab2081462fe7175b10cf71954f89ee0bd970","2020-04-15T20:00:00Z",436,NA,48396,48396,48396,18,48,0,1951,428,2379
"467",20200415,"KS",1494,13174,NA,NA,342,NA,NA,NA,NA,NA,"741290e76dc8a96f228e1b1f0265839274c1bb2f","2020-04-15T20:00:00Z",76,342,14668,14668,14668,20,7,15,453,68,521
"468",20200415,"KY",2210,25487,NA,305,687,137,263,NA,NA,653,"7a9d1b012f945c1b95c8ae33f3e74905cb97db2c","2020-04-15T20:00:00Z",115,687,27697,27697,27697,21,11,14,852,162,1014
"469",20200415,"LA",21951,99977,NA,1943,NA,NA,NA,425,NA,NA,"4867cbef72b802351bee7b6a64aeb28b6cf873ea","2020-04-15T20:00:00Z",1103,NA,121928,121928,121928,22,90,0,3073,433,3506
"470",20200415,"MA",29918,102105,NA,3635,2340,973,NA,NA,NA,NA,"7935d1488b039a3764464b73e82ca6c09f1ab0bb","2020-04-15T20:00:00Z",1108,2340,132023,132023,132023,25,151,0,3717,1755,5472
"471",20200415,"MD",10032,45731,NA,NA,2231,NA,NA,NA,NA,607,"21fc0ecd1c9792f868faec7e483042e4a31d3ce3","2020-04-15T20:00:00Z",349,2231,55763,55763,55763,24,47,109,1470,560,2030
"472",20200415,"ME",770,14076,NA,48,126,22,NA,9,NA,305,"e9cf94b8fa7dbbd5ae8f4d19a59dc0e95f68bb69","2020-04-15T20:00:00Z",24,126,14846,14846,14846,23,4,2,2468,36,2504
"473",20200415,"MI",28059,61638,NA,3918,NA,1468,NA,1212,NA,452,"c15ad5c7dee7ddd892a0f92c12ece0400b55d4a7","2020-04-15T20:00:00Z",1921,NA,89697,89697,89697,26,153,0,2413,1058,3471
"474",20200415,"MN",1809,38433,NA,197,445,93,175,NA,NA,940,"f1171cb80ab97afa1d029dfd356d4615dc88bfb7","2020-04-15T20:00:00Z",87,445,40242,40242,40242,27,8,40,887,114,1001
"475",20200415,"MO",4895,44117,NA,1024,NA,NA,NA,NA,NA,NA,"6e4be90622adf587d625b5751989a07a554a11af","2020-04-15T20:00:00Z",147,NA,49012,49012,49012,29,14,0,825,209,1034
"476",20200415,"MP",13,27,7,NA,NA,NA,NA,NA,NA,NA,"9e4313b445ebbe0b16760b3bbee331ae6401250e","2020-04-15T20:00:00Z",2,NA,47,40,40,69,0,0,0,0,0
"477",20200415,"MS",3360,34791,NA,NA,645,154,NA,99,NA,NA,"d05e5d2b8e752c0ad1a46b77af0cacd196370dd3","2020-04-15T20:00:00Z",122,645,38151,38151,38151,28,11,49,0,273,273
"478",20200415,"MT",404,9179,NA,21,51,NA,NA,NA,NA,209,"93ecb003f2a23275e2e681d720654a0a2ceabaf8","2020-04-15T20:00:00Z",7,51,9583,9583,9583,30,0,1,344,5,349
"479",20200415,"NC",5123,62704,NA,431,NA,NA,NA,NA,NA,NA,"5f92fc6275e53ffc256dcd7aef4ea36d732744f7","2020-04-15T20:00:00Z",117,NA,67827,67827,67827,37,9,0,2689,99,2788
"480",20200415,"ND",365,10952,NA,13,44,NA,NA,NA,NA,142,"7560537f4933cf30f04500c5b9fa651e3eb9487b","2020-04-15T20:00:00Z",9,44,11317,11317,11317,38,0,2,377,24,401
"481",20200415,"NE",901,10828,NA,NA,NA,NA,NA,NA,NA,NA,"d32127075c9d4b81935ccbceef63e04783cd46e6","2020-04-15T20:00:00Z",20,NA,11729,11729,11729,31,2,0,342,30,372
"482",20200415,"NH",1139,11027,121,70,178,NA,NA,NA,NA,365,"015c02d79a187cd5e8069e8e8b56675ef3310118","2020-04-15T20:00:00Z",32,178,12287,12166,12166,33,9,26,437,119,556
"483",20200415,"NJ",71030,72991,NA,8270,NA,1980,NA,1705,NA,NA,"a1d3be61faebbecb0fb2d8564b474468f1ffdd78","2020-04-15T20:00:00Z",3156,NA,144021,144021,144021,34,351,0,2041,2206,4247
"484",20200415,"NM",1407,31443,NA,87,181,NA,NA,NA,NA,340,"c2a768159fbeb43c1952ca1b95b6da166f99514d","2020-04-15T20:00:00Z",36,181,32850,32850,32850,35,5,0,818,62,880
"485",20200415,"NV",3211,24444,NA,NA,NA,NA,NA,NA,NA,NA,"982c76668c33c42b936979ce9d53140cf470e47d","2020-04-15T20:00:00Z",131,NA,27655,27655,27655,32,11,0,871,123,994
"486",20200415,"NY",213779,312233,NA,18697,46201,5225,NA,NA,NA,23887,"1345a6429c3718d790172d3c91f25184b1df3832","2020-04-15T20:00:00Z",11586,46201,526012,526012,526012,36,752,0,15298,11571,26869
"487",20200415,"OH",7791,63761,NA,NA,2237,NA,677,NA,NA,NA,"ea6e49b055a0ca5556581c489b1856a532675634","2020-04-15T20:00:00Z",361,2237,71552,71552,71552,39,37,81,3040,638,3678
"488",20200415,"OK",2263,26956,NA,194,510,107,NA,NA,NA,1115,"8a12432d26cb2221b2f83b98d44a24500c54d06c","2020-04-15T20:00:00Z",123,510,29219,29219,29219,40,15,22,871,79,950
"489",20200415,"OR",1663,31688,NA,305,401,95,NA,43,NA,NA,"c6fed9f1fa421f55707f0ddac96736083ab45ee8","2020-04-15T20:00:00Z",58,401,33351,33351,33351,41,3,20,958,30,988
"490",20200415,"PA",26490,111094,NA,2395,NA,NA,NA,668,NA,NA,"4318df239342730ed7c96fe01174f84b229181cf","2020-04-15T20:00:00Z",647,NA,137584,137584,137584,42,63,0,2808,1145,3953
"491",20200415,"PR",974,6825,1410,NA,NA,NA,NA,NA,NA,NA,"43474cb427471e7c540223732e9e98269c0e2af1","2020-04-15T20:00:00Z",51,NA,9209,7799,7799,72,6,0,541,51,592
"492",20200415,"RI",3529,22368,NA,229,331,54,NA,44,NA,168,"505c2312cd82df0fdf0f7f2f0985489df7125f75","2020-04-15T20:00:00Z",87,331,25897,25897,25897,44,7,0,2719,278,2997
"493",20200415,"SC",3656,31077,NA,NA,675,NA,NA,NA,NA,NA,"a2abbb9b0fcf19b2af159e4a2079f4942aa3d7ac","2020-04-15T20:00:00Z",107,675,34733,34733,34733,45,10,0,758,103,861
"494",20200415,"SD",1168,8691,0,NA,51,NA,NA,NA,NA,329,"56f54f4b46df7451d1557a1535094be9d8b7334e","2020-04-15T20:00:00Z",6,51,9859,9859,9859,46,0,6,383,180,563
"495",20200415,"TN",6079,74817,NA,NA,663,NA,NA,NA,NA,2196,"2e637ff36a1861115fbebf8ec944d2c97aa82f70","2020-04-15T20:00:00Z",135,663,80896,80896,80896,47,11,30,1809,256,2065
"496",20200415,"TX",15492,136318,NA,1538,NA,NA,NA,NA,NA,3150,"fd169f5a78bd0ac684499791a5ba2f0ee8318a26","2020-04-15T20:00:00Z",364,NA,151810,151810,151810,48,46,0,4475,868,5343
"497",20200415,"UT",2542,45072,NA,NA,221,NA,NA,NA,NA,218,"f1de11bfb56f8f39c4440f1921363b342a5826da","2020-04-15T20:00:00Z",20,221,47614,47614,47614,49,1,8,1008,130,1138
"498",20200415,"VA",6500,37669,496,1298,1048,394,NA,234,NA,752,"7dc829337ed6386ccc773e2f04348f2c7b7a0dbb","2020-04-15T20:00:00Z",195,1048,44665,44169,44169,51,41,1048,1077,329,1406
"499",20200415,"VI",51,331,35,NA,NA,NA,NA,NA,NA,44,"95049b7539010144345654f7a3f6cbe6efbe462f","2020-04-15T20:00:00Z",1,NA,417,382,382,78,0,0,5,0,5
"500",20200415,"VT",759,10322,NA,63,NA,NA,NA,NA,NA,15,"1669256ed2aed8d9f91b715cbbee0c6f85bc77f2","2020-04-15T20:00:00Z",30,NA,11081,11081,11081,50,1,0,489,7,496
"501",20200415,"WA",11048,112160,NA,645,NA,194,NA,NA,NA,NA,"e939c8bb9cb2778ff4e93eb4aded201df8e733b3","2020-04-15T20:00:00Z",541,NA,123208,123208,123208,53,25,0,28769,307,29076
"502",20200415,"WI",3721,39326,280,406,1091,163,290,NA,NA,NA,"d5c12eba567acf1c9e2ee2b9aa915afee64342cb","2020-04-15T20:00:00Z",182,1091,43327,43047,43047,55,12,42,1329,166,1495
"503",20200415,"WV",702,16954,NA,82,164,36,73,23,50,211,"b18a653a4338aadc65598d0fcd0af46e08167006","2020-04-15T20:00:00Z",10,164,17656,17656,17656,54,1,0,556,62,618
"504",20200415,"WY",287,6042,NA,NA,43,NA,NA,NA,NA,129,"5b2e779c0acd3bd8a1d72c7473eacb87867e6039","2020-04-15T20:00:00Z",2,43,6329,6329,6329,56,1,0,353,12,365
"505",20200414,"AK",285,8063,NA,NA,32,NA,NA,NA,NA,98,"5315a4f1841f006de941785d317d4bb3057063e2","2020-04-14T20:00:00Z",9,32,8348,8348,8348,2,1,0,510,8,518
"506",20200414,"AL",3876,29241,NA,NA,493,NA,210,NA,132,NA,"fdef67fc2526eb4972bb573db30ce225d2ac391e","2020-04-14T20:00:00Z",110,493,33117,33117,33117,1,11,36,3793,142,3935
"507",20200414,"AR",1480,19651,NA,81,130,NA,43,29,39,427,"907ec6f1eeb2bdbc47087e6f29f8dd66d4e03d99","2020-04-14T20:00:00Z",30,130,21131,21131,21131,5,0,0,257,70,327
"508",20200414,"AS",0,3,17,NA,NA,NA,NA,NA,NA,NA,"185c50b581ff3a04f08affd4eb6d8739e5f920fa","2020-04-14T20:00:00Z",NA,NA,20,3,3,60,0,0,0,0,0
"509",20200414,"AZ",3806,40290,NA,580,NA,286,NA,216,NA,249,"7afc2afc97a6d3d4ee3cc637067272a2584445f8","2020-04-14T20:00:00Z",131,NA,44096,44096,44096,4,9,0,645,104,749
"510",20200414,"CA",23338,178870,13200,5163,NA,1552,NA,NA,NA,NA,"1f65c8b2d5328790f9cbedda2bfe2325921ed07a","2020-04-14T20:00:00Z",758,NA,215408,202208,202208,6,71,0,10336,990,11326
"511",20200414,"CO",7691,31051,NA,888,1493,NA,NA,NA,NA,NA,"066997c17f87cf08fc0d8b0e79f82164d05cfcb0","2020-04-14T20:00:00Z",308,1493,38742,38742,38742,8,4,21,1201,7,1208
"512",20200414,"CT",13989,31852,NA,1779,NA,NA,NA,NA,NA,NA,"78f6969207143e30d7e31c57727060aa6dceb19d","2020-04-14T20:00:00Z",671,NA,45841,45841,45841,9,69,0,924,608,1532
"513",20200414,"DC",2058,9226,NA,295,NA,95,NA,31,NA,518,"dafa456b34fa9ba6b89253015b782876f6cbefe1","2020-04-14T20:00:00Z",67,NA,11284,11284,11284,11,14,0,247,103,350
"514",20200414,"DE",1761,10543,NA,204,NA,NA,NA,NA,NA,277,"0b4aa321c592c1b78fe25c7303b5c9ff0bd9eaf2","2020-04-14T20:00:00Z",41,NA,12304,12304,12304,10,6,0,348,136,484
"515",20200414,"FL",21367,181813,1275,NA,3060,NA,NA,NA,NA,NA,"b577561bc8ed7135d1d5f86319c7618eb4d7e8d7","2020-04-14T20:00:00Z",537,3060,204455,203180,203180,12,54,227,6207,766,6973
"516",20200414,"GA",14223,47572,NA,NA,2769,NA,NA,NA,NA,NA,"e98314a9ad82070e5aab98fae3a637052d835ecd","2020-04-14T20:00:00Z",501,2769,61795,61795,61795,13,37,180,3866,908,4774
"517",20200414,"GU",135,811,NA,13,NA,2,NA,2,NA,66,"43a8d7bd2d2ca1d17d7c5b60af65bfeafadabcb1","2020-04-14T20:00:00Z",5,NA,946,946,946,66,0,0,41,0,41
"518",20200414,"HI",504,18916,NA,NA,44,NA,NA,NA,NA,315,"e01e426d6c9851f6dff5ffdfb923dd0b2ccfa9e6","2020-04-14T20:00:00Z",9,44,19420,19420,19420,15,0,0,571,5,576
"519",20200414,"IA",1899,16986,NA,163,NA,73,NA,41,NA,741,"ebcf272676e4b8542c2534292aab391679f1a075","2020-04-14T20:00:00Z",49,NA,18885,18885,18885,19,6,0,0,189,189
"520",20200414,"ID",1453,13661,NA,NA,135,NA,38,NA,NA,NA,"777ef89768a10db7c9c8a2399853b4b909947c6e","2020-04-14T20:00:00Z",33,135,15114,15114,15114,16,6,3,206,27,233
"521",20200414,"IL",23247,87369,NA,4283,NA,1189,NA,796,NA,NA,"193239d8b51a59855b00a55edee15ee316951607","2020-04-14T20:00:00Z",868,NA,110616,110616,110616,17,74,0,3626,1222,4848
"522",20200414,"IN",8527,37490,NA,NA,NA,721,NA,435,NA,NA,"b69228298ef925c76acd39e5442c5bcc0d3f60d0","2020-04-14T20:00:00Z",388,NA,46017,46017,46017,18,38,0,1187,291,1478
"523",20200414,"KS",1426,12721,NA,NA,327,NA,NA,NA,NA,NA,"bda44e265aa550daef73afb7ebc3569012d9df95","2020-04-14T20:00:00Z",69,327,14147,14147,14147,20,7,18,233,50,283
"524",20200414,"KY",2048,24635,NA,299,673,136,259,NA,NA,629,"2b7342b70a38c752c22a13316b8d1e0a23e4ad2a","2020-04-14T20:00:00Z",104,673,26683,26683,26683,21,7,6,732,85,817
"525",20200414,"LA",21518,96904,NA,1977,NA,NA,NA,436,NA,NA,"9b6c1ac221a66ad81a99cc1b339c9508902561d8","2020-04-14T20:00:00Z",1013,NA,118422,118422,118422,22,129,0,9829,502,10331
"526",20200414,"MA",28163,98388,NA,3615,2340,NA,NA,NA,NA,NA,"8dc1f8ee3946c6f0c27a89111dbb701bea6372b2","2020-04-14T20:00:00Z",957,2340,126551,126551,126551,25,113,0,3206,1296,4502
"527",20200414,"MD",9472,44261,NA,NA,2122,NA,NA,NA,NA,607,"2e95981d2f117826eb9aa5b28b4816a376ce9284","2020-04-14T20:00:00Z",302,2122,53733,53733,53733,24,40,147,1446,536,1982
"528",20200414,"ME",734,11608,NA,58,124,21,NA,9,NA,292,"07611c393a61a586a42b1766b55713cde98bf804","2020-04-14T20:00:00Z",20,124,12342,12342,12342,23,1,0,0,36,36
"529",20200414,"MI",27001,59225,NA,3910,NA,1497,NA,1235,NA,452,"2f9554ed2cfa321ae23a7feb3e0e69139276697b","2020-04-14T20:00:00Z",1768,NA,86226,86226,86226,26,166,0,2216,1366,3582
"530",20200414,"MN",1695,37546,NA,177,405,75,155,NA,NA,909,"582ed8cc017fc1db3291ebb7cb62aa9ba87408fe","2020-04-14T20:00:00Z",79,405,39241,39241,39241,27,9,44,769,45,814
"531",20200414,"MO",4686,43292,NA,1041,NA,NA,NA,NA,NA,NA,"4f05ef3a06d242a9732b6cffbf6a78bcf81f4925","2020-04-14T20:00:00Z",133,NA,47978,47978,47978,29,19,0,2252,298,2550
"532",20200414,"MP",13,27,7,NA,NA,NA,NA,NA,NA,NA,"a825a7fc1d8625af08be8708a47baf7916020de0","2020-04-14T20:00:00Z",2,NA,47,40,40,69,0,0,0,2,2
"533",20200414,"MS",3087,34791,NA,NA,596,154,NA,99,NA,NA,"956818cd92a3e7624c9d5b71ccc385f74c294bea","2020-04-14T20:00:00Z",111,596,37878,37878,37878,28,13,47,6749,145,6894
"534",20200414,"MT",399,8835,NA,24,50,NA,NA,NA,NA,197,"fc436784be7707d945e86cb69153f25edaa5b085","2020-04-14T20:00:00Z",7,50,9234,9234,9234,30,0,3,131,5,136
"535",20200414,"NC",5024,60015,NA,418,NA,NA,NA,NA,NA,NA,"25b8ebc740c6a41636dcd7006640fa333d730ee5","2020-04-14T20:00:00Z",108,NA,65039,65039,65039,37,22,0,1443,208,1651
"536",20200414,"ND",341,10575,NA,13,42,NA,NA,NA,NA,138,"aebdbc20ca0b8176e70cdf76eb4121decf48183e","2020-04-14T20:00:00Z",9,42,10916,10916,10916,38,1,2,125,10,135
"537",20200414,"NE",871,10486,NA,NA,NA,NA,NA,NA,NA,NA,"2a5e766de0b445c7f853572fbc5148b7ab52824b","2020-04-14T20:00:00Z",18,NA,11357,11357,11357,31,1,0,328,57,385
"538",20200414,"NH",1020,10590,25,72,152,NA,NA,NA,NA,249,"a319f3c068f24a5e63d20b17ba8de4a3df3174b9","2020-04-14T20:00:00Z",23,152,11635,11610,11610,33,0,0,368,35,403
"539",20200414,"NJ",68824,70950,NA,8185,NA,2051,NA,1626,NA,NA,"ad30f78b85ddfe5a8b36f19576395a501bb3d39a","2020-04-14T20:00:00Z",2805,NA,139774,139774,139774,34,362,0,6065,4240,10305
"540",20200414,"NM",1345,30625,NA,87,181,NA,NA,NA,NA,304,"1ea50b47aeebd4b2d54a4f9eb5a54ebe59b81e96","2020-04-14T20:00:00Z",31,181,31970,31970,31970,35,5,181,1355,100,1455
"541",20200414,"NV",3088,23573,NA,NA,NA,NA,NA,NA,NA,NA,"84edea65ba96938737a829b8879e09cdb21897fd","2020-04-14T20:00:00Z",120,NA,26661,26661,26661,32,6,0,1080,117,1197
"542",20200414,"NY",202208,296935,NA,18697,46201,5225,NA,NA,NA,23887,"af7e566432a9ff3be22212c6e53deadb87354a33","2020-04-14T20:00:00Z",10834,46201,499143,499143,499143,36,778,3489,13609,7177,20786
"543",20200414,"OH",7153,60721,NA,NA,2156,NA,654,NA,NA,NA,"5563ce4cc048b615be4620e733469f6d2471b34f","2020-04-14T20:00:00Z",324,2156,67874,67874,67874,39,50,123,2584,178,2762
"544",20200414,"OK",2184,26085,NA,194,488,107,NA,NA,NA,1060,"ad6efc671514f779a7ccf3bfde09ed25ac56da73","2020-04-14T20:00:00Z",108,488,28269,28269,28269,40,9,31,5295,115,5410
"545",20200414,"OR",1633,30730,NA,311,381,88,NA,44,NA,NA,"0c9baedd69ce60c44de18753cb549c293194d646","2020-04-14T20:00:00Z",55,381,32363,32363,32363,41,2,12,1193,49,1242
"546",20200414,"PA",25345,108286,NA,2317,NA,NA,NA,675,NA,NA,"01a6ae891224a47f84ff9b40c7a77eaddcd245be","2020-04-14T20:00:00Z",584,NA,133631,133631,133631,42,60,0,2693,1146,3839
"547",20200414,"PR",923,6284,1322,NA,NA,NA,NA,NA,NA,NA,"416f53bbee917cbd5e0bccfba96b673ad5d98cb5","2020-04-14T20:00:00Z",45,NA,8529,7207,7207,72,0,0,324,20,344
"548",20200414,"RI",3251,19649,NA,213,331,48,NA,NA,NA,135,"100fdd28f2a198c44f8475616daa554985d0fc15","2020-04-14T20:00:00Z",80,331,22900,22900,22900,44,7,0,1964,275,2239
"549",20200414,"SC",3553,30319,NA,NA,675,NA,NA,NA,NA,NA,"b94c2f7d81c3145ed3927482fb441c1f24f64a37","2020-04-14T20:00:00Z",97,675,33872,33872,33872,45,15,179,2213,234,2447
"550",20200414,"SD",988,8308,0,NA,45,NA,NA,NA,NA,261,"633f2e47635d660194aed76366c88094e21f2f42","2020-04-14T20:00:00Z",6,45,9296,9296,9296,46,0,1,174,120,294
"551",20200414,"TN",5823,73008,NA,NA,633,NA,NA,NA,NA,1969,"44227e48a2f27f48600c51aeecc0ca4cb23464bf","2020-04-14T20:00:00Z",124,633,78831,78831,78831,47,15,54,2423,213,2636
"552",20200414,"TX",14624,131843,NA,1409,NA,NA,NA,NA,NA,2580,"8dc9304f7eab3e5e43e2e6466c0e0a4a6d729443","2020-04-14T20:00:00Z",318,NA,146467,146467,146467,48,31,0,12523,718,13241
"553",20200414,"UT",2412,44064,NA,NA,213,NA,NA,NA,NA,218,"b371027ae74241bec0dac952659857e3af0b88d7","2020-04-14T20:00:00Z",19,213,46476,46476,46476,49,1,12,640,49,689
"554",20200414,"VA",6171,36592,469,1282,NA,422,NA,276,NA,721,"2356538f4c6deef4a2077015f365e0578fc8a7a1","2020-04-14T20:00:00Z",154,NA,43232,42763,42763,51,5,0,938,424,1362
"555",20200414,"VI",51,326,23,NA,NA,NA,NA,NA,NA,44,"facae52660ca43c775c83bd24ccbfcaad65b267c","2020-04-14T20:00:00Z",1,NA,400,377,377,78,0,0,4,0,4
"556",20200414,"VT",752,9833,NA,64,NA,NA,NA,NA,NA,15,"061b7b60b1af06764026b91889bc830546a1947f","2020-04-14T20:00:00Z",29,NA,10585,10585,10585,50,1,0,215,4,219
"557",20200414,"WA",10741,83391,NA,387,NA,98,NA,NA,NA,NA,"fb3b49eea13394770fb12949ecb2b2192732a628","2020-04-14T20:00:00Z",516,NA,94132,94132,94132,53,8,0,0,202,202
"558",20200414,"WI",3555,37997,277,432,1049,161,283,NA,NA,NA,"7a5f920f1bcc93e475c2a8662cb23daac46aa584","2020-04-14T20:00:00Z",170,1049,41829,41552,41552,55,16,56,1228,127,1355
"559",20200414,"WV",640,16398,NA,87,164,38,73,25,50,147,"fdba0b7e2f9ca5d0216104868608ec2443bb58d8","2020-04-14T20:00:00Z",9,164,17038,17038,17038,54,0,0,369,14,383
"560",20200414,"WY",275,5689,NA,NA,43,NA,NA,NA,NA,140,"569247545c3e5e81d159451c48da2af5143aa092","2020-04-14T20:00:00Z",1,43,5964,5964,5964,56,0,2,0,0,0
"561",20200413,"AK",277,7553,NA,NA,32,NA,NA,NA,NA,85,"67560e7c63366eea20aa9e68ec2f1d41b712ce9a","2020-04-13T20:00:00Z",8,32,7830,7830,7830,2,0,1,-213,5,-208
"562",20200413,"AL",3734,25448,NA,NA,457,NA,189,NA,119,NA,"fa960b1ff153c2babf5a49ba770f497397565eba","2020-04-13T20:00:00Z",99,457,29182,29182,29182,1,6,20,7390,209,7599
"563",20200413,"AR",1410,19394,NA,74,130,NA,43,28,39,391,"babc64d1c0a349d46b8b6acb6d58ae86d81a931a","2020-04-13T20:00:00Z",30,130,20804,20804,20804,5,3,0,952,130,1082
"564",20200413,"AS",0,3,NA,NA,NA,NA,NA,NA,NA,NA,"126d68a7fa8062e651ab412124fc1136d7cba009","2020-04-13T20:00:00Z",NA,NA,3,3,3,60,0,0,0,0,0
"565",20200413,"AZ",3702,39645,NA,525,NA,286,NA,195,NA,NA,"0ce3933cdbea79fb6bb942023171da802a935825","2020-04-13T20:00:00Z",122,NA,43347,43347,43347,4,7,0,1075,163,1238
"566",20200413,"CA",22348,168534,13200,3015,NA,1178,NA,NA,NA,NA,"aa396d040ac6c94b3d80e0f82bfb7a57cf2eb4d1","2020-04-13T20:00:00Z",687,NA,204082,190882,190882,6,36,0,0,554,554
"567",20200413,"CO",7684,29850,NA,842,1472,NA,NA,NA,NA,NA,"c1524362540b43dfbb856c0e11dcdba123b64be0","2020-04-13T20:00:00Z",304,1472,37534,37534,37534,8,30,96,1870,791,2661
"568",20200413,"CT",13381,30928,NA,1760,NA,NA,NA,NA,NA,NA,"c71d686a95c48387544bce6a9fbeba963f66f34f","2020-04-13T20:00:00Z",602,NA,44309,44309,44309,9,48,0,1743,1346,3089
"569",20200413,"DC",1955,8979,NA,295,NA,95,NA,31,NA,507,"ef361e87bc64c70ef055a6e97fa41b9f0da370ed","2020-04-13T20:00:00Z",53,NA,10934,10934,10934,11,3,0,214,80,294
"570",20200413,"DE",1625,10195,NA,201,NA,NA,NA,NA,NA,213,"f7f84986055ab03b462b21ea11cc6ea24aacf9c7","2020-04-13T20:00:00Z",35,NA,11820,11820,11820,10,2,0,571,146,717
"571",20200413,"FL",20601,175606,1789,NA,2833,NA,NA,NA,NA,NA,"5fe41e1e2a1be283194c989166518cf5d80303ee","2020-04-13T20:00:00Z",483,2833,197996,196207,196207,12,18,61,12208,1246,13454
"572",20200413,"GA",13315,43706,NA,NA,2589,NA,NA,NA,NA,NA,"d0deb48e89f93932727868c6d10d2f651f8efc64","2020-04-13T20:00:00Z",464,2589,57021,57021,57021,13,31,84,1705,863,2568
"573",20200413,"GU",135,770,NA,12,NA,2,NA,2,NA,58,"383fdeb7253f4ed73938675b0b186f25cad68340","2020-04-13T20:00:00Z",5,NA,905,905,905,66,0,0,77,2,79
"574",20200413,"HI",499,18345,NA,NA,44,NA,6,NA,2,310,"54e5a0f2d498944226791b8f435fce69e44256e0","2020-04-13T20:00:00Z",9,44,18844,18844,18844,15,1,0,863,13,876
"575",20200413,"IA",1710,16986,NA,142,NA,70,NA,41,NA,741,"8d7ec2ae1e1870221675951d652464cfc0a22796","2020-04-13T20:00:00Z",43,NA,18696,18696,18696,19,2,0,981,123,1104
"576",20200413,"ID",1426,13455,NA,NA,132,NA,38,NA,NA,NA,"3734e946519c646c233e93adb5afa4fe1e45abcc","2020-04-13T20:00:00Z",27,132,14881,14881,14881,16,0,1,554,19,573
"577",20200413,"IL",22025,83743,NA,3680,NA,1166,NA,821,NA,NA,"77d9c32803a4b81b867134206c0118eccce7c35f","2020-04-13T20:00:00Z",794,NA,105768,105768,105768,17,74,0,3860,1173,5033
"578",20200413,"IN",8236,36303,NA,NA,NA,740,NA,459,NA,NA,"923393ceb4fd69f45c83176518953b957dc59e39","2020-04-13T20:00:00Z",350,NA,44539,44539,44539,18,7,0,1742,308,2050
"579",20200413,"KS",1376,12488,NA,NA,309,NA,NA,NA,NA,NA,"d1e24b154340c63d12d49325cd6925ef2b57c9da","2020-04-13T20:00:00Z",62,309,13864,13864,13864,20,6,11,572,39,611
"580",20200413,"KY",1963,23903,NA,289,667,136,256,NA,NA,607,"68d8821e644d265098d60ae69248fa3f4ccec80b","2020-04-13T20:00:00Z",97,667,25866,25866,25866,21,3,208,1176,123,1299
"581",20200413,"LA",21016,87075,NA,2134,NA,NA,NA,461,NA,NA,"41f0e163c98a2af797eedef51a39016330e66076","2020-04-13T20:00:00Z",884,NA,108091,108091,108091,22,44,0,3625,421,4046
"582",20200413,"MA",26867,95182,NA,3454,2340,NA,NA,NA,NA,NA,"1d94a6213f93ea216de4af7e0ceaea61232c683f","2020-04-13T20:00:00Z",844,2340,122049,122049,122049,25,88,105,3927,1392,5319
"583",20200413,"MD",8936,42815,NA,NA,1975,NA,NA,NA,NA,603,"f9a5a804498e6bd539f46271022967a0ecb0ed72","2020-04-13T20:00:00Z",262,1975,51751,51751,51751,24,27,115,1276,711,1987
"584",20200413,"ME",698,11608,NA,22,124,NA,NA,NA,NA,273,"a49d6c928981fe2e87c948002d33bb30477dc086","2020-04-13T20:00:00Z",19,124,12306,12306,12306,23,0,4,5520,65,5585
"585",20200413,"MI",25635,57009,NA,3986,NA,1570,NA,1365,NA,447,"66c92c8befd3220371550c8729f82fa8d7a17a3a","2020-04-13T20:00:00Z",1602,NA,82644,82644,82644,26,115,0,2210,997,3207
"586",20200413,"MN",1650,36777,NA,157,361,74,146,NA,NA,842,"58b6311ace3e68e769980be6addd27758f367182","2020-04-13T20:00:00Z",70,361,38427,38427,38427,27,0,0,977,29,1006
"587",20200413,"MO",4388,41040,NA,988,NA,NA,NA,NA,NA,NA,"48de0f7d502836ea55ad90341d91104f716ea7ed","2020-04-13T20:00:00Z",114,NA,45428,45428,45428,29,4,0,0,228,228
"588",20200413,"MP",11,27,9,NA,NA,NA,NA,NA,NA,NA,"280aea9a94f99710bfa80e49afa6f4b533e0872e","2020-04-13T20:00:00Z",2,NA,47,38,38,69,0,0,0,0,0
"589",20200413,"MS",2942,28042,NA,NA,549,124,NA,84,NA,NA,"6869fbdb314470af627e647ba339e869756a8298","2020-04-13T20:00:00Z",98,549,30984,30984,30984,28,2,1,9410,161,9571
"590",20200413,"MT",394,8704,NA,21,47,NA,NA,NA,NA,171,"1ee9635f3af084d2b1703ac61739fd9440358304","2020-04-13T20:00:00Z",7,47,9098,9098,9098,30,1,0,178,7,185
"591",20200413,"NC",4816,58572,NA,313,NA,NA,NA,NA,NA,NA,"813a9cb064e17ff6e72219744f027f5088392253","2020-04-13T20:00:00Z",86,NA,63388,63388,63388,37,5,0,953,296,1249
"592",20200413,"ND",331,10450,NA,13,40,NA,NA,NA,NA,127,"74ba42bdde7f9eefc5627f7c42c8f940763bbc2b","2020-04-13T20:00:00Z",8,40,10781,10781,10781,38,0,1,408,23,431
"593",20200413,"NE",814,10158,NA,NA,NA,NA,NA,NA,NA,NA,"dca6111ee5fb521097ef8b27743c224713cc5092","2020-04-13T20:00:00Z",17,NA,10972,10972,10972,31,0,0,258,23,281
"594",20200413,"NH",985,10222,125,NA,152,NA,NA,NA,NA,239,"4c755414bd724a745f7c748ed32bd161be48e6a5","2020-04-13T20:00:00Z",23,152,11332,11207,11207,33,0,6,226,56,282
"595",20200413,"NJ",64584,64885,NA,7781,NA,1886,NA,1611,NA,NA,"f10013846bdebee508305109342406d19382e1b7","2020-04-13T20:00:00Z",2443,NA,129469,129469,129469,34,93,0,0,2734,2734
"596",20200413,"NM",1245,29270,NA,80,NA,NA,NA,NA,NA,295,"2b1efe12b5e1e2732ca1c703e1b1d85dac4ae8c9","2020-04-13T20:00:00Z",26,NA,30515,30515,30515,35,6,0,1752,71,1823
"597",20200413,"NV",2971,22493,NA,NA,NA,NA,NA,NA,NA,NA,"9dc1eb61a67199b2b083862e2949d04b07670a87","2020-04-13T20:00:00Z",114,NA,25464,25464,25464,32,2,0,718,135,853
"598",20200413,"NY",195031,283326,NA,18825,42712,5156,NA,NA,NA,23887,"286aa877043319eac31dd16ed268926cee8f6d4a","2020-04-13T20:00:00Z",10056,42712,478357,478357,478357,36,671,118,10419,6337,16756
"599",20200413,"OH",6975,58137,NA,NA,2033,NA,613,NA,NA,NA,"fed2c54bfbaa53e982b6d3a6d9018362e8227a75","2020-04-13T20:00:00Z",274,2033,65112,65112,65112,39,21,85,1498,371,1869
"600",20200413,"OK",2069,20790,NA,383,457,191,NA,NA,NA,865,"4191ae6166d8548c2596587043111b10ac96c6c2","2020-04-13T20:00:00Z",99,457,22859,22859,22859,40,3,11,0,99,99
"601",20200413,"OR",1584,29537,NA,321,369,96,NA,50,NA,NA,"b512824791533724a49c30378f83ab6c5f8f440c","2020-04-13T20:00:00Z",53,369,31121,31121,31121,41,1,10,1306,57,1363
"602",20200413,"PA",24199,105593,NA,2243,NA,NA,NA,669,NA,NA,"d3f878ae067f662c5425d813556e38963ac10e24","2020-04-13T20:00:00Z",524,NA,129792,129792,129792,42,17,0,3536,1366,4902
"603",20200413,"PR",903,5960,1288,NA,NA,NA,NA,NA,NA,NA,"2e02e70aac0ed14a854e5bf23ecc53dc59ee0fce","2020-04-13T20:00:00Z",45,NA,8151,6863,6863,72,1,0,141,6,147
"604",20200413,"RI",2976,17685,NA,197,331,50,NA,26,NA,135,"c8feb721e136d0a52f133a66a069ffbb7e80691d","2020-04-13T20:00:00Z",73,331,20661,20661,20661,44,10,331,0,311,311
"605",20200413,"SC",3319,28106,NA,NA,496,NA,NA,NA,NA,NA,"e39bcc755d0cc87ba9446729a4a1241d4fee6776","2020-04-13T20:00:00Z",82,496,31425,31425,31425,45,0,0,0,0,0
"606",20200413,"SD",868,8134,0,NA,44,NA,NA,NA,NA,207,"d6fdd504a7297a9ad1ec09a772f7cd53ad90d099","2020-04-13T20:00:00Z",6,44,9002,9002,9002,46,0,1,311,138,449
"607",20200413,"TN",5610,70585,NA,NA,579,NA,NA,NA,NA,1671,"4798bcbacd867bc269aac274fc75fc9fd32df2cb","2020-04-13T20:00:00Z",109,579,76195,76195,76195,47,8,12,5216,302,5518
"608",20200413,"TX",13906,119320,NA,1176,NA,NA,NA,NA,NA,2269,"6f951cbd8c25986d844e2e30c3718cb9cfea2fbc","2020-04-13T20:00:00Z",287,NA,133226,133226,133226,48,16,0,8271,422,8693
"609",20200413,"UT",2363,43424,NA,NA,201,NA,NA,NA,NA,218,"9da0e13ad75b4e608cac7956fda03bd19ba2d526","2020-04-13T20:00:00Z",18,201,45787,45787,45787,49,0,6,1493,60,1553
"610",20200413,"VA",5747,35654,473,1238,NA,428,NA,302,NA,NA,"e6cfda1e1cbf4242dfa8c853d239fdd36d5a6381","2020-04-13T20:00:00Z",149,NA,41874,41401,41401,51,8,0,943,473,1416
"611",20200413,"VI",51,322,2,NA,NA,NA,NA,NA,NA,43,"7d5d9e075195e6ae339cf80c000fc025bfebca71","2020-04-13T20:00:00Z",1,NA,375,373,373,78,0,0,23,0,23
"612",20200413,"VT",748,9618,NA,33,NA,NA,NA,NA,NA,15,"14051825f769b3fefa36f69aef7735081ba73a3d","2020-04-13T20:00:00Z",28,NA,10366,10366,10366,50,1,0,504,21,525
"613",20200413,"WA",10539,83391,NA,527,NA,166,NA,NA,NA,NA,"9f645dc8cbc2e580a01f9afd8768035a1f3398d0","2020-04-13T20:00:00Z",508,NA,93930,93930,93930,53,17,0,0,188,188
"614",20200413,"WI",3428,36769,273,442,993,175,264,NA,NA,NA,"e47a161cb51e95ae954f5980da5ab396b503ce05","2020-04-13T20:00:00Z",154,993,40470,40197,40197,55,10,19,853,87,940
"615",20200413,"WV",626,16029,NA,95,164,43,73,23,50,85,"5b88cfc537cbb6ce7e4cf00b79567df0989146aa","2020-04-13T20:00:00Z",9,164,16655,16655,16655,54,1,164,383,15,398
"616",20200413,"WY",275,5689,NA,NA,41,NA,NA,NA,NA,138,"925408d55d0948b12058c56e5c0acd2eb3b0f93d","2020-04-13T20:00:00Z",1,41,5964,5964,5964,56,1,1,491,14,505
"617",20200412,"AK",272,7766,NA,NA,31,NA,NA,NA,NA,66,"5f686eece203e247c3bfb219c664517920d7c141","2020-04-12T20:00:00Z",8,31,8038,8038,8038,2,0,0,291,15,306
"618",20200412,"AL",3525,18058,NA,NA,437,NA,189,NA,119,NA,"a10003b9814203ba98d289480736cff0b00b4009","2020-04-12T20:00:00Z",93,437,21583,21583,21583,1,2,35,0,334,334
"619",20200412,"AR",1280,18442,NA,74,130,NA,43,30,39,367,"6c7bd80088061ed07c0e558496324807bfdba9e0","2020-04-12T20:00:00Z",27,130,19722,19722,19722,5,3,0,1090,54,1144
"620",20200412,"AS",0,3,2,NA,NA,NA,NA,NA,NA,NA,"30bdeb66442be44960060acf5492b2203bbe4112","2020-04-12T20:00:00Z",NA,NA,5,3,3,60,0,0,0,0,0
"621",20200412,"AZ",3539,38570,NA,NA,NA,NA,NA,NA,NA,NA,"994b2dd7ad7e22da1720b4f9eaf7248665bcd81a","2020-04-12T20:00:00Z",115,NA,42109,42109,42109,4,7,0,1433,146,1579
"622",20200412,"CA",21794,168534,13200,5234,NA,1539,NA,NA,NA,NA,"5838b65659424b8a88297f99ccedb9b0e03fcd2e","2020-04-12T20:00:00Z",651,NA,203528,190328,190328,6,42,0,15930,2322,18252
"623",20200412,"CO",6893,27980,NA,822,1376,NA,NA,NA,NA,NA,"0fa95fe61d44d2f0fa042d032b241cb63b065710","2020-04-12T20:00:00Z",274,1376,34873,34873,34873,8,24,64,1837,383,2220
"624",20200412,"CT",12035,29185,NA,1654,NA,NA,NA,NA,NA,NA,"b380ea3514025b20c074c69d84faaec7884c8c82","2020-04-12T20:00:00Z",554,NA,41220,41220,41220,9,60,0,864,525,1389
"625",20200412,"DC",1875,8765,NA,NA,NA,NA,NA,NA,NA,493,"b4e91978eb47e7033efd60c57d4172799b67fd77","2020-04-12T20:00:00Z",50,NA,10640,10640,10640,11,3,0,504,97,601
"626",20200412,"DE",1479,9624,NA,190,NA,NA,NA,NA,NA,191,"bf0ecd2e46ae83a0346eac035f0390a92efcb46e","2020-04-12T20:00:00Z",33,NA,11103,11103,11103,10,0,0,0,0,0
"627",20200412,"FL",19355,163398,1297,NA,2772,NA,NA,NA,NA,NA,"9d192350c4b0bd28255957587d7d0c5092a28934","2020-04-12T20:00:00Z",465,2772,184050,182753,182753,12,27,111,8959,861,9820
"628",20200412,"GA",12452,42001,NA,NA,2505,NA,NA,NA,NA,NA,"f93274bf897baa6e636ffc45d10d3f8eb44e92e1","2020-04-12T20:00:00Z",433,2505,54453,54453,54453,13,5,26,2445,293,2738
"629",20200412,"GU",133,693,NA,13,NA,2,NA,2,NA,58,"4ec282f20356475c9133bfb60102022c15aad197","2020-04-12T20:00:00Z",5,NA,826,826,826,66,0,0,0,0,0
"630",20200412,"HI",486,17482,NA,NA,44,NA,6,NA,2,300,"3026c07fbaa81d7abacb2ad47b32a51871d4c485","2020-04-12T20:00:00Z",8,44,17968,17968,17968,15,0,1,416,21,437
"631",20200412,"IA",1587,16005,NA,129,NA,55,NA,30,NA,674,"4407491152515f135951ac47a81a3814b6c138dd","2020-04-12T20:00:00Z",41,NA,17592,17592,17592,19,7,0,383,77,460
"632",20200412,"ID",1407,12901,NA,NA,131,NA,38,NA,NA,NA,"254b387c2694a6e2b909c2c1d5054533175d4851","2020-04-12T20:00:00Z",27,131,14308,14308,14308,16,2,3,533,11,544
"633",20200412,"IL",20852,79883,NA,3680,NA,1166,NA,821,NA,NA,"5a6cd05b5f034e0c094981d6ca2071b6a682dee2","2020-04-12T20:00:00Z",720,NA,100735,100735,100735,17,43,0,6914,1672,8586
"634",20200412,"IN",7928,34561,NA,NA,NA,820,NA,497,NA,NA,"6178539b82f582e8df334647211d512ba72a35f9","2020-04-12T20:00:00Z",343,NA,42489,42489,42489,18,13,0,2781,493,3274
"635",20200412,"KS",1337,11916,NA,NA,298,NA,NA,NA,NA,NA,"c4a60f6d5288d83f3490a787e3237b364c7392ef","2020-04-12T20:00:00Z",56,298,13253,13253,13253,20,1,5,841,69,910
"636",20200412,"KY",1840,22727,NA,271,459,105,177,NA,NA,464,"6a8b7894876f6171b2c15fa85528a3cddfabb26e","2020-04-12T20:00:00Z",94,459,24567,24567,24567,21,4,0,132,147,279
"637",20200412,"LA",20595,83450,NA,2084,NA,NA,NA,458,NA,NA,"9aeab99aa0ac14c1c095c7a5aae3603eda67156a","2020-04-12T20:00:00Z",840,NA,104045,104045,104045,22,34,0,6549,581,7130
"638",20200412,"MA",25475,91255,NA,NA,2235,NA,NA,NA,NA,NA,"17e631ae78eb3208abcba385e2bb9f27bb97a4b6","2020-04-12T20:00:00Z",756,2235,116730,116730,116730,25,70,115,5339,2615,7954
"639",20200412,"MD",8225,41539,NA,NA,1860,NA,NA,NA,NA,456,"0babcfcedb910d559fde4cb1251327b93972eb14","2020-04-12T20:00:00Z",235,1860,49764,49764,49764,24,29,151,1995,531,2526
"640",20200412,"ME",633,6088,NA,NA,120,NA,NA,NA,NA,266,"47d53b7fbb72db4bbf66fcb824f6a43854bbbd72","2020-04-12T20:00:00Z",19,120,6721,6721,6721,23,0,6,0,17,17
"641",20200412,"MI",24638,54799,NA,3636,NA,1582,NA,1441,NA,433,"541b02d2376d6434e90cd4b0a59ecdfbbe1426bb","2020-04-12T20:00:00Z",1487,NA,79437,79437,79437,26,95,0,2778,645,3423
"642",20200412,"MN",1621,35800,NA,157,361,74,146,NA,NA,842,"8ba9bf84ed5e038d18ac77d2852976ce3d191e5b","2020-04-12T20:00:00Z",70,361,37421,37421,37421,27,6,21,1823,194,2017
"643",20200412,"MO",4160,41040,NA,988,NA,NA,NA,NA,NA,NA,"e664370ad9aea932c140ade5241b33ec518dfef6","2020-04-12T20:00:00Z",110,NA,45200,45200,45200,29,1,0,1892,136,2028
"644",20200412,"MP",11,27,9,NA,NA,NA,NA,NA,NA,NA,"8735c3e28769f9480af353e26d1dca6841d381e8","2020-04-12T20:00:00Z",2,NA,47,38,38,69,0,0,0,0,0
"645",20200412,"MS",2781,18632,NA,NA,548,NA,NA,NA,NA,NA,"2a98ff7258f13e78385d1b59663ed3c26b5183a0","2020-04-12T20:00:00Z",96,548,21413,21413,21413,28,3,20,0,139,139
"646",20200412,"MT",387,8526,NA,22,47,NA,NA,NA,NA,169,"b26f0da0367eed75b13c3113713e19c2b29cc66e","2020-04-12T20:00:00Z",6,47,8913,8913,8913,30,0,1,322,10,332
"647",20200412,"NC",4520,57619,NA,331,NA,NA,NA,NA,NA,NA,"630a0bdaed60fd2d71c5d94a21689a3ee8707bde","2020-04-12T20:00:00Z",81,NA,62139,62139,62139,37,1,0,1538,208,1746
"648",20200412,"ND",308,10042,NA,12,39,NA,NA,NA,NA,121,"13b6bda9e45c4c68f8a91973100e3d5550a53110","2020-04-12T20:00:00Z",8,39,10350,10350,10350,38,1,3,255,15,270
"649",20200412,"NE",791,9900,NA,NA,NA,NA,NA,NA,NA,NA,"0e4aa19def436c0ea5e28399ed5e83844613e39a","2020-04-12T20:00:00Z",17,NA,10691,10691,10691,31,0,0,615,91,706
"650",20200412,"NH",929,9996,119,NA,146,NA,NA,NA,NA,236,"570c39e24c2b30f639d27733a214cee15192ff5e","2020-04-12T20:00:00Z",23,146,11044,10925,10925,33,1,12,388,44,432
"651",20200412,"NJ",61850,64885,NA,7604,NA,1914,NA,1644,NA,NA,"ecb690eaa50b5a250895aa6d678f5381632ffd26","2020-04-12T20:00:00Z",2350,NA,126735,126735,126735,34,167,0,2843,3699,6542
"652",20200412,"NM",1174,27518,NA,78,NA,NA,NA,18,NA,235,"4c46aa8b48ded5f0b8333dc9014314d918b06528","2020-04-12T20:00:00Z",20,NA,28692,28692,28692,35,1,0,1511,83,1594
"653",20200412,"NV",2836,21775,NA,282,NA,NA,NA,NA,NA,NA,"7a4c2725a28bced1bb827cd35f1a5e59044c09a7","2020-04-12T20:00:00Z",112,NA,24611,24611,24611,32,10,0,888,136,1024
"654",20200412,"NY",188694,272907,NA,18707,42594,5198,NA,NA,NA,23887,"c34e542369716ac96cf4d5c56a0b44894e6a356f","2020-04-12T20:00:00Z",9385,42594,461601,461601,461601,36,758,1915,12385,8236,20621
"655",20200412,"OH",6604,56639,NA,NA,1948,NA,595,NA,NA,NA,"0bc5957f5991dc69c64f03e3c7e2e18be0a1601d","2020-04-12T20:00:00Z",253,1948,63243,63243,63243,39,6,89,2418,417,2835
"656",20200412,"OK",1970,20790,NA,383,446,191,NA,NA,NA,865,"acebfb6a2f63dbae55b283b6eb9f79172ec9ec7c","2020-04-12T20:00:00Z",96,446,22760,22760,22760,40,2,0,0,102,102
"657",20200412,"OR",1527,28231,NA,295,359,81,NA,52,NA,NA,"343ee0136caa7bac5fbaee7bd25ebc6d63b83179","2020-04-12T20:00:00Z",52,359,29758,29758,29758,41,4,21,2378,156,2534
"658",20200412,"PA",22833,102057,NA,2097,NA,NA,NA,649,NA,NA,"07324fe7599e52f854acb0b27a19898fd30f90df","2020-04-12T20:00:00Z",507,NA,124890,124890,124890,42,13,0,3559,1178,4737
"659",20200412,"PR",897,5819,1251,NA,NA,NA,NA,NA,NA,NA,"7ca4fd5cd8955f51e2f92c346c060be1f0a2967c","2020-04-12T20:00:00Z",44,NA,7967,6716,6716,72,2,0,236,109,345
"660",20200412,"RI",2665,17685,NA,201,NA,50,NA,26,NA,35,"d847efc166112ef05e650276fcb510a617db4ddb","2020-04-12T20:00:00Z",63,NA,20350,20350,20350,44,7,0,1827,316,2143
"661",20200412,"SC",3319,28106,NA,NA,496,NA,NA,NA,NA,NA,"044250266baeb0dc046c839a6fea392ad5d6fd48","2020-04-12T20:00:00Z",82,496,31425,31425,31425,45,2,0,1220,112,1332
"662",20200412,"SD",730,7823,0,NA,43,NA,NA,NA,NA,197,"62f16b2fc12b94655a06c6ad9a65d192f8932a5b","2020-04-12T20:00:00Z",6,43,8553,8553,8553,46,0,10,445,104,549
"663",20200412,"TN",5308,65369,NA,NA,567,NA,NA,NA,NA,1504,"4d9171393648095a093ae412c55c5ab9fac65158","2020-04-12T20:00:00Z",101,567,70677,70677,70677,47,0,11,3655,194,3849
"664",20200412,"TX",13484,111049,NA,1338,NA,NA,NA,NA,NA,2014,"3ae759108fcc149585565c0d6c9c9aa338cf0c50","2020-04-12T20:00:00Z",271,NA,124533,124533,124533,48,17,0,3077,923,4000
"665",20200412,"UT",2303,41931,NA,NA,195,NA,NA,NA,NA,NA,"2ed0a5b83fb1172a55311e320b688ef899102994","2020-04-12T20:00:00Z",18,195,44234,44234,44234,49,0,5,1591,97,1688
"666",20200412,"VA",5274,34711,521,751,NA,734,NA,294,NA,NA,"95dbe378dabc930e6bef597168fd0fea0642bed1","2020-04-12T20:00:00Z",141,NA,40506,39985,39985,51,11,0,1789,197,1986
"667",20200412,"VI",51,299,20,3,NA,NA,NA,NA,NA,43,"75a5e96c1cb0af90daf332a0e1ad218b519c6ccb","2020-04-12T20:00:00Z",1,NA,370,350,350,78,0,0,0,0,0
"668",20200412,"VT",727,9114,NA,34,NA,NA,NA,NA,NA,15,"317bf42eca48bc513b07ec021dbb66bbe8228721","2020-04-12T20:00:00Z",27,NA,9841,9841,9841,50,2,0,567,16,583
"669",20200412,"WA",10351,83391,NA,642,NA,191,NA,NA,NA,NA,"e507fefd6fcb93fa2bec03aa068438ba4b525f29","2020-04-12T20:00:00Z",491,NA,93742,93742,93742,53,0,0,0,234,234
"670",20200412,"WI",3341,35916,NA,442,974,179,261,NA,NA,NA,"b6c52db7f98867be6533207bd5925f1d2606039d","2020-04-12T20:00:00Z",144,974,39257,39257,39257,55,7,24,1236,128,1364
"671",20200412,"WV",611,15646,NA,81,NA,36,NA,24,NA,83,"e1c4f53acb2ff1cdc76c7f0b1b69d8d4853c6b69","2020-04-12T20:00:00Z",8,NA,16257,16257,16257,54,3,0,771,34,805
"672",20200412,"WY",261,5198,NA,NA,40,NA,NA,NA,NA,137,"2a6cd1a98f43d43820dfb2d7cb95355af66c516b","2020-04-12T20:00:00Z",0,40,5459,5459,5459,56,0,3,0,0,0
"673",20200411,"AK",257,7475,NA,NA,31,NA,NA,NA,NA,63,"a8d36e9ce19edaeaac989881abf96fc74196efba","2020-04-11T20:00:00Z",8,31,7732,7732,7732,2,1,3,289,11,300
"674",20200411,"AL",3191,18058,NA,NA,402,NA,NA,NA,NA,NA,"1fc42a3d2389569b3fd60bf6c3ba8d7c35c5a378","2020-04-11T20:00:00Z",91,402,21249,21249,21249,1,11,34,0,223,223
"675",20200411,"AR",1226,17352,NA,86,130,NA,43,33,39,340,"c89b6d79b846a7e0c95039ef4e098653cea76566","2020-04-11T20:00:00Z",24,130,18578,18578,18578,5,1,0,1403,55,1458
"676",20200411,"AS",0,3,2,NA,NA,NA,NA,NA,NA,NA,"e3996e19f3dfdc280692ed786367458686df63ed","2020-04-11T20:00:00Z",NA,NA,5,3,3,60,0,0,0,0,0
"677",20200411,"AZ",3393,37137,NA,NA,NA,NA,NA,NA,NA,NA,"ee23e7459fb43965ff718c5ef4d8a2a807359399","2020-04-11T20:00:00Z",108,NA,40530,40530,40530,4,11,0,2515,281,2796
"678",20200411,"CA",19472,152604,13200,5236,NA,1591,NA,NA,NA,NA,"d1eef75994ad1a7d659936e05ced31e584362f04","2020-04-11T20:00:00Z",609,NA,185276,172076,172076,6,68,0,7213,0,7213
"679",20200411,"CO",6510,26143,NA,841,1312,NA,NA,NA,NA,NA,"cd0a888338567f3e8184b9d4eab6812f09d776be","2020-04-11T20:00:00Z",250,1312,32653,32653,32653,8,0,0,0,0,0
"680",20200411,"CT",11510,28321,NA,1593,NA,NA,NA,NA,NA,NA,"e8de5e9127276977194f6ce3aa078c1d4bfac16b","2020-04-11T20:00:00Z",494,NA,39831,39831,39831,9,46,0,2571,972,3543
"681",20200411,"DC",1778,8261,NA,NA,NA,NA,NA,NA,NA,447,"7adff028478102fb7be713729b35aeef9dacf359","2020-04-11T20:00:00Z",47,NA,10039,10039,10039,11,9,0,566,118,684
"682",20200411,"DE",1479,9624,NA,190,NA,NA,NA,NA,NA,191,"fb09c90df852cd85214cc24b799df37f71e52f87","2020-04-11T20:00:00Z",33,NA,11103,11103,11103,10,10,0,-791,153,-638
"683",20200411,"FL",18494,154439,1418,NA,2661,NA,NA,NA,NA,NA,"556eff0dd57a9b72146fc86e7822a3b142ea4371","2020-04-11T20:00:00Z",438,2661,174351,172933,172933,12,48,174,9140,963,10103
"684",20200411,"GA",12159,39556,NA,NA,2479,NA,NA,NA,NA,NA,"06b53fa7eb6c28f644aa6beac82e353c65a7cd9c","2020-04-11T20:00:00Z",428,2479,51715,51715,51715,13,12,128,4892,676,5568
"685",20200411,"GU",133,693,NA,14,NA,2,NA,2,NA,58,"5f26927fab3a35e0b2477043b2004ec19028dea1","2020-04-11T20:00:00Z",5,NA,826,826,826,66,1,0,31,3,34
"686",20200411,"HI",465,17066,NA,NA,43,NA,6,NA,2,284,"6a84740bf5d92867954153fb11dd79b51db0d3cd","2020-04-11T20:00:00Z",8,43,17531,17531,17531,15,2,1,1359,23,1382
"687",20200411,"IA",1510,15622,NA,118,NA,55,NA,30,NA,585,"6e736638a93bc8f376fbcb65eda72923cfd30259","2020-04-11T20:00:00Z",34,NA,17132,17132,17132,19,3,0,1057,122,1179
"688",20200411,"ID",1396,12368,NA,NA,128,NA,35,NA,NA,NA,"2a4968fc9c46df1aa8970de03b88a4ff10098182","2020-04-11T20:00:00Z",25,128,13764,13764,13764,16,1,1,627,43,670
"689",20200411,"IL",19180,72969,NA,3680,NA,1166,NA,821,NA,NA,"d2f4bc346d1388c9600d41903a16bab576cb0fb7","2020-04-11T20:00:00Z",677,NA,92149,92149,92149,17,81,0,3329,1293,4622
"690",20200411,"IN",7435,31780,NA,NA,NA,820,NA,497,NA,NA,"7660759d9c736b25312a708f6706d27a10c69c3b","2020-04-11T20:00:00Z",330,NA,39215,39215,39215,18,30,0,3647,528,4175
"691",20200411,"KS",1268,11075,NA,NA,293,NA,NA,NA,NA,NA,"e95fd55dfdd68260274d86129c167f566658f1d8","2020-04-11T20:00:00Z",55,293,12343,12343,12343,20,5,19,827,102,929
"692",20200411,"KY",1693,22595,NA,271,459,105,177,NA,NA,464,"49f90f03874fb86940f115d5680768de7a5ec5dc","2020-04-11T20:00:00Z",90,459,24288,24288,24288,21,0,0,0,0,0
"693",20200411,"LA",20014,76901,NA,2067,NA,NA,NA,470,NA,NA,"644d819f726bea7ac3131764e77319d0958664a5","2020-04-11T20:00:00Z",806,NA,96915,96915,96915,22,51,0,3874,761,4635
"694",20200411,"MA",22860,85916,NA,NA,2120,NA,NA,NA,NA,NA,"d99e0e8ff1ffbd3ee9b312016cebd53c3e9f431d","2020-04-11T20:00:00Z",686,2120,108776,108776,108776,25,87,164,4518,1886,6404
"695",20200411,"MD",7694,39544,NA,NA,1709,NA,NA,NA,NA,431,"f895c4448a93a8b4556faabc3b387ee307377004","2020-04-11T20:00:00Z",206,1709,47238,47238,47238,24,35,296,2064,726,2790
"696",20200411,"ME",616,6088,NA,NA,114,NA,NA,NA,NA,256,"394a794fce881dd00fc98ecefbe1f4eb3e829ae3","2020-04-11T20:00:00Z",19,114,6704,6704,6704,23,2,3,0,30,30
"697",20200411,"MI",23993,52021,NA,3636,NA,1582,NA,1441,NA,595,"3d03b637d24856390bec64766587db8137e39c61","2020-04-11T20:00:00Z",1392,NA,76014,76014,76014,26,111,0,2760,1210,3970
"698",20200411,"MN",1427,33977,NA,145,340,69,138,NA,NA,793,"cd31725bf7239aabd805a7b5ba66f24d247a6a4a","2020-04-11T20:00:00Z",64,340,35404,35404,35404,27,7,23,1419,91,1510
"699",20200411,"MO",4024,39148,NA,506,NA,NA,NA,NA,NA,NA,"ad1a0aa2494f6e2a7f6677d7051ef8ec83d71034","2020-04-11T20:00:00Z",109,NA,43172,43172,43172,29,13,0,2207,225,2432
"700",20200411,"MP",11,27,9,NA,NA,NA,NA,NA,NA,NA,"a6b93f8944bc4e65251189c2dce27586265374da","2020-04-11T20:00:00Z",2,NA,47,38,38,69,0,0,0,0,0
"701",20200411,"MS",2642,18632,NA,NA,528,NA,NA,NA,NA,NA,"13130297b1d7ae26a372b7badcf50d038370b77e","2020-04-11T20:00:00Z",93,528,21274,21274,21274,28,11,46,0,173,173
"702",20200411,"MT",377,8204,NA,21,46,NA,NA,NA,NA,169,"d7001c3f70e70180eeddca7303c5d1f5b43d79bf","2020-04-11T20:00:00Z",6,46,8581,8581,8581,30,0,5,272,12,284
"703",20200411,"NC",4312,56081,NA,362,NA,NA,NA,NA,NA,NA,"7da4a0c4d29d52802578786c23cf1cc40c0b7a5b","2020-04-11T20:00:00Z",80,NA,60393,60393,60393,37,6,0,2344,404,2748
"704",20200411,"ND",293,9787,NA,10,36,NA,NA,NA,NA,119,"3f0ea0abba907cbabd93287478b8828e27daa409","2020-04-11T20:00:00Z",7,36,10080,10080,10080,38,1,0,457,15,472
"705",20200411,"NE",700,9285,NA,NA,NA,NA,NA,NA,NA,NA,"89e40d06d159df3bc9c1778c7af0ce11d51294ec","2020-04-11T20:00:00Z",17,NA,9985,9985,9985,31,2,0,566,65,631
"706",20200411,"NH",885,9608,93,NA,134,NA,NA,NA,NA,234,"f81faf4a7cd08487f4dee5871b604340144c37b7","2020-04-11T20:00:00Z",22,134,10586,10493,10493,33,1,10,469,66,535
"707",20200411,"NJ",58151,62042,NA,7618,NA,1746,NA,1650,NA,NA,"10b137d9c127d722126d306ada0677121f0c8e5a","2020-04-11T20:00:00Z",2183,NA,120193,120193,120193,34,251,0,3107,3563,6670
"708",20200411,"NM",1091,26007,NA,75,NA,NA,NA,18,NA,235,"ecbde1158d88583b1442f9da74ccd91095e61d2e","2020-04-11T20:00:00Z",19,NA,27098,27098,27098,35,0,0,0,0,0
"709",20200411,"NV",2700,20887,NA,282,NA,NA,NA,NA,NA,NA,"b2c1d98549beb7f6a25f914ba45f9e5344ad192b","2020-04-11T20:00:00Z",102,NA,23587,23587,23587,32,16,0,722,116,838
"710",20200411,"NY",180458,260522,NA,18654,40679,5009,NA,NA,NA,22025,"361c16745f9be4bc650b0fa0ebaabc36edad3d47","2020-04-11T20:00:00Z",8627,40679,440980,440980,440980,36,783,1861,13149,9946,23095
"711",20200411,"OH",6187,54221,NA,NA,1859,NA,572,NA,NA,NA,"653b0637956dae24b08d87da57bfaca2dfbff9a3","2020-04-11T20:00:00Z",247,1859,60408,60408,60408,39,16,104,1526,351,1877
"712",20200411,"OK",1868,20790,NA,383,446,191,NA,NA,NA,865,"f6e31080079bb3b55beac5b3cd00638a769d3c9d","2020-04-11T20:00:00Z",94,446,22658,22658,22658,40,6,18,420,74,494
"713",20200411,"OR",1371,25853,NA,140,338,58,NA,46,NA,NA,"cc27c7f6db1c726f33a81e8a595fe2c3d34e08d0","2020-04-11T20:00:00Z",48,338,27224,27224,27224,41,4,12,1547,50,1597
"714",20200411,"PA",21655,98498,NA,2115,NA,NA,NA,639,NA,NA,"707c8ca592c2cb6865085b84acfa61765e56ae2c","2020-04-11T20:00:00Z",494,NA,120153,120153,120153,42,78,0,5458,1676,7134
"715",20200411,"PR",788,5583,1332,NA,NA,NA,NA,NA,NA,NA,"49a43ec077cb42785a932e1bb08e765e31dc86a4","2020-04-11T20:00:00Z",42,NA,7703,6371,6371,72,3,0,462,63,525
"716",20200411,"RI",2349,15858,NA,183,NA,50,NA,26,NA,35,"3b26580e535b35400119bfdaf286449fbeaf2c90","2020-04-11T20:00:00Z",56,NA,18207,18207,18207,44,7,0,3577,334,3911
"717",20200411,"SC",3207,26886,NA,NA,496,NA,NA,NA,NA,NA,"c00baa6c5ebcac7c6ac51403bb3ea2705db0f834","2020-04-11T20:00:00Z",80,496,30093,30093,30093,45,8,0,1768,142,1910
"718",20200411,"SD",626,7378,2,NA,33,NA,NA,NA,NA,189,"45590554a2f8dc468a998428879eea2c8744acbf","2020-04-11T20:00:00Z",6,33,8006,8004,8004,46,0,4,267,90,357
"719",20200411,"TN",5114,61714,NA,NA,556,NA,NA,NA,NA,1386,"fd78d9f797ce808abb10194c7e10937b8ec2d11d","2020-04-11T20:00:00Z",101,556,66828,66828,66828,47,3,20,3777,252,4029
"720",20200411,"TX",12561,107972,NA,1514,NA,NA,NA,NA,NA,1617,"535058cfb921109397033e463e8f8ea64bf1c3e2","2020-04-11T20:00:00Z",254,NA,120533,120533,120533,48,28,0,3925,890,4815
"721",20200411,"UT",2206,40340,NA,NA,190,NA,NA,NA,NA,NA,"aed7ede8563fb5e0601845af9649cc018e08d406","2020-04-11T20:00:00Z",18,190,42546,42546,42546,49,1,7,1680,104,1784
"722",20200411,"VA",5077,32922,517,1252,NA,709,NA,283,NA,NA,"48ece2c7bbb4be59fff46938cd10e3d81c72664a","2020-04-11T20:00:00Z",130,NA,38516,37999,37999,51,9,0,1972,568,2540
"723",20200411,"VI",51,299,20,3,NA,NA,NA,NA,NA,43,"846737287140472645be46cb0d3cf5fbab03815b","2020-04-11T20:00:00Z",1,NA,370,350,350,78,0,0,26,1,27
"724",20200411,"VT",711,8547,NA,77,NA,NA,NA,NA,NA,15,"44686c86db46ac9e0ed3fd3c5ec0b243858060d8","2020-04-11T20:00:00Z",25,NA,9258,9258,9258,50,1,0,994,32,1026
"725",20200411,"WA",10117,83391,NA,649,NA,191,NA,NA,NA,NA,"d2f916d77b4b32e912aad0da250e057ac5a6d3d2","2020-04-11T20:00:00Z",491,NA,93508,93508,93508,53,45,0,0,220,220
"726",20200411,"WI",3213,34680,NA,444,950,179,257,NA,NA,NA,"2d6d4254f4b1570432ae547a2251bd22f16e1f2c","2020-04-11T20:00:00Z",137,950,37893,37893,37893,55,9,46,1455,145,1600
"727",20200411,"WV",577,14875,NA,85,NA,40,NA,22,NA,63,"b5a667f02d5fa2f0312950c94e2cff983a5ab75d","2020-04-11T20:00:00Z",5,NA,15452,15452,15452,54,0,0,874,23,897
"728",20200411,"WY",261,5198,NA,NA,37,NA,NA,NA,NA,129,"ec8a322ffba1a10858e7b2e45c9d6febda25d776","2020-04-11T20:00:00Z",0,37,5459,5459,5459,56,0,0,462,8,470
"729",20200410,"AK",246,7186,NA,NA,28,NA,NA,NA,NA,55,"f72f6232f47812a602059afa4d5f4d698726aa3b","2020-04-10T20:00:00Z",7,28,7432,7432,7432,2,0,1,198,11,209
"730",20200410,"AL",2968,18058,NA,NA,368,NA,NA,NA,NA,NA,"deabcc53c679be6f942df9ba423a0d262ce45c5c","2020-04-10T20:00:00Z",80,368,21026,21026,21026,1,6,35,0,199,199
"731",20200410,"AR",1171,15949,NA,86,130,NA,43,33,39,312,"eed9ef5b44313459b1b49ca25a50a47df14fbc20","2020-04-10T20:00:00Z",23,130,17120,17120,17120,5,2,0,2117,52,2169
"732",20200410,"AS",0,3,2,NA,NA,NA,NA,NA,NA,NA,"f380a4ca829f914ba3535ed117102abc8fe7d43c","2020-04-10T20:00:00Z",0,NA,5,3,3,60,0,0,0,0,0
"733",20200410,"AZ",3112,34622,NA,NA,NA,NA,NA,NA,NA,NA,"f3ba26485902411adb8738870f9588c6ca100e6b","2020-04-10T20:00:00Z",97,NA,37734,37734,37734,4,8,0,462,94,556
"734",20200410,"CA",19472,145391,13900,2897,NA,1145,NA,NA,NA,NA,"7b7f43add244dd0beac30179ffa9cc26c01ac4cd","2020-04-10T20:00:00Z",541,NA,178763,164863,164863,6,49,0,200,1163,1363
"735",20200410,"CO",6510,26143,NA,842,1312,NA,NA,NA,NA,NA,"1f6196416d9b1623ae28c2a62688d8a097987cdd","2020-04-10T20:00:00Z",250,1312,32653,32653,32653,8,57,150,2599,855,3454
"736",20200410,"CT",10538,25750,NA,1562,NA,NA,NA,NA,NA,NA,"d837fdb36f289a47f704866efa7a975c6fd57275","2020-04-10T20:00:00Z",448,NA,36288,36288,36288,9,68,0,2032,754,2786
"737",20200410,"DC",1660,7695,NA,NA,NA,NA,NA,NA,NA,426,"7c6bf62e6c19aaa7b50946ee18cb701683abd073","2020-04-10T20:00:00Z",38,NA,9355,9355,9355,11,6,0,494,137,631
"738",20200410,"DE",1326,10415,NA,181,NA,NA,NA,NA,NA,177,"f85cebdacc98a38f07d28833e92b016fa4dc8afd","2020-04-10T20:00:00Z",23,NA,11741,11741,11741,10,0,0,1732,119,1851
"739",20200410,"FL",17531,145299,1411,NA,2487,NA,NA,NA,NA,NA,"0437d8adf77ea12d3a32f324bb51546af79a8b71","2020-04-10T20:00:00Z",390,2487,164241,162830,162830,12,36,219,9114,1167,10281
"740",20200410,"GA",11483,34664,NA,NA,2351,NA,NA,NA,NA,NA,"a86c13bf50abbedc6518f8959043eee9283da498","2020-04-10T20:00:00Z",416,2351,46147,46147,46147,13,37,192,4145,917,5062
"741",20200410,"GU",130,662,NA,14,NA,2,NA,2,NA,41,"c1c7a10a9b4263aa04238ac704dc651de9a5dfdd","2020-04-10T20:00:00Z",4,NA,792,792,792,66,0,0,69,2,71
"742",20200410,"HI",442,15707,NA,NA,42,NA,6,NA,2,251,"11d1477448eb2f3b1d0cd776a1cf18b0ed78e85f","2020-04-10T20:00:00Z",6,42,16149,16149,16149,15,1,0,391,7,398
"743",20200410,"IA",1388,14565,NA,125,NA,55,NA,30,NA,506,"cf06ef7ea2ce1c10bdedb84bdcc11451814ee3e1","2020-04-10T20:00:00Z",31,NA,15953,15953,15953,19,2,0,862,118,980
"744",20200410,"ID",1353,11741,NA,NA,127,NA,33,NA,NA,NA,"09f5794bcc50d38e9cd2132a6c3eddd78da2a208","2020-04-10T20:00:00Z",24,127,13094,13094,13094,16,6,14,442,121,563
"745",20200410,"IL",17887,69640,NA,3680,NA,1166,NA,821,NA,NA,"a611c14568ede32f626296251d9f95268c6a975f","2020-04-10T20:00:00Z",596,NA,87527,87527,87527,17,68,0,5205,1465,6670
"746",20200410,"IN",6907,28133,NA,NA,NA,820,NA,497,NA,NA,"bc9eede1aa2efa612414d45c0f39ffa6e2d174dd","2020-04-10T20:00:00Z",300,NA,35040,35040,35040,18,55,0,2351,556,2907
"747",20200410,"KS",1166,10248,NA,NA,274,NA,NA,NA,NA,NA,"d86d82fbef79b76de7b6bb09a5b536cf6f40b3d0","2020-04-10T20:00:00Z",50,274,11414,11414,11414,20,8,11,579,60,639
"748",20200410,"KY",1693,22595,NA,271,459,105,177,NA,NA,464,"d38ee043d21f9d9bec3e400d81df4c1ac102c33b","2020-04-10T20:00:00Z",90,459,24288,24288,24288,21,17,459,2140,347,2487
"749",20200410,"LA",19253,73027,NA,2054,NA,NA,NA,479,NA,NA,"16c20b191b25b668f0647db33d5c34aa2808544a","2020-04-10T20:00:00Z",755,NA,92280,92280,92280,22,53,0,4391,970,5361
"750",20200410,"MA",20974,81398,NA,NA,1956,NA,NA,NA,NA,NA,"8b7730535bc5b8dead6d18a4a4c3a1f0c02e2a20","2020-04-10T20:00:00Z",599,1956,102372,102372,102372,25,96,209,5381,2033,7414
"751",20200410,"MD",6968,37480,NA,NA,1413,NA,NA,NA,NA,397,"3a611c353715227700aaf71149af9a15a62ac7c2","2020-04-10T20:00:00Z",171,1413,44448,44448,44448,24,33,65,2136,783,2919
"752",20200410,"ME",586,6088,NA,NA,111,NA,NA,NA,NA,246,"edcc463ba06ffef28da371e9fd40e073ac48d5a9","2020-04-10T20:00:00Z",17,111,6674,6674,6674,23,1,6,0,26,26
"753",20200410,"MI",22783,49261,NA,3823,NA,1663,NA,1394,NA,56,"98994da86c7132b2f2f83b0cc20710255565f6d1","2020-04-10T20:00:00Z",1281,NA,72044,72044,72044,26,205,0,3711,1279,4990
"754",20200410,"MN",1336,32558,NA,143,317,64,131,NA,NA,732,"b0ce47b8d2c469ae70f548dda74437ae58ac5c93","2020-04-10T20:00:00Z",57,317,33894,33894,33894,27,7,24,1506,94,1600
"755",20200410,"MO",3799,36941,NA,568,NA,NA,NA,NA,NA,NA,"a7977b08cbff8551ece14b94762e1df5c225dbac","2020-04-10T20:00:00Z",96,NA,40740,40740,40740,29,19,0,1986,260,2246
"756",20200410,"MP",11,27,9,NA,NA,NA,NA,NA,NA,NA,"a01de0528870e6505c5107d4906b0e1cf768b55a","2020-04-10T20:00:00Z",2,NA,47,38,38,69,0,0,0,0,0
"757",20200410,"MS",2469,18632,NA,NA,482,NA,NA,NA,NA,NA,"267b52d12346a2d87ec4ce44f602440d51099037","2020-04-10T20:00:00Z",82,482,21101,21101,21101,28,6,41,0,209,209
"758",20200410,"MT",365,7932,NA,29,41,NA,NA,NA,NA,165,"17d4382671100d496c21cd8670c9afc03144c70d","2020-04-10T20:00:00Z",6,41,8297,8297,8297,30,0,5,426,11,437
"759",20200410,"NC",3908,53737,NA,423,NA,NA,NA,NA,NA,NA,"eaf63c7099f9715b6d487305c238aac2b9a20e3d","2020-04-10T20:00:00Z",74,NA,57645,57645,57645,37,9,0,9579,257,9836
"760",20200410,"ND",278,9330,NA,13,36,NA,NA,NA,NA,105,"9994e28867ec9ac2df5ad6da0d17c0da3c58e955","2020-04-10T20:00:00Z",6,36,9608,9608,9608,38,1,2,609,9,618
"761",20200410,"NE",635,8719,NA,NA,NA,NA,NA,NA,NA,NA,"142d1f81156a102997f1db5e3ca7c20ddceaa655","2020-04-10T20:00:00Z",15,NA,9354,9354,9354,31,1,0,603,68,671
"762",20200410,"NH",819,9139,155,NA,124,NA,NA,NA,NA,234,"989460ace7ce2a2284f1442d60b994abfcb6176d","2020-04-10T20:00:00Z",21,124,10113,9958,9958,33,3,6,376,31,407
"763",20200410,"NJ",54588,58935,NA,7570,NA,1679,NA,1663,NA,682,"a416d702cd805b6a6da57f4770c93b3df78c267b","2020-04-10T20:00:00Z",1932,NA,113523,113523,113523,34,232,0,2770,3561,6331
"764",20200410,"NM",1091,26007,NA,73,NA,NA,NA,18,NA,217,"b17728fffb713e971580bc824240a489bfffa008","2020-04-10T20:00:00Z",19,NA,27098,27098,27098,35,3,0,3065,226,3291
"765",20200410,"NV",2584,20165,NA,282,NA,NA,NA,NA,NA,NA,"6e8507d77f69509a31c92ce4ea3327b88c4e9706","2020-04-10T20:00:00Z",86,NA,22749,22749,22749,32,6,0,850,128,978
"766",20200410,"NY",170512,247373,NA,18569,38818,4908,NA,NA,NA,20249,"b9f6747819f23a6d4d2caddb7dab2b4568f829f4","2020-04-10T20:00:00Z",7844,38818,417885,417885,417885,36,777,2242,15761,10575,26336
"767",20200410,"OH",5836,52695,NA,NA,1755,NA,548,NA,NA,NA,"38d222fadd867ea8c8b8342f3d8858953fbba4bd","2020-04-10T20:00:00Z",231,1755,58531,58531,58531,39,18,143,2222,324,2546
"768",20200410,"OK",1794,20370,NA,186,428,122,NA,NA,NA,790,"d3fba58c0192f4eb15ae8ee5cadb0776f6186eba","2020-04-10T20:00:00Z",88,428,22164,22164,22164,40,8,13,1775,110,1885
"769",20200410,"OR",1321,24306,NA,146,326,66,NA,54,NA,NA,"9633f2a24e6dc4e0e6cff39ca519a0e65b239880","2020-04-10T20:00:00Z",44,326,25627,25627,25627,41,0,0,0,0,0
"770",20200410,"PA",19979,93040,NA,2072,NA,NA,NA,611,NA,NA,"fe2ff10aeb9a7872a49c0e8b849e73c32c36f285","2020-04-10T20:00:00Z",416,NA,113019,113019,113019,42,78,0,5666,1751,7417
"771",20200410,"PR",725,5121,1392,NA,NA,NA,NA,NA,NA,NA,"aca519d0dea20a8d0eaee68b47274458c9e8e179","2020-04-10T20:00:00Z",39,NA,7238,5846,5846,72,6,0,418,42,460
"772",20200410,"RI",2015,12281,NA,169,NA,45,NA,26,NA,35,"8b13c275050c994b155faf9675b601fb8ca82113","2020-04-10T20:00:00Z",49,NA,14296,14296,14296,44,6,0,1599,288,1887
"773",20200410,"SC",3065,25118,NA,NA,496,NA,NA,NA,NA,NA,"92199aa30fd4dd5ad130bdf4df1fc753f5dc6f57","2020-04-10T20:00:00Z",72,496,28183,28183,28183,45,5,255,543,273,816
"774",20200410,"SD",536,7111,NA,NA,29,NA,NA,NA,NA,177,"b87f4b357ef2f9c892ea11a46c8820b5430b192c","2020-04-10T20:00:00Z",6,29,7647,7647,7647,46,0,2,411,89,500
"775",20200410,"TN",4862,57937,NA,NA,536,NA,NA,NA,NA,1145,"e4ac457d8b0b17da3e94311a37cdebdae2178807","2020-04-10T20:00:00Z",98,536,62799,62799,62799,47,4,31,2722,228,2950
"776",20200410,"TX",11671,104047,NA,1532,NA,NA,NA,NA,NA,1366,"586fa304b254a11f480c37372834cb32ceaf4aea","2020-04-10T20:00:00Z",226,NA,115718,115718,115718,48,27,0,8143,1441,9584
"777",20200410,"UT",2102,38660,NA,NA,183,NA,NA,NA,NA,NA,"9922f7bcadc14b7394b2c54e39cc1916b6e9044c","2020-04-10T20:00:00Z",17,183,40762,40762,40762,49,4,15,2263,126,2389
"778",20200410,"VA",4509,30950,521,1238,772,457,NA,287,NA,NA,"4e73ce5191e84abcc39961e9a5b2f31bbdeb628b","2020-04-10T20:00:00Z",121,772,35980,35459,35459,51,12,87,1966,467,2433
"779",20200410,"VI",50,273,45,3,NA,NA,NA,NA,NA,43,"88e39033fbbd388c97c41f4ac80d942c1749824a","2020-04-10T20:00:00Z",1,NA,368,323,323,78,0,0,22,4,26
"780",20200410,"VT",679,7553,NA,32,NA,NA,NA,NA,NA,15,"dc96a20cf819e19bcf41ad74d575ae858dacf10c","2020-04-10T20:00:00Z",24,NA,8232,8232,8232,50,1,0,0,51,51
"781",20200410,"WA",9897,83391,NA,642,NA,191,NA,NA,NA,NA,"d8144098cec26c7ad6aa0fa050f740bfef47d72a","2020-04-10T20:00:00Z",446,NA,93288,93288,93288,53,0,0,0,448,448
"782",20200410,"WI",3068,33225,NA,NA,904,190,247,NA,NA,NA,"1eeea810191607f248c1426c6d8b32934ec5365b","2020-04-10T20:00:00Z",128,904,36293,36293,36293,55,17,61,1801,183,1984
"783",20200410,"WV",554,14001,NA,85,NA,20,NA,22,NA,63,"230ef679b8324b5fdf188b5acd7c07d4abf5e044","2020-04-10T20:00:00Z",5,NA,14555,14555,14555,54,0,0,661,31,692
"784",20200410,"WY",253,4736,NA,NA,37,NA,NA,NA,NA,105,"542f22512141736619d47feb0b66d9539e12bb4e","2020-04-10T20:00:00Z",0,37,4989,4989,4989,56,0,3,816,23,839
"785",20200409,"AK",235,6988,NA,NA,27,NA,NA,NA,NA,49,"b25c4a1e5bb964d05142022307f57e41e0872f26","2020-04-09T20:00:00Z",7,27,7223,7223,7223,2,0,0,146,9,155
"786",20200409,"AL",2769,18058,NA,NA,333,NA,NA,NA,NA,NA,"34ec8a688f0984d69a58ddef29d640ace6ee65bf","2020-04-09T20:00:00Z",74,333,20827,20827,20827,1,8,19,1305,400,1705
"787",20200409,"AR",1119,13832,NA,73,130,NA,43,31,39,288,"d21f4f58502c23fd66e3842b4b6eb7c9c18ccdf0","2020-04-09T20:00:00Z",21,130,14951,14951,14951,5,3,0,302,119,421
"788",20200409,"AS",0,3,2,NA,NA,NA,NA,NA,NA,NA,"4550449cb174c1fcabdb4d4e92ebe0a79b4bd30f","2020-04-09T20:00:00Z",0,NA,5,3,3,60,0,0,0,0,0
"789",20200409,"AZ",3018,34160,NA,NA,NA,NA,NA,NA,NA,NA,"a706debeb0a3336ce380a04afeca43b1f77d44c9","2020-04-09T20:00:00Z",89,NA,37178,37178,37178,4,9,0,2322,292,2614
"790",20200409,"CA",18309,145191,14100,2825,NA,1132,NA,NA,NA,NA,"415e9a2ee1c4debcc75db294bc356b28a291a185","2020-04-09T20:00:00Z",492,NA,177600,163500,163500,6,50,0,17884,1352,19236
"791",20200409,"CO",5655,23544,NA,848,1162,NA,NA,NA,NA,NA,"7da5b0594d9ac4a43b4ebef17fba2e299929b704","2020-04-09T20:00:00Z",193,1162,29199,29199,29199,8,14,83,879,226,1105
"792",20200409,"CT",9784,23718,NA,1464,NA,NA,NA,NA,NA,NA,"4f9311d78efaba1380411da694bf2264bf3f4c69","2020-04-09T20:00:00Z",380,NA,33502,33502,33502,9,103,0,2463,2003,4466
"793",20200409,"DC",1523,7201,NA,NA,NA,NA,NA,NA,NA,393,"5f3e6ed3208c06cc3446e80b46ca4bc5fee989b1","2020-04-09T20:00:00Z",32,NA,8724,8724,8724,11,5,0,358,83,441
"794",20200409,"DE",1207,8683,NA,201,NA,NA,NA,NA,NA,173,"45f2d85472665b02bd94b4ef5f6a05fca3661bd0","2020-04-09T20:00:00Z",23,NA,9890,9890,9890,10,7,0,1055,279,1334
"795",20200409,"FL",16364,136185,1395,NA,2268,NA,NA,NA,NA,NA,"754e4c4bc873607e36e18febcf6f6f3fe17eef34","2020-04-09T20:00:00Z",354,2268,153944,152549,152549,12,45,206,8506,909,9415
"796",20200409,"GA",10566,30519,NA,NA,2159,NA,NA,NA,NA,NA,"e55d4dcfec26e2fede63494733c002a68b541521","2020-04-09T20:00:00Z",379,2159,41085,41085,41085,13,17,166,1633,665,2298
"797",20200409,"GU",128,593,NA,14,NA,2,NA,2,NA,33,"8d0d6f8cf4948a29fbe75c2c6068e2e4bc336303","2020-04-09T20:00:00Z",4,NA,721,721,721,66,0,0,31,3,34
"798",20200409,"HI",435,15316,NA,NA,42,NA,6,NA,NA,113,"b8cac0a3e57db8fcb5f8784a24ff0292859ce8b1","2020-04-09T20:00:00Z",5,42,15751,15751,15751,15,0,0,577,25,602
"799",20200409,"IA",1270,13703,NA,122,NA,NA,NA,NA,NA,476,"1f9d61aaf5b280767ba36847ddc362d1b27327f9","2020-04-09T20:00:00Z",29,NA,14973,14973,14973,19,2,0,882,125,1007
"800",20200409,"ID",1232,11299,NA,NA,113,NA,29,NA,NA,NA,"2cbe02b18b0ca2023e2896936099c1de3f2793ca","2020-04-09T20:00:00Z",18,113,12531,12531,12531,16,3,20,611,22,633
"801",20200409,"IL",16422,64435,NA,3680,NA,1166,NA,821,NA,NA,"4a5176c1a33a75ad4f04db3b40abc94f7f24bfe5","2020-04-09T20:00:00Z",528,NA,80857,80857,80857,17,66,0,4447,1344,5791
"802",20200409,"IN",6351,25782,NA,NA,NA,924,NA,507,NA,NA,"1406da427afc443d36e088a6059820b56836038e","2020-04-09T20:00:00Z",245,NA,32133,32133,32133,18,42,0,856,408,1264
"803",20200409,"KS",1106,9669,NA,NA,263,NA,NA,NA,NA,NA,"dc24b13ac61718730956dec0e03f27c8b1f93822","2020-04-09T20:00:00Z",42,263,10775,10775,10775,20,4,40,532,60,592
"804",20200409,"KY",1346,20455,NA,NA,NA,NA,NA,NA,NA,NA,"4fb35d2fca57462d9af6173dfc7908eca90f57f4","2020-04-09T20:00:00Z",73,NA,21801,21801,21801,21,8,0,0,197,197
"805",20200409,"LA",18283,68636,NA,2014,NA,NA,NA,473,NA,NA,"f2b7e11d6a23a663135d5c22b782e3fe824a9623","2020-04-09T20:00:00Z",702,NA,86919,86919,86919,22,50,0,4260,1253,5513
"806",20200409,"MA",18941,76017,NA,NA,1747,NA,NA,NA,NA,NA,"b11a7d65a58f21a74215521505414bdb2b385bbc","2020-04-09T20:00:00Z",503,1747,94958,94958,94958,25,70,164,5296,2151,7447
"807",20200409,"MD",6185,35344,NA,NA,1348,NA,NA,NA,NA,376,"dd11e0579e86c2a04984fc8a6c92a033633133a0","2020-04-09T20:00:00Z",138,1348,41529,41529,41529,24,14,138,2411,656,3067
"808",20200409,"ME",560,6088,NA,NA,105,NA,NA,NA,NA,202,"de9357008b267094a60a0ac8ff7fd3c2dc3466c0","2020-04-09T20:00:00Z",16,105,6648,6648,6648,23,2,4,0,23,23
"809",20200409,"MI",21504,45550,NA,3826,NA,1628,NA,1434,NA,56,"17e988d651529c4378e3d66af16ab70a20092e7f","2020-04-09T20:00:00Z",1076,NA,67054,67054,67054,26,117,0,0,915,915
"810",20200409,"MN",1242,31052,NA,145,293,63,119,NA,NA,675,"cdf145be23b01c96273d3c5925c78004122d3677","2020-04-09T20:00:00Z",50,293,32294,32294,32294,27,11,22,1453,88,1541
"811",20200409,"MO",3539,34955,NA,568,NA,NA,NA,NA,NA,NA,"b97f337b09235d8410b8c2a2f9d134d4d38e89f3","2020-04-09T20:00:00Z",77,NA,38494,38494,38494,29,19,0,4172,212,4384
"812",20200409,"MP",11,27,9,NA,NA,NA,NA,NA,NA,NA,"2923ea3c9e9309ed8d343db9349620a8388522e7","2020-04-09T20:00:00Z",2,NA,47,38,38,69,0,0,0,0,0
"813",20200409,"MS",2260,18632,NA,NA,441,NA,NA,NA,NA,NA,"a1e53262497df092c0e0c4ca9af9fd8f23aafe66","2020-04-09T20:00:00Z",76,441,20892,20892,20892,28,9,31,0,257,257
"814",20200409,"MT",354,7506,NA,13,36,NA,NA,NA,NA,157,"c26e42cdca9c9d43ffd76a58290bd6a75c28198d","2020-04-09T20:00:00Z",6,36,7860,7860,7860,30,0,5,440,22,462
"815",20200409,"NC",3651,44158,NA,398,NA,NA,NA,NA,NA,NA,"a6a57caf54cc0f7c9a4d14df31be2434fe42b80d","2020-04-09T20:00:00Z",65,NA,47809,47809,47809,37,12,0,4597,225,4822
"816",20200409,"ND",269,8721,NA,14,34,NA,NA,NA,NA,101,"6ac57451eb83c5297a3f2fe18e496d59f112de5a","2020-04-09T20:00:00Z",5,34,8990,8990,8990,38,1,0,420,18,438
"817",20200409,"NE",567,8116,NA,NA,NA,NA,NA,NA,NA,NA,"fce6cfce0f23547227601671cf284cae2df67536","2020-04-09T20:00:00Z",14,NA,8683,8683,8683,31,2,0,674,48,722
"818",20200409,"NH",788,8763,143,NA,118,NA,NA,NA,NA,227,"b8d573ac2c092ed49dcab22fdc1f47f4cfed830d","2020-04-09T20:00:00Z",18,118,9694,9551,9551,33,0,0,374,0,374
"819",20200409,"NJ",51027,56165,NA,7363,NA,1523,NA,1551,NA,NA,"d3664bdf91bd8ece813cb2d55230b4895f54b2c0","2020-04-09T20:00:00Z",1700,NA,107192,107192,107192,34,196,0,3186,3590,6776
"820",20200409,"NM",865,22942,NA,59,NA,NA,NA,18,NA,201,"d5a00c6606ab48f22af533b1282f8163225fc10d","2020-04-09T20:00:00Z",16,NA,23807,23807,23807,35,3,0,1491,71,1562
"821",20200409,"NV",2456,19315,NA,282,NA,NA,NA,NA,NA,NA,"9635ff95f130d1857de5d74bacf7f6c72af5d972","2020-04-09T20:00:00Z",80,NA,21771,21771,21771,32,9,0,1067,138,1205
"822",20200409,"NY",159937,231612,NA,18279,36576,4925,NA,NA,NA,18297,"adcfe0b7d9f5faf78429b00c69af00833443c8ec","2020-04-09T20:00:00Z",7067,36576,391549,391549,391549,36,799,2144,15775,10621,26396
"823",20200409,"OH",5512,50473,NA,NA,1612,NA,497,NA,NA,NA,"f099bcbfbf8d79d1541a85ea927661eac603a881","2020-04-09T20:00:00Z",213,1612,55985,55985,55985,39,20,117,2280,364,2644
"824",20200409,"OK",1684,18595,NA,188,415,120,NA,NA,NA,686,"4134ad5e4d3911e0700b88a7aaae9339b1f207b6","2020-04-09T20:00:00Z",80,415,20279,20279,20279,40,1,25,6774,160,6934
"825",20200409,"OR",1321,24306,NA,146,326,66,NA,54,NA,NA,"06d3913b0eccc967a1a12517d7f8e4783ce8f591","2020-04-09T20:00:00Z",44,326,25627,25627,25627,41,11,2,981,82,1063
"826",20200409,"PA",18228,87374,NA,2051,NA,NA,NA,592,NA,NA,"8e11977c61eb78c15db006bc6135ab8066828777","2020-04-09T20:00:00Z",338,NA,105602,105602,105602,42,29,0,5075,1989,7064
"827",20200409,"PR",683,4703,1304,NA,NA,NA,NA,NA,NA,NA,"3bb866405c927aaf77a70f81b17ece80ef99c327","2020-04-09T20:00:00Z",33,NA,6690,5386,5386,72,9,0,437,63,500
"828",20200409,"RI",1727,10682,NA,160,NA,45,NA,26,NA,35,"fd47654c67cacd1940a1c7cffa0df6b0214882aa","2020-04-09T20:00:00Z",43,NA,12409,12409,12409,44,8,0,0,277,277
"829",20200409,"SC",2792,24575,NA,NA,241,NA,NA,NA,NA,NA,"c05090d9d4cd23e93dadd900e6c6ebb2cc5b00f6","2020-04-09T20:00:00Z",67,241,27367,27367,27367,45,4,0,2493,240,2733
"830",20200409,"SD",447,6700,NA,NA,27,NA,NA,NA,NA,161,"8cfce8992986ecd4882180246461d58c60cbb9cf","2020-04-09T20:00:00Z",6,27,7147,7147,7147,46,0,1,345,54,399
"831",20200409,"TN",4634,55215,NA,NA,505,NA,NA,NA,NA,921,"520c002646bd19f9e80ae12d8f8315aab83d0297","2020-04-09T20:00:00Z",94,505,59849,59849,59849,47,15,56,2959,272,3231
"832",20200409,"TX",10230,95904,NA,1439,NA,NA,NA,NA,NA,1101,"fe4a67d30a9035e09c2e041eb4efaa22284bb709","2020-04-09T20:00:00Z",199,NA,106134,106134,106134,48,22,0,8999,877,9876
"833",20200409,"UT",1976,36397,NA,NA,168,NA,NA,NA,NA,NA,"34ed9aa981dc493348917a34c5d37854cab5b2b3","2020-04-09T20:00:00Z",13,168,38373,38373,38373,49,0,10,2127,130,2257
"834",20200409,"VA",4042,28984,627,669,685,469,NA,285,NA,NA,"32a8135f572c4f5c6851cbeced9b22c53353e7df","2020-04-09T20:00:00Z",109,685,33653,33026,33026,51,34,70,1984,397,2381
"835",20200409,"VI",46,251,42,NA,NA,NA,NA,NA,NA,39,"330da68f6494e174387505355ee3fa2cfdaa9e42","2020-04-09T20:00:00Z",1,NA,339,297,297,78,0,0,9,1,10
"836",20200409,"VT",628,7553,NA,33,NA,NA,NA,NA,NA,15,"24b22733110eb020e8f1caee0a2cb8db9dd3b934","2020-04-09T20:00:00Z",23,NA,8181,8181,8181,50,0,0,409,23,432
"837",20200409,"WA",9449,83391,NA,650,NA,191,NA,NA,NA,NA,"665982787afb1f13f43548dbf459a933d29323a7","2020-04-09T20:00:00Z",446,NA,92840,92840,92840,53,0,0,0,279,279
"838",20200409,"WI",2885,31424,NA,NA,843,NA,230,NA,NA,NA,"aa5c7ae162799320b7accdadf68720fdb6c50f52","2020-04-09T20:00:00Z",111,843,34309,34309,34309,55,12,53,1309,129,1438
"839",20200409,"WV",523,13340,NA,NA,NA,NA,NA,NA,NA,NA,"54cf0e05059125cce24ebdf1fdfdff35af1f361b","2020-04-09T20:00:00Z",5,NA,13863,13863,13863,54,1,0,1257,61,1318
"840",20200409,"WY",230,3920,NA,NA,34,NA,NA,NA,NA,94,"231a30211b44fe5c73eef7f2161a0d501c682df9","2020-04-09T20:00:00Z",0,34,4150,4150,4150,56,0,1,77,9,86
"841",20200408,"AK",226,6842,NA,NA,27,NA,NA,NA,NA,32,"b06950cbd3502f7885c9412d1bf698858848a4d7","2020-04-08T20:00:00Z",7,27,7068,7068,7068,2,1,4,142,13,155
"842",20200408,"AL",2369,16753,NA,NA,314,NA,NA,NA,NA,NA,"d7c974f24aac9af8f039f0c9d4627e059267b4a1","2020-04-08T20:00:00Z",66,314,19122,19122,19122,1,10,43,3956,250,4206
"843",20200408,"AR",1000,13530,NA,76,130,NA,43,30,39,208,"dc9ad2f9b7456a55682f25d3f5569a8a420a7f0c","2020-04-08T20:00:00Z",18,130,14530,14530,14530,5,2,-18,838,54,892
"844",20200408,"AS",0,3,2,NA,NA,NA,NA,NA,NA,NA,"b1e0124ac6fe5ca02b1b17dc2464d3b5b31ace83","2020-04-08T20:00:00Z",0,NA,5,3,3,60,0,0,0,0,0
"845",20200408,"AZ",2726,31838,NA,NA,NA,NA,NA,NA,NA,NA,"2b3096a859b88875d9972e3e5521cd07aed78996","2020-04-08T20:00:00Z",80,NA,34564,34564,34564,4,7,0,1038,151,1189
"846",20200408,"CA",16957,127307,14600,2714,NA,1154,NA,NA,NA,NA,"c597c8b5b77b179c9e590a881c97d79fea2bd2db","2020-04-08T20:00:00Z",442,NA,158864,144264,144264,6,68,0,11943,1092,13035
"847",20200408,"CO",5429,22665,NA,833,1079,NA,NA,NA,NA,NA,"c10a0cb31be734e887bcd88fee27d7b8174bc1bc","2020-04-08T20:00:00Z",179,1079,28094,28094,28094,8,29,85,962,257,1219
"848",20200408,"CT",7781,21255,NA,1308,NA,NA,NA,NA,NA,NA,"45534c8765623e13c69801a1e66891b07171f925","2020-04-08T20:00:00Z",277,NA,29036,29036,29036,9,0,0,0,0,0
"849",20200408,"DC",1440,6843,NA,NA,NA,NA,NA,NA,NA,361,"6a984539ee98fd18f8879705bea3637b3d17c542","2020-04-08T20:00:00Z",27,NA,8283,8283,8283,11,5,0,231,229,460
"850",20200408,"DE",928,7628,NA,147,NA,NA,NA,NA,NA,144,"9a8eba55923c74303bfcc615fc6cd39c2d834f80","2020-04-08T20:00:00Z",16,NA,8556,8556,8556,10,0,0,0,0,0
"851",20200408,"FL",15455,127679,1324,NA,2062,NA,NA,NA,NA,NA,"9ca6b245b17a0b8b9a414985df6f5e8338c1dd30","2020-04-08T20:00:00Z",309,2062,144458,143134,143134,12,13,63,4264,708,4972
"852",20200408,"GA",9901,28886,NA,NA,1993,NA,NA,NA,NA,NA,"a895f3bea3a6eef44bee143492725ba4af74c53d","2020-04-08T20:00:00Z",362,1993,38787,38787,38787,13,33,219,3991,1083,5074
"853",20200408,"GU",125,562,NA,21,NA,2,NA,2,NA,31,"f3056dbcf91af97f2a4055fc511d9f5e69e758fe","2020-04-08T20:00:00Z",4,NA,687,687,687,66,0,0,33,4,37
"854",20200408,"HI",410,14739,NA,NA,42,NA,6,NA,NA,113,"c791e64551362c9d3458669437df3833d46bb4b6","2020-04-08T20:00:00Z",5,42,15149,15149,15149,15,0,16,1584,23,1607
"855",20200408,"IA",1145,12821,NA,122,193,NA,NA,NA,NA,431,"6ed8bb2a57d38b65911feac6a484fec23d956882","2020-04-08T20:00:00Z",27,193,13966,13966,13966,19,1,0,1151,97,1248
"856",20200408,"ID",1210,10688,NA,NA,93,NA,24,NA,NA,NA,"27b547d754d7b7848ee8bf6006162b7a42221c6d","2020-04-08T20:00:00Z",15,93,11898,11898,11898,16,2,10,612,40,652
"857",20200408,"IL",15078,59988,NA,3680,NA,1166,NA,821,NA,NA,"db2da93a6acb672606b2a7d6aa39ea427bbb3701","2020-04-08T20:00:00Z",462,NA,75066,75066,75066,17,82,0,4805,1529,6334
"858",20200408,"IN",5943,24926,NA,NA,NA,924,NA,507,NA,NA,"fbbf8a2b8324dab4096dc4c4082c442d1a303a08","2020-04-08T20:00:00Z",203,NA,30869,30869,30869,18,30,0,1669,436,2105
"859",20200408,"KS",1046,9137,NA,NA,223,NA,NA,NA,NA,NA,"fd8d2aea43b7e390c0426d2ac0120a9d5aa12c57","2020-04-08T20:00:00Z",38,223,10183,10183,10183,20,11,0,523,146,669
"860",20200408,"KY",1149,20455,NA,NA,NA,NA,NA,NA,NA,NA,"f4d5b5432b32b07295608c1298bee85c9dcb6c5e","2020-04-08T20:00:00Z",65,NA,21604,21604,21604,21,6,0,1508,141,1649
"861",20200408,"LA",17030,64376,NA,1983,NA,NA,NA,490,NA,NA,"c174ce072a8244ab0d33a6f3f195c03aa665816d","2020-04-08T20:00:00Z",652,NA,81406,81406,81406,22,70,0,6005,746,6751
"862",20200408,"MA",16790,70721,NA,NA,1583,NA,NA,NA,NA,NA,"7915e32cef3119c45147580dc68353c32922bf20","2020-04-08T20:00:00Z",433,1583,87511,87511,87511,25,77,148,4579,1588,6167
"863",20200408,"MD",5529,32933,NA,NA,1210,NA,NA,NA,NA,365,"d47d07ee138d924014565dabdc5316462616b927","2020-04-08T20:00:00Z",124,1210,38462,38462,38462,24,21,104,5677,1158,6835
"864",20200408,"ME",537,6088,NA,NA,101,NA,NA,NA,NA,187,"ae1b00dd8f587c7cc0ff1fec4f62af3e28f48c2d","2020-04-08T20:00:00Z",14,101,6625,6625,6625,23,2,2,0,18,18
"865",20200408,"MI",20589,45550,NA,NA,NA,NA,NA,NA,NA,56,"069cf53c2a7e5ed44fbbe8e54a6aa7c9cf6a070a","2020-04-08T20:00:00Z",959,NA,66139,66139,66139,26,114,0,0,766,766
"866",20200408,"MN",1154,29599,NA,135,271,64,105,NA,NA,632,"d35b537cf4cb211b89d42f83477e0ac688431c6a","2020-04-08T20:00:00Z",39,271,30753,30753,30753,27,5,29,1408,85,1493
"867",20200408,"MO",3327,30783,NA,519,NA,NA,NA,NA,NA,NA,"d610dbf95f9ce914e35925513bd27000667a1dd5","2020-04-08T20:00:00Z",58,NA,34110,34110,34110,29,5,0,1851,290,2141
"868",20200408,"MP",11,27,9,NA,NA,NA,NA,NA,NA,NA,"735ed7fb7685d4eeb3831a9c3d19b1b39665d89f","2020-04-08T20:00:00Z",2,NA,47,38,38,69,0,0,12,3,15
"869",20200408,"MS",2003,18632,NA,NA,410,NA,NA,NA,NA,NA,"fcd575a3ceb3f1a059d37279be733e6d49d79eb0","2020-04-08T20:00:00Z",67,410,20635,20635,20635,28,8,33,0,88,88
"870",20200408,"MT",332,7066,NA,NA,31,NA,NA,NA,NA,135,"36c57219663afe4f9a25d8bb1219124aabcbc5c6","2020-04-08T20:00:00Z",6,31,7398,7398,7398,30,0,3,400,13,413
"871",20200408,"NC",3426,39561,NA,386,NA,NA,NA,NA,NA,NA,"ef6411c1805a6c8509d4b7acf726edd78546548e","2020-04-08T20:00:00Z",53,NA,42987,42987,42987,37,7,0,1700,205,1905
"872",20200408,"ND",251,8301,NA,16,34,NA,NA,NA,NA,98,"f5b46f7b1cf2660fc83947337d0163f20ba2e916","2020-04-08T20:00:00Z",4,34,8552,8552,8552,38,0,1,835,14,849
"873",20200408,"NE",519,7442,NA,NA,NA,NA,NA,NA,NA,NA,"f0d5c983d53155a6c8258ec5594807b0dae155a8","2020-04-08T20:00:00Z",12,NA,7961,7961,7961,31,2,0,631,72,703
"874",20200408,"NH",788,8389,89,NA,118,NA,NA,NA,NA,211,"7ebe9caa69ad598a5afd77ca6ca988541ac6e9ab","2020-04-08T20:00:00Z",18,118,9266,9177,9177,33,9,15,370,73,443
"875",20200408,"NJ",47437,52979,NA,7026,NA,1617,NA,1576,NA,NA,"1ce238d30dd4f486d2f2bb36bef82c329b90fde8","2020-04-08T20:00:00Z",1504,NA,100416,100416,100416,34,272,0,2421,3021,5442
"876",20200408,"NM",794,21451,NA,51,NA,NA,NA,18,NA,171,"5e9d9f69e1e9d52d200ebc187b2ec3a4e126db63","2020-04-08T20:00:00Z",13,NA,22245,22245,22245,35,1,0,312,108,420
"877",20200408,"NV",2318,18248,NA,282,NA,NA,NA,NA,NA,NA,"8eeef516219c0235bb9ccef8db9926eb66f200dd","2020-04-08T20:00:00Z",71,NA,20566,20566,20566,32,13,0,1696,231,1927
"878",20200408,"NY",149316,215837,NA,18079,34432,4593,NA,NA,NA,16353,"36db5397b3f156232e908feab224b44a19364028","2020-04-08T20:00:00Z",6268,34432,365153,365153,365153,36,779,2349,14642,10453,25095
"879",20200408,"OH",5148,48193,NA,NA,1495,NA,472,NA,NA,NA,"3a07f6e617059a639f0e53d3277927ef65015168","2020-04-08T20:00:00Z",193,1495,53341,53341,53341,39,26,141,2137,366,2503
"880",20200408,"OK",1524,11821,NA,188,390,120,NA,NA,NA,686,"162bc2c40a69457aa64daeba84ab2b0950a8b6e5","2020-04-08T20:00:00Z",79,390,13345,13345,13345,40,12,14,0,52,52
"881",20200408,"OR",1239,23325,NA,156,324,61,NA,58,69,NA,"1c86840efc88ab6828b14988c2d5983a6049dc2e","2020-04-08T20:00:00Z",33,324,24564,24564,24564,41,0,0,1499,58,1557
"882",20200408,"PA",16239,82299,NA,1898,NA,NA,NA,603,NA,NA,"cab36f3232f06858b95f1664b7788dadbf0f93a1","2020-04-08T20:00:00Z",309,NA,98538,98538,98538,42,69,0,5580,1680,7260
"883",20200408,"PR",620,4266,1160,NA,NA,NA,NA,NA,NA,NA,"35f7ff30a6a6ed0b45cd9139f6ef39aa0edf4057","2020-04-08T20:00:00Z",24,NA,6046,4886,4886,72,1,0,300,47,347
"884",20200408,"RI",1450,10682,NA,143,NA,45,NA,26,NA,35,"98ac386411d8aecfd63defe746ee07ab45b33a5e","2020-04-08T20:00:00Z",35,NA,12132,12132,12132,44,5,0,1605,220,1825
"885",20200408,"SC",2552,22082,NA,NA,241,NA,NA,NA,NA,NA,"8f51f648224b34fc123427ec9411fe698b3fd55d","2020-04-08T20:00:00Z",63,241,24634,24634,24634,45,12,0,819,135,954
"886",20200408,"SD",393,6355,0,NA,26,NA,NA,NA,NA,146,"a8f46321eb94c8751dab4186c5050bb4ded8aee4","2020-04-08T20:00:00Z",6,26,6748,6748,6748,46,0,3,407,73,480
"887",20200408,"TN",4362,52256,NA,NA,449,NA,NA,NA,NA,592,"ff68dc08ca2226e687b39272db6329b7d75241b3","2020-04-08T20:00:00Z",79,449,56618,56618,56618,47,7,41,3520,224,3744
"888",20200408,"TX",9353,86905,NA,1491,NA,NA,NA,NA,NA,38,"93f1b214cb7a5167793d5ec07075b9602aca2613","2020-04-08T20:00:00Z",177,NA,96258,96258,96258,48,23,0,6518,1091,7609
"889",20200408,"UT",1846,34270,NA,NA,158,NA,NA,NA,NA,NA,"0ec7be922281b2c2e3ac1769448ed67ab2024183","2020-04-08T20:00:00Z",13,158,36116,36116,36116,49,0,10,1361,108,1469
"890",20200408,"VA",3645,27000,NA,NA,615,NA,145,NA,108,NA,"4f244cf2235f74c233ab8d9fe566115c0adce611","2020-04-08T20:00:00Z",75,615,30645,30645,30645,51,12,52,1688,312,2000
"891",20200408,"VI",45,242,35,NA,NA,NA,NA,NA,NA,39,"be21b51a3a90bca976c5226f32fc911743a57b90","2020-04-08T20:00:00Z",1,NA,322,287,287,78,0,0,20,2,22
"892",20200408,"VT",605,7144,NA,35,50,NA,NA,NA,NA,15,"b8f5da42c9c0c15c8ca16cc61712345084f0d207","2020-04-08T20:00:00Z",23,50,7749,7749,7749,50,0,5,590,30,620
"893",20200408,"WA",9170,83391,NA,655,NA,186,NA,NA,NA,NA,"25f93e0ec55f6decfb0c3b75508605b8fa89d7c4","2020-04-08T20:00:00Z",446,NA,92561,92561,92561,53,53,0,0,355,355
"894",20200408,"WI",2756,30115,NA,NA,790,NA,218,NA,NA,NA,"1e997110316d96e4af9dfed752e7c9bafaede693","2020-04-08T20:00:00Z",99,790,32871,32871,32871,55,7,45,1603,178,1781
"895",20200408,"WV",462,12083,NA,NA,NA,NA,NA,NA,NA,NA,"59287361f21a273826deacdebcd7572e171a3e34","2020-04-08T20:00:00Z",4,NA,12545,12545,12545,54,0,0,436,50,486
"896",20200408,"WY",221,3843,NA,NA,33,NA,NA,NA,NA,62,"871dc959c9d38ea20b4d4c856b22997e0bccaf55","2020-04-08T20:00:00Z",0,33,4064,4064,4064,56,0,0,54,5,59
"897",20200407,"AK",213,6700,NA,NA,23,NA,NA,NA,NA,29,"427f23b794025bcc59ba746dc6721ba1ae4f6ff9","2020-04-07T20:00:00Z",6,23,6913,6913,6913,2,0,0,8,22,30
"898",20200407,"AL",2119,12797,NA,NA,271,NA,NA,NA,NA,NA,"bc437164edce7423a9a6a0095632666a06d512c4","2020-04-07T20:00:00Z",56,271,14916,14916,14916,1,6,31,0,151,151
"899",20200407,"AR",946,12692,NA,74,148,NA,NA,26,43,142,"3091efb8651506655cf6538a5a63244288d812e8","2020-04-07T20:00:00Z",16,148,13638,13638,13638,5,0,11,722,71,793
"900",20200407,"AS",0,3,2,NA,NA,NA,NA,NA,NA,NA,"d76095b5eddc995d69df0f33197a6638cc6fbf7f","2020-04-07T20:00:00Z",0,NA,5,3,3,60,0,0,0,0,0
"901",20200407,"AZ",2575,30800,NA,NA,NA,NA,NA,NA,NA,NA,"943f82c1a910748ffe6ec553b93b7b964125cc38","2020-04-07T20:00:00Z",73,NA,33375,33375,33375,4,8,0,722,119,841
"902",20200407,"CA",15865,115364,14100,2611,NA,1108,NA,NA,NA,NA,"a2ab1e862259b9e5f29fc83a735a7402bacc7da6","2020-04-07T20:00:00Z",374,NA,145329,131229,131229,6,31,0,12269,1529,13798
"903",20200407,"CO",5172,21703,NA,786,994,NA,NA,NA,NA,NA,"12249a5bdf925092cbd469cb2a578f54ad5a4c99","2020-04-07T20:00:00Z",150,994,26875,26875,26875,8,10,70,880,222,1102
"904",20200407,"CT",7781,21255,NA,1308,NA,NA,NA,NA,NA,NA,"824d1ebd3f4b1c49e597d77753df238341173130","2020-04-07T20:00:00Z",277,NA,29036,29036,29036,9,71,0,1475,875,2350
"905",20200407,"DC",1211,6612,NA,NA,NA,NA,NA,NA,NA,318,"4bb7cd953c61db17cc89b08b77d926f2eea787e6","2020-04-07T20:00:00Z",22,NA,7823,7823,7823,11,-2,0,256,114,370
"906",20200407,"DE",928,7628,NA,147,NA,NA,NA,NA,NA,144,"b59047f7944fc9482b1f7653159655f7a5bfad7b","2020-04-07T20:00:00Z",16,NA,8556,8556,8556,10,2,0,1307,255,1562
"907",20200407,"FL",14747,123415,1407,NA,1999,NA,NA,NA,NA,NA,"14451271e31c6ef62ec1fed25030c8bbcadd8c83","2020-04-07T20:00:00Z",296,1999,139569,138162,138162,12,60,317,13465,1423,14888
"908",20200407,"GA",8818,24895,NA,NA,1774,NA,NA,NA,NA,NA,"7a0ffe5a1d036f2a779e0d14397523b71ac8241a","2020-04-07T20:00:00Z",329,1774,33713,33713,33713,13,100,442,935,1504,2439
"909",20200407,"GU",121,529,NA,21,NA,2,NA,2,NA,27,"e4f1f3a809ee107b77e669dd351b0ea512d64a40","2020-04-07T20:00:00Z",4,NA,650,650,650,66,0,0,24,8,32
"910",20200407,"HI",387,13155,NA,NA,26,NA,6,NA,NA,89,"06de5ddab7916756cd9f985d7476ee41c2851291","2020-04-07T20:00:00Z",5,26,13542,13542,13542,15,1,5,0,16,16
"911",20200407,"IA",1048,11670,NA,104,193,NA,NA,NA,NA,341,"ae5471f42b9f26b00ec9f67c82c73e0e96bf77ac","2020-04-07T20:00:00Z",26,193,12718,12718,12718,19,1,14,1017,102,1119
"912",20200407,"ID",1170,10076,NA,NA,83,NA,21,NA,NA,NA,"2223b4fd3b2130cde4c6e92876814d778ecc7ec7","2020-04-07T20:00:00Z",13,83,11246,11246,11246,16,3,6,182,69,251
"913",20200407,"IL",13549,55183,NA,3680,NA,1166,NA,821,NA,NA,"01860afc01cd1aaca444ed3812a2f910c2871cf5","2020-04-07T20:00:00Z",380,NA,68732,68732,68732,17,73,0,4503,1287,5790
"914",20200407,"IN",5507,23257,NA,NA,NA,924,NA,507,NA,NA,"42532e1054b8584b5dd3db8eaebb0ea3e0a5a8a3","2020-04-07T20:00:00Z",173,NA,28764,28764,28764,18,34,0,2010,563,2573
"915",20200407,"KS",900,8614,NA,NA,223,NA,NA,NA,NA,NA,"a47fd40f94b1f7214f6b6ff2b771091439fffd90","2020-04-07T20:00:00Z",27,223,9514,9514,9514,20,2,25,375,55,430
"916",20200407,"KY",1008,18947,NA,NA,NA,NA,NA,NA,NA,NA,"11fc69bcf9e209378b83b650cd855946fcf47ca9","2020-04-07T20:00:00Z",59,NA,19955,19955,19955,21,14,0,1135,53,1188
"917",20200407,"LA",16284,58371,NA,1996,NA,NA,NA,519,NA,NA,"9139f6e23f09c887df221642ce10c85516944f49","2020-04-07T20:00:00Z",582,NA,74655,74655,74655,22,70,0,4072,1417,5489
"918",20200407,"MA",15202,66142,NA,NA,1435,NA,NA,NA,NA,NA,"480c678f573f195caec6a15c44dcfe844e95ef3c","2020-04-07T20:00:00Z",356,1435,81344,81344,81344,25,96,194,3550,1365,4915
"919",20200407,"MD",4371,27256,NA,NA,1106,NA,NA,NA,NA,288,"c957680fdbd36cb8cd1d307885f4d5b9b1e87afd","2020-04-07T20:00:00Z",103,1106,31627,31627,31627,24,12,47,1684,326,2010
"920",20200407,"ME",519,6088,NA,NA,99,NA,NA,NA,NA,176,"af07f06f7bb91affb207dc39d20674e9ee2d4149","2020-04-07T20:00:00Z",12,99,6607,6607,6607,23,2,7,0,20,20
"921",20200407,"MI",19823,45550,NA,NA,NA,NA,NA,NA,NA,56,"8ff4cbadba372a60d39f847bceeaf9eab1db8001","2020-04-07T20:00:00Z",845,NA,65373,65373,65373,26,118,0,2430,973,3403
"922",20200407,"MN",1069,28191,NA,120,242,64,100,NA,NA,549,"1c6751a69dd6a4e9a349a62be6413fdbe71ea87a","2020-04-07T20:00:00Z",34,242,29260,29260,29260,27,4,19,1049,83,1132
"923",20200407,"MO",3037,28932,NA,508,NA,NA,NA,NA,NA,NA,"a3d2d6a3042c80afb487dfd2d4a7897fe0edee76","2020-04-07T20:00:00Z",53,NA,31969,31969,31969,29,14,0,1819,315,2134
"924",20200407,"MP",8,15,NA,NA,NA,NA,NA,NA,NA,NA,"70c7bf240bc0ee206b5e12ec30a64ffd6f19ca2a","2020-04-07T20:00:00Z",2,NA,23,23,23,69,1,0,2,0,2
"925",20200407,"MS",1915,18632,NA,NA,377,NA,NA,NA,NA,NA,"807ca25410f85d8883f0c8fe409f630d92091d1e","2020-04-07T20:00:00Z",59,377,20547,20547,20547,28,8,-98,0,177,177
"926",20200407,"MT",319,6666,NA,NA,28,NA,NA,NA,NA,NA,"7397072f3dbcb6c5c091e5ab277d8f2c2f68f82d","2020-04-07T20:00:00Z",6,28,6985,6985,6985,30,0,4,175,20,195
"927",20200407,"NC",3221,37861,NA,354,NA,NA,NA,NA,NA,NA,"67dd715b37f86ed85a0618ce86dd6b9d498dee2b","2020-04-07T20:00:00Z",46,NA,41082,41082,41082,37,13,0,5,351,356
"928",20200407,"ND",237,7466,NA,18,33,NA,NA,NA,NA,82,"59b258409a58763928c3aa0087984baad4dd1600","2020-04-07T20:00:00Z",4,33,7703,7703,7703,38,1,1,478,12,490
"929",20200407,"NE",447,6811,NA,NA,NA,NA,NA,NA,NA,NA,"518ded644af5182eecdac1ec28f9dede5f3b98d8","2020-04-07T20:00:00Z",10,NA,7258,7258,7258,31,2,0,433,38,471
"930",20200407,"NH",715,8019,49,NA,103,NA,NA,NA,NA,151,"9bdef844521f989a0ac01b4af374dcbb7368680b","2020-04-07T20:00:00Z",9,103,8783,8734,8734,33,0,11,318,46,364
"931",20200407,"NJ",44416,50558,NA,7017,NA,1651,NA,1540,NA,NA,"cc2566fc957facb8d98c9cdcaafbb8235297c5e6","2020-04-07T20:00:00Z",1232,NA,94974,94974,94974,34,229,0,2616,3326,5942
"932",20200407,"NM",686,21139,NA,48,NA,NA,NA,18,NA,133,"74b47d956a13a1210784d310796b4b88918963db","2020-04-07T20:00:00Z",12,NA,21825,21825,21825,35,0,0,2627,62,2689
"933",20200407,"NV",2087,16552,NA,282,NA,NA,NA,NA,NA,NA,"4f4321d0926b598d47e2a920f8709e23c2b89e00","2020-04-07T20:00:00Z",58,NA,18639,18639,18639,32,12,0,876,134,1010
"934",20200407,"NY",138863,201195,NA,17493,32083,4593,NA,NA,NA,14590,"15947b1c9ed54db71e224d5882c2e146b415b520","2020-04-07T20:00:00Z",5489,32083,340058,340058,340058,36,731,1880,11073,8174,19247
"935",20200407,"OH",4782,46056,NA,NA,1354,NA,417,NA,NA,NA,"ee1be244efee5b29b0b3adc051423a9eba46f3f0","2020-04-07T20:00:00Z",167,1354,50838,50838,50838,39,25,140,2128,332,2460
"936",20200407,"OK",1472,11821,NA,186,376,137,NA,NA,NA,612,"d926e29ea2057ff177bfe56ada2bf18ab9ecf780","2020-04-07T20:00:00Z",67,376,13293,13293,13293,40,16,36,10399,145,10544
"937",20200407,"OR",1181,21826,NA,NA,324,NA,NA,69,NA,NA,"0d8a30e0bd30ca1bb26872f15cb6fd8209687f3e","2020-04-07T20:00:00Z",33,324,23007,23007,23007,41,6,66,1157,49,1206
"938",20200407,"PA",14559,76719,NA,1665,NA,NA,NA,548,NA,NA,"5f6c0c5a75d956d960f06c3bff2b90956af04cf5","2020-04-07T20:00:00Z",240,NA,91278,91278,91278,42,78,0,5845,1579,7424
"939",20200407,"PR",573,3966,968,NA,NA,NA,NA,NA,NA,NA,"f55b55c315376b7c321d3701606e48d766c257c6","2020-04-07T20:00:00Z",23,NA,5507,4539,4539,72,2,0,534,60,594
"940",20200407,"RI",1230,9077,NA,123,NA,40,NA,26,NA,35,"813da9a6c780ba8fa0045b1f3cc2bd61c53fe95f","2020-04-07T20:00:00Z",30,NA,10307,10307,10307,44,3,0,1678,148,1826
"941",20200407,"SC",2417,21263,NA,NA,241,NA,NA,NA,NA,NA,"33337e94ee9a38b99bd37fda37b889f83199a988","2020-04-07T20:00:00Z",51,241,23680,23680,23680,45,7,0,4336,368,4704
"942",20200407,"SD",320,5948,2,NA,23,NA,NA,NA,NA,98,"23329c2017a92fb927ed537c0f932b129bff88ec","2020-04-07T20:00:00Z",6,23,6270,6268,6268,46,2,0,216,32,248
"943",20200407,"TN",4138,48736,NA,NA,408,NA,NA,NA,NA,466,"a34b15897c7e1082065823522dfae12982a71304","2020-04-07T20:00:00Z",72,408,52874,52874,52874,47,7,56,5188,336,5524
"944",20200407,"TX",8262,80387,NA,1252,NA,NA,NA,NA,NA,38,"cc8ef53ec9222fe4b8c2c5b0383d429085c6ad89","2020-04-07T20:00:00Z",154,NA,88649,88649,88649,48,14,0,2306,986,3292
"945",20200407,"UT",1738,32909,NA,NA,148,NA,NA,NA,NA,NA,"40a68524a0d0c4244c5e3929960fac5865a4b540","2020-04-07T20:00:00Z",13,148,34647,34647,34647,49,0,10,1190,63,1253
"946",20200407,"VA",3333,25312,NA,NA,563,NA,145,NA,108,NA,"2d8926f55fc5c4e769e6556a7e790b9c759e84c1","2020-04-07T20:00:00Z",63,563,28645,28645,28645,51,9,66,3669,455,4124
"947",20200407,"VI",43,222,20,NA,NA,NA,NA,NA,NA,36,"070fb1b83a9073c515f131b90847354c4f4f4732","2020-04-07T20:00:00Z",1,NA,285,265,265,78,0,0,0,0,0
"948",20200407,"VT",575,6554,NA,29,45,NA,NA,NA,NA,15,"44493af709005398cd2f24b0c1c9f7cf96707f38","2020-04-07T20:00:00Z",23,45,7129,7129,7129,50,0,0,464,32,496
"949",20200407,"WA",8815,83391,NA,641,NA,190,NA,NA,NA,NA,"5618c8fe1788590cac33ab33f5d6fdaf03d389fa","2020-04-07T20:00:00Z",393,NA,92206,92206,92206,53,15,0,0,336,336
"950",20200407,"WI",2578,28512,NA,NA,745,NA,200,NA,NA,NA,"e14827d359df3ec78ec54ec531ff175e68dd2bd4","2020-04-07T20:00:00Z",92,745,31090,31090,31090,55,15,77,1938,138,2076
"951",20200407,"WV",412,11647,NA,NA,NA,NA,NA,NA,NA,NA,"e06f7c7ba78a9622b82d063891c486527000e2ee","2020-04-07T20:00:00Z",4,NA,12059,12059,12059,54,0,0,2052,67,2119
"952",20200407,"WY",216,3789,NA,NA,33,NA,NA,NA,NA,62,"4351947d4b6974eb2fd1a41c558fe95a0fdb44b1","2020-04-07T20:00:00Z",0,33,4005,4005,4005,56,0,10,70,6,76
"953",20200406,"AK",191,6692,NA,NA,23,NA,NA,NA,NA,NA,"4d91929ba83b31e1dda30ca4a3c7d5716d39bfd7","2020-04-06T20:00:00Z",6,23,6883,6883,6883,2,0,3,593,6,599
"954",20200406,"AL",1968,12797,NA,NA,240,NA,NA,NA,NA,NA,"2efa35d0a2dc1dac3c6e12ced852169b719f14ea","2020-04-06T20:00:00Z",50,240,14765,14765,14765,1,5,9,1515,172,1687
"955",20200406,"AR",875,11970,NA,74,137,NA,NA,22,39,102,"681e0e05c357b930913804c3afe865bfa6f966d3","2020-04-06T20:00:00Z",16,137,12845,12845,12845,5,0,7,1558,45,1603
"956",20200406,"AS",0,3,2,NA,NA,NA,NA,NA,NA,NA,"3a37c6e7721e92a70327b4a50845f8a5579db152","2020-04-06T20:00:00Z",0,NA,5,3,3,60,0,0,0,0,0
"957",20200406,"AZ",2456,30078,NA,NA,NA,NA,NA,NA,NA,NA,"be6a1c823f4e57810c2c8d8f43de71e304b6a99c","2020-04-06T20:00:00Z",65,NA,32534,32534,32534,4,1,0,4937,187,5124
"958",20200406,"CA",14336,103095,15000,2509,NA,1085,NA,NA,NA,NA,"003211e59c1546fc081730f881ca621139601c35","2020-04-06T20:00:00Z",343,NA,132431,117431,117431,6,24,0,0,898,898
"959",20200406,"CO",4950,20823,NA,786,924,NA,NA,NA,NA,NA,"07597b3350c29f1005bf0fe74b9fea1cb8b5a429","2020-04-06T20:00:00Z",140,924,25773,25773,25773,8,14,49,1488,385,1873
"960",20200406,"CT",6906,19780,NA,1221,NA,NA,NA,NA,NA,NA,"331c624125331bd02f6656dbf3b17f66953734f1","2020-04-06T20:00:00Z",206,NA,26686,26686,26686,9,17,0,2185,1231,3416
"961",20200406,"DC",1097,6356,NA,NA,NA,NA,NA,NA,NA,287,"efc1c5bfd8563e9f8cb1bcb65c39a8636e42aee3","2020-04-06T20:00:00Z",24,NA,7453,7453,7453,11,2,0,520,99,619
"962",20200406,"DE",673,6321,NA,101,NA,NA,NA,NA,NA,71,"cf37ffc02efefef42ffb6e6b5529ba8356c3956f","2020-04-06T20:00:00Z",14,NA,6994,6994,6994,10,0,0,0,0,0
"963",20200406,"FL",13324,109950,1142,NA,1682,NA,NA,NA,NA,NA,"b4dbb2348dfa81a79ef605f252915ceeb3f37601","2020-04-06T20:00:00Z",236,1682,124416,123274,123274,12,18,110,8697,1173,9870
"964",20200406,"GA",7314,23960,NA,NA,1332,NA,NA,NA,NA,NA,"7fbdf8249948edf453caa4ac551cedfad4c6e5f9","2020-04-06T20:00:00Z",229,1332,31274,31274,31274,13,18,49,2775,667,3442
"965",20200406,"GU",113,505,NA,21,NA,2,NA,NA,NA,25,"a296a0a8bbbdce70dbd163dae499b32101a2505b","2020-04-06T20:00:00Z",4,NA,618,618,618,66,0,0,12,1,13
"966",20200406,"HI",371,13155,NA,NA,21,NA,6,NA,NA,85,"db9f4880719074c900ecffea275c5058b1b37074","2020-04-06T20:00:00Z",4,21,13526,13526,13526,15,0,2,551,20,571
"967",20200406,"IA",946,10653,NA,99,179,NA,NA,NA,NA,284,"c4c1a020fdf54b6521f263c532a4de89d1879baf","2020-04-06T20:00:00Z",25,179,11599,11599,11599,19,3,14,680,78,758
"968",20200406,"ID",1101,9894,NA,NA,77,NA,16,NA,NA,NA,"4e2f37a1fcf63752d912fbe47f4e932a367e3e5a","2020-04-06T20:00:00Z",10,77,10995,10995,10995,16,0,11,710,24,734
"969",20200406,"IL",12262,50680,NA,NA,NA,NA,NA,NA,NA,NA,"78c31ba234d1c85d4b9d41c49ea533da5c855ffe","2020-04-06T20:00:00Z",307,NA,62942,62942,62942,17,33,0,2953,1006,3959
"970",20200406,"IN",4944,21247,NA,NA,NA,924,NA,507,NA,NA,"5f4916e24243d76f03d2b658cf1f98ac188c64ca","2020-04-06T20:00:00Z",139,NA,26191,26191,26191,18,12,0,3006,533,3539
"971",20200406,"KS",845,8239,NA,NA,198,NA,NA,NA,NA,NA,"6c72b546a13e3baf08b9c625794792dd4473f1c0","2020-04-06T20:00:00Z",25,198,9084,9084,9084,20,3,15,763,98,861
"972",20200406,"KY",955,17812,NA,NA,NA,NA,NA,NA,NA,NA,"5f0f716526e1c3cc135a7162b6189a78ac324b8d","2020-04-06T20:00:00Z",45,NA,18767,18767,18767,21,5,0,2066,38,2104
"973",20200406,"LA",14867,54299,NA,1981,NA,NA,NA,552,NA,NA,"a3740cf7280c590ba011403d5c2e52c73f99920c","2020-04-06T20:00:00Z",512,NA,69166,69166,69166,22,35,0,6984,1857,8841
"974",20200406,"MA",13837,62592,NA,NA,1241,NA,NA,NA,NA,NA,"b0360aa8749c9625eb85af7f7e6be0b8f080a836","2020-04-06T20:00:00Z",260,1241,76429,76429,76429,25,29,96,3155,1337,4492
"975",20200406,"MD",4045,25572,NA,NA,1059,NA,NA,NA,NA,184,"51b860d3b0fe49a368c7ee7cb7ae0695859f0e5e","2020-04-06T20:00:00Z",91,1059,29617,29617,29617,24,24,123,844,436,1280
"976",20200406,"ME",499,6088,NA,NA,92,NA,NA,NA,NA,158,"9816f29c109d6d20a0d8cdb7ffbf5641bc7dcbab","2020-04-06T20:00:00Z",10,92,6587,6587,6587,23,0,6,0,29,29
"977",20200406,"MI",18850,43120,NA,NA,NA,NA,NA,NA,NA,56,"713b7f97c2e5c96c3c0080412dcda9b42df34214","2020-04-06T20:00:00Z",727,NA,61970,61970,61970,26,110,0,2789,1283,4072
"978",20200406,"MN",986,27142,NA,115,223,57,90,NA,NA,470,"f7a8cca1c4f511a0b8c331cd2f42b77b7fb4aaeb","2020-04-06T20:00:00Z",30,223,28128,28128,28128,27,1,21,1300,51,1351
"979",20200406,"MO",2722,27113,NA,439,NA,NA,NA,NA,NA,NA,"44876cfa047477bbea2f3887d3c012b5e9eb4d65","2020-04-06T20:00:00Z",39,NA,29835,29835,29835,29,5,0,2231,355,2586
"980",20200406,"MP",8,13,10,NA,NA,NA,NA,NA,NA,NA,"10213f297312a3f5d4b85bae5983c6d4dcd6fa21","2020-04-06T20:00:00Z",1,NA,31,21,21,69,0,0,0,0,0
"981",20200406,"MS",1738,18632,NA,NA,475,NA,NA,NA,NA,NA,"35f1e3f05db047b513ce0c520a71e84abd8c6c55","2020-04-06T20:00:00Z",51,475,20370,20370,20370,28,8,0,13052,100,13152
"982",20200406,"MT",299,6491,NA,NA,24,NA,NA,NA,NA,NA,"72195fdeabd9bc44e4c62aabc52ba24fe91f47a4","2020-04-06T20:00:00Z",6,24,6790,6790,6790,30,0,0,174,13,187
"983",20200406,"NC",2870,37856,NA,270,NA,NA,NA,NA,NA,NA,"79ed2fe9fc52cdceca198867d2f320bcc46ca495","2020-04-06T20:00:00Z",33,NA,40726,40726,40726,37,2,0,396,285,681
"984",20200406,"ND",225,6988,NA,19,32,NA,NA,NA,NA,74,"422a526ac91fe712af0eaa412a73536e980ac1a3","2020-04-06T20:00:00Z",3,32,7213,7213,7213,38,0,1,408,18,426
"985",20200406,"NE",409,6378,8,NA,NA,NA,NA,NA,NA,NA,"42cd4bf96826173bb3a5a6a5ca9df14cfde85a82","2020-04-06T20:00:00Z",8,NA,6795,6787,6787,31,0,0,820,46,866
"986",20200406,"NH",669,7701,101,NA,92,NA,NA,NA,NA,147,"70a71d29747afd73ec66cdfd0621fb6a958076cf","2020-04-06T20:00:00Z",9,92,8471,8370,8370,33,0,6,290,48,338
"987",20200406,"NJ",41090,47942,NA,6390,NA,NA,NA,1263,NA,NA,"461e1b1f9efb9d0e1190ba770527966f3ed83c11","2020-04-06T20:00:00Z",1003,NA,89032,89032,89032,34,86,0,3281,3585,6866
"988",20200406,"NM",624,18512,NA,45,NA,NA,NA,18,NA,130,"824b4f01e29d57652140bde152e631fd06ec36c4","2020-04-06T20:00:00Z",12,NA,19136,19136,19136,35,1,0,2227,81,2308
"989",20200406,"NV",1953,15676,NA,NA,NA,NA,NA,NA,NA,NA,"410ad8bd25fa26f8111b556ef20deba6ba990442","2020-04-06T20:00:00Z",46,NA,17629,17629,17629,32,0,0,681,117,798
"990",20200406,"NY",130689,190122,NA,16837,30203,4504,NA,NA,NA,13366,"2f8e8d32b6402d0d288a4d4db9946c5667b67f39","2020-04-06T20:00:00Z",4758,30203,320811,320811,320811,36,599,2111,9873,8658,18531
"991",20200406,"OH",4450,43928,NA,NA,1214,NA,371,NA,NA,NA,"379af1a5febc51ed345a6c4af033b8ed1030f0f0","2020-04-06T20:00:00Z",142,1214,48378,48378,48378,39,23,110,4215,407,4622
"992",20200406,"OK",1327,1422,NA,161,340,143,NA,NA,NA,522,"7a9dbe14460760a8d8319bae852504e6653d079d","2020-04-06T20:00:00Z",51,340,2749,2749,2749,40,5,10,21,75,96
"993",20200406,"OR",1132,20669,NA,NA,258,NA,NA,40,NA,NA,"25dd5121fb241ea32f05b2a662678e9ffae92040","2020-04-06T20:00:00Z",27,258,21801,21801,21801,41,0,0,1113,64,1177
"994",20200406,"PA",12980,70874,NA,NA,1145,NA,NA,533,NA,NA,"38e0af60db24c9b40a0274e3929826b66e991968","2020-04-06T20:00:00Z",162,1145,83854,83854,83854,42,12,73,4613,1470,6083
"995",20200406,"PR",513,3432,1000,NA,NA,NA,NA,NA,NA,NA,"4042cfb220e0d43e1dd965301a4b6d4e1a4f3f6c","2020-04-06T20:00:00Z",21,NA,4945,3945,3945,72,1,0,359,38,397
"996",20200406,"RI",1082,7399,NA,109,NA,37,NA,26,NA,35,"a993fa3bfcd36b6447689c11581adcac70279d6e","2020-04-06T20:00:00Z",27,NA,8481,8481,8481,44,2,0,1140,160,1300
"997",20200406,"SC",2049,16927,NA,NA,241,NA,NA,NA,NA,NA,"5fa94b2c78458efcbbcb8feb369f34826b4b2d30","2020-04-06T20:00:00Z",44,241,18976,18976,18976,45,0,0,0,0,0
"998",20200406,"SD",288,5732,0,NA,23,NA,NA,NA,NA,91,"9a0ab68c444290d9b4b67c8b517b1116526f1b39","2020-04-06T20:00:00Z",4,23,6020,6020,6020,46,2,1,379,48,427
"999",20200406,"TN",3802,43548,NA,NA,352,NA,NA,NA,NA,356,"6e99f97799daa32dfee6ab07755e268c0c2784aa","2020-04-06T20:00:00Z",65,352,47350,47350,47350,47,21,24,1881,169,2050
"1000",20200406,"TX",7276,78081,NA,1153,NA,NA,NA,NA,NA,38,"36fadabbdbb990c75e795f4b4d13f227963067fb","2020-04-06T20:00:00Z",140,NA,85357,85357,85357,48,13,0,13955,464,14419
"1001",20200406,"UT",1675,31719,NA,NA,138,NA,NA,NA,NA,NA,"a79f311e74664a5be49283b57cb86101e98e4f8c","2020-04-06T20:00:00Z",13,138,33394,33394,33394,49,5,14,2432,70,2502
"1002",20200406,"VA",2878,21643,NA,NA,497,NA,145,NA,108,NA,"c3515340a90eccc1b0b717381a669c8881457106","2020-04-06T20:00:00Z",54,497,24521,24521,24521,51,3,66,609,241,850
"1003",20200406,"VI",43,222,20,NA,NA,NA,NA,NA,NA,36,"9bd028c77055b8af275bac0ad96aef87f45c18fd","2020-04-06T20:00:00Z",1,NA,285,265,265,78,0,0,16,1,17
"1004",20200406,"VT",543,6090,NA,28,45,NA,NA,NA,NA,15,"65d25548f9cbaafc3f6e01dfcc9f8ff6993848ca","2020-04-06T20:00:00Z",23,45,6633,6633,6633,50,1,0,20,31,51
"1005",20200406,"WA",8479,83391,NA,638,NA,191,NA,NA,NA,NA,"3725a790e0c44d93addbf9b7745a269ae8147aca","2020-04-06T20:00:00Z",378,NA,91870,91870,91870,53,13,0,3064,343,3407
"1006",20200406,"WI",2440,26574,NA,NA,668,NA,186,NA,NA,NA,"7cd8b0660ae9551ba4a980f38fbd73aee870b871","2020-04-06T20:00:00Z",77,668,29014,29014,29014,55,9,44,1405,173,1578
"1007",20200406,"WV",345,9595,NA,NA,NA,NA,NA,NA,NA,NA,"f1298e935f9de41c83650aacb51c751c9be96333","2020-04-06T20:00:00Z",4,NA,9940,9940,9940,54,1,0,1081,21,1102
"1008",20200406,"WY",210,3719,NA,NA,23,NA,NA,NA,NA,52,"1a81a6ed6b83de32c30c32bfb094f26c70e62fd3","2020-04-06T20:00:00Z",0,23,3929,3929,3929,56,0,0,679,13,692
"1009",20200405,"AK",185,6099,NA,NA,20,NA,NA,NA,NA,NA,"661d7b0f627847a2dceb5d70d4e9260965031cc2","2020-04-05T20:00:00Z",6,20,6284,6284,6284,2,1,4,230,14,244
"1010",20200405,"AL",1796,11282,NA,NA,231,NA,NA,NA,NA,NA,"3f2c1f28926eeadf623d04aeb3716d29c5394d3c","2020-04-05T20:00:00Z",45,231,13078,13078,13078,1,2,19,2009,216,2225
"1011",20200405,"AR",830,10412,NA,67,130,NA,NA,27,39,97,"e494a9e5f54ebda0d5dc23e63da16773173c82cc","2020-04-05T20:00:00Z",16,130,11242,11242,11242,5,2,24,785,87,872
"1012",20200405,"AS",0,3,2,NA,NA,NA,NA,NA,NA,NA,"f2739209490825ae0877fda0f7d57622d07f62f3","2020-04-05T20:00:00Z",0,NA,5,3,3,60,0,0,0,0,0
"1013",20200405,"AZ",2269,25141,NA,NA,NA,NA,NA,NA,NA,NA,"2abd866096fc77008709c2702234d34a7462398b","2020-04-05T20:00:00Z",64,NA,27410,27410,27410,4,12,0,0,250,250
"1014",20200405,"CA",13438,103095,15000,2398,NA,1040,NA,NA,NA,NA,"b16da92c388833be7769869d9eaf221dabbd9b20","2020-04-05T20:00:00Z",319,NA,131533,116533,116533,6,43,0,1421,1412,2833
"1015",20200405,"CO",4565,19335,NA,783,875,NA,NA,NA,NA,NA,"31a247af3cbbcb8aa7a3f51aaa037f9e9bb5d84e","2020-04-05T20:00:00Z",126,875,23900,23900,23900,8,15,52,1437,392,1829
"1016",20200405,"CT",5675,17595,NA,1142,NA,NA,NA,NA,NA,NA,"1e92cd4c9468e9740d884cae46aa7fa1d8ad63e8","2020-04-05T20:00:00Z",189,NA,23270,23270,23270,9,24,0,842,399,1241
"1017",20200405,"DC",998,5836,NA,NA,NA,NA,NA,NA,NA,258,"492481c558e3cbdafc4289535e3c9f10603f6f0a","2020-04-05T20:00:00Z",22,NA,6834,6834,6834,11,1,0,300,96,396
"1018",20200405,"DE",673,6321,NA,101,NA,NA,NA,NA,NA,71,"4cfd22e6ea296fbca4f9ce0ea79a4b1b69a56eef","2020-04-05T20:00:00Z",14,NA,6994,6994,6994,10,0,0,447,80,527
"1019",20200405,"FL",12151,101253,1129,NA,1572,NA,NA,NA,NA,NA,"a93e5474b39c59e992996dd7ffc9f886446156c1","2020-04-05T20:00:00Z",218,1572,114533,113404,113404,12,27,110,10297,1040,11337
"1020",20200405,"GA",6647,21185,NA,NA,1283,NA,NA,NA,NA,NA,"d574a55e0cbdbd204007cc62e7d7da3ff1222c38","2020-04-05T20:00:00Z",211,1283,27832,27832,27832,13,10,44,1051,487,1538
"1021",20200405,"GU",112,493,NA,21,NA,2,NA,NA,NA,23,"657171a222a700475248cd3665c3656d81c40e13","2020-04-05T20:00:00Z",4,NA,605,605,605,66,0,0,21,19,40
"1022",20200405,"HI",351,12604,NA,NA,19,NA,6,NA,NA,82,"77397e6e6161c484fd9fd351a7a97f2504e3ef04","2020-04-05T20:00:00Z",4,19,12955,12955,12955,15,1,1,645,32,677
"1023",20200405,"IA",868,9973,NA,91,165,NA,NA,NA,NA,188,"ddab7f4fb076f0753905ad90cf58ce0af0c83e02","2020-04-05T20:00:00Z",22,165,10841,10841,10841,19,8,12,519,82,601
"1024",20200405,"ID",1077,9184,NA,NA,66,NA,11,NA,NA,NA,"181bae20b5e5d41e5e68a4ac2fbbec0ead002f93","2020-04-05T20:00:00Z",10,66,10261,10261,10261,16,0,4,1327,64,1391
"1025",20200405,"IL",11256,47727,NA,NA,NA,NA,NA,NA,NA,NA,"d76333be7d0f922df9b8b422717d922c15da272f","2020-04-05T20:00:00Z",274,NA,58983,58983,58983,17,31,0,4503,899,5402
"1026",20200405,"IN",4411,18241,NA,NA,NA,NA,NA,NA,NA,NA,"f93680f2440d0a80612808fcc143041ba9cb2558","2020-04-05T20:00:00Z",127,NA,22652,22652,22652,18,11,0,2394,458,2852
"1027",20200405,"KS",747,7476,NA,NA,183,NA,NA,NA,NA,NA,"dae86135f02c394b72b0ae420bb652e62b1475ff","2020-04-05T20:00:00Z",22,183,8223,8223,8223,20,1,11,596,49,645
"1028",20200405,"KY",917,15746,NA,NA,NA,NA,NA,NA,NA,NA,"b04b342a420aa4f3ebcda1e367731dcabb035fe9","2020-04-05T20:00:00Z",40,NA,16663,16663,16663,21,3,0,1005,86,1091
"1029",20200405,"LA",13010,47315,NA,1803,NA,NA,NA,561,NA,NA,"54b0aaaa06fce89fecccf2fd6ce9501b9190d7b5","2020-04-05T20:00:00Z",477,NA,60325,60325,60325,22,68,0,1313,514,1827
"1030",20200405,"MA",12500,59437,NA,NA,1145,NA,NA,NA,NA,NA,"d25b1917417ab57d0ef9e85c85c1a5cca2cc7e36","2020-04-05T20:00:00Z",231,1145,71937,71937,71937,25,15,77,2373,764,3137
"1031",20200405,"MD",3609,24728,NA,NA,936,NA,NA,NA,NA,159,"cac549d0b74daccf3ab34404fc5dd3812b44bbff","2020-04-05T20:00:00Z",67,936,28337,28337,28337,24,14,115,2243,484,2727
"1032",20200405,"ME",470,6088,NA,NA,86,NA,NA,NA,NA,156,"251d971acb2a0763de6451631e1f79284d54e187","2020-04-05T20:00:00Z",10,86,6558,6558,6558,23,0,3,0,14,14
"1033",20200405,"MI",17567,40331,NA,NA,NA,NA,NA,NA,NA,56,"4f43122e0d1c106e7db4947613520694e2e4514c","2020-04-05T20:00:00Z",617,NA,57898,57898,57898,26,77,0,2926,1172,4098
"1034",20200405,"MN",935,25842,NA,106,202,48,77,NA,NA,451,"c7075ad182d0178bcc22aab78d7cd3495cca7d7d","2020-04-05T20:00:00Z",29,202,26777,26777,26777,27,5,22,1284,70,1354
"1035",20200405,"MO",2367,24882,NA,424,NA,NA,NA,NA,NA,NA,"434ac4b9d0cbd2143af60703aa3aedc944b8ed77","2020-04-05T20:00:00Z",34,NA,27249,27249,27249,29,10,0,2268,76,2344
"1036",20200405,"MP",8,13,10,NA,NA,NA,NA,NA,NA,NA,"2dfb8a2e3962fb5328cb829dac324abbea5ea5c2","2020-04-05T20:00:00Z",1,NA,31,21,21,69,0,0,0,0,0
"1037",20200405,"MS",1638,5580,NA,NA,475,NA,NA,NA,NA,NA,"7e075b052224457cec693d4aa2f7c8c5b76962d3","2020-04-05T20:00:00Z",43,475,7218,7218,7218,28,8,39,447,183,630
"1038",20200405,"MT",286,6317,NA,NA,24,NA,NA,NA,NA,NA,"df75d2ad9e7baae0b40fddec219b81def7584a74","2020-04-05T20:00:00Z",6,24,6603,6603,6603,30,1,0,405,21,426
"1039",20200405,"NC",2585,37460,NA,261,NA,NA,NA,NA,NA,NA,"4d5b54fff38c79c5d34358a4fc1ecd201692b759","2020-04-05T20:00:00Z",31,NA,40045,40045,40045,37,7,0,1089,183,1272
"1040",20200405,"ND",207,6580,NA,20,31,NA,NA,NA,NA,63,"6a4b61d1260f55fee4335342942c41cf34e82bab","2020-04-05T20:00:00Z",3,31,6787,6787,6787,38,0,1,559,21,580
"1041",20200405,"NE",363,5558,12,NA,NA,NA,NA,NA,NA,NA,"6249d274e5c51fbff387c37b8d9ef435910c9a47","2020-04-05T20:00:00Z",8,NA,5933,5921,5921,31,2,0,500,42,542
"1042",20200405,"NH",621,7411,93,NA,86,NA,NA,NA,NA,146,"d5c04e13103086262e57257b6f168cab23603a0b","2020-04-05T20:00:00Z",9,86,8125,8032,8032,33,2,6,446,81,527
"1043",20200405,"NJ",37505,44661,NA,4000,NA,NA,NA,NA,NA,NA,"d2be91c6279c39ae389e9016e723b22d0f8ef25c","2020-04-05T20:00:00Z",917,NA,82166,82166,82166,34,71,0,3429,3381,6810
"1044",20200405,"NM",543,16285,NA,37,NA,NA,NA,18,NA,54,"63f30ca9eb0ba350762c320c91a6b9c3ee657611","2020-04-05T20:00:00Z",11,NA,16828,16828,16828,35,1,0,1148,48,1196
"1045",20200405,"NV",1836,14995,NA,NA,NA,NA,NA,NA,NA,NA,"eed461ec57cf1fb0231459c7950a45d60e402fc7","2020-04-05T20:00:00Z",46,NA,16831,16831,16831,32,0,0,574,94,668
"1046",20200405,"NY",122031,180249,NA,16479,28092,4376,NA,NA,NA,12187,"58a99b83c7368e224acff5ea100e3692a0b8fa75","2020-04-05T20:00:00Z",4159,28092,302280,302280,302280,36,594,1709,10332,8327,18659
"1047",20200405,"OH",4043,39713,NA,NA,1104,NA,346,NA,NA,NA,"e5ae03b405f85f1d28b2ebb497d115720b0a273c","2020-04-05T20:00:00Z",119,1104,43756,43756,43756,39,17,98,1581,304,1885
"1048",20200405,"OK",1252,1401,NA,NA,330,NA,NA,NA,NA,NA,"6533cee27cd3fff7678c17b003d7f79151d505c6","2020-04-05T20:00:00Z",46,330,2653,2653,2653,40,4,14,39,93,132
"1049",20200405,"OR",1068,19556,NA,NA,258,NA,NA,40,NA,NA,"895c3bb4369358143348dcc34246a7c7fc41e04b","2020-04-05T20:00:00Z",27,258,20624,20624,20624,41,1,19,3021,69,3090
"1050",20200405,"PA",11510,66261,NA,NA,1072,NA,NA,NA,NA,NA,"37345694c2105b11def51fd454c4a6757b9e3189","2020-04-05T20:00:00Z",150,1072,77771,77771,77771,42,14,68,6248,1493,7741
"1051",20200405,"PR",475,3073,1039,NA,NA,NA,NA,NA,NA,NA,"1573ba924ae71c4ae8290b22456399487d9a034b","2020-04-05T20:00:00Z",20,NA,4587,3548,3548,72,2,0,468,23,491
"1052",20200405,"RI",922,6259,NA,103,NA,33,NA,6,NA,35,"f8c3f68699896ac066c1b424d770f323fa222ba5","2020-04-05T20:00:00Z",25,NA,7181,7181,7181,44,8,0,675,116,791
"1053",20200405,"SC",2049,16927,NA,NA,241,NA,NA,NA,NA,NA,"ccdff6113258b5f27c5731a18b0b0b1a1839e358","2020-04-05T20:00:00Z",44,241,18976,18976,18976,45,4,0,530,132,662
"1054",20200405,"SD",240,5353,NA,NA,22,NA,NA,NA,NA,84,"95a0098886125c0b34f0de459993844962e75bd4","2020-04-05T20:00:00Z",2,22,5593,5593,5593,46,0,3,341,28,369
"1055",20200405,"TN",3633,41667,NA,NA,328,NA,NA,NA,NA,295,"5a155ea45dcb7ba75630d696556e3c0ed525d402","2020-04-05T20:00:00Z",44,328,45300,45300,45300,47,1,17,3597,312,3909
"1056",20200405,"TX",6812,64126,NA,827,NA,NA,NA,NA,NA,38,"12359c732574d27b68f27360a5f1a8abef4bbcdc","2020-04-05T20:00:00Z",127,NA,70938,70938,70938,48,22,0,6485,702,7187
"1057",20200405,"UT",1605,29287,NA,NA,124,NA,NA,NA,NA,NA,"83dbc778efc9acf771c3b3a3c24fdb95eccd9723","2020-04-05T20:00:00Z",8,124,30892,30892,30892,49,0,7,2672,177,2849
"1058",20200405,"VA",2637,21034,NA,NA,431,NA,145,NA,108,NA,"43347a01365145c45a8187e871977110df8e3d22","2020-04-05T20:00:00Z",51,431,23671,23671,23671,51,-1,41,1889,230,2119
"1059",20200405,"VI",42,206,18,NA,NA,NA,NA,NA,NA,34,"f7efcce917045a165880162c7ec816f33b5f318f","2020-04-05T20:00:00Z",1,NA,266,248,248,78,1,0,22,2,24
"1060",20200405,"VT",512,6070,NA,29,45,NA,NA,NA,NA,15,"e3035a258b92b434b2fe2e996f2935e60f287645","2020-04-05T20:00:00Z",22,45,6582,6582,6582,50,2,0,687,51,738
"1061",20200405,"WA",8136,80327,NA,581,NA,178,NA,NA,NA,NA,"0358d1c58d433546f5e8e0cca30af63a5109ae1f","2020-04-05T20:00:00Z",365,NA,88463,88463,88463,53,20,0,4694,389,5083
"1062",20200405,"WI",2267,25169,NA,NA,624,NA,175,NA,NA,NA,"e9ae6b075ad9a1a7866f76c9aeddda94fa67311d","2020-04-05T20:00:00Z",68,624,27436,27436,27436,55,12,36,1310,155,1465
"1063",20200405,"WV",324,8514,NA,NA,NA,NA,NA,NA,NA,NA,"7c658b660d0796f3403a84ab40c4f1fcb02d9eed","2020-04-05T20:00:00Z",3,NA,8838,8838,8838,54,1,0,1110,42,1152
"1064",20200405,"WY",197,3040,NA,NA,23,NA,NA,NA,NA,50,"521559b492dc45d4a16042c5a00a0be69fb8f96d","2020-04-05T20:00:00Z",0,23,3237,3237,3237,56,0,0,95,10,105
"1065",20200404,"AK",171,5869,NA,NA,16,NA,NA,NA,NA,NA,"10a0cf7d2d88dce27674dda730950a2661caa4b0","2020-04-04T20:00:00Z",5,16,6040,6040,6040,2,2,1,10,14,24
"1066",20200404,"AL",1580,9273,NA,NA,212,NA,NA,NA,NA,NA,"963802ea3a71c8b5d74fec7b17f1fb98e9547168","2020-04-04T20:00:00Z",43,212,10853,10853,10853,1,8,212,1086,148,1234
"1067",20200404,"AR",743,9627,NA,72,106,NA,NA,23,39,79,"e8ac44e2e243e6a3a4c4a59290ba4e5a35dcf203","2020-04-04T20:00:00Z",14,106,10370,10370,10370,5,2,1,632,39,671
"1068",20200404,"AS",0,3,2,NA,NA,NA,NA,NA,NA,NA,"b7b36903e210f356b4ff21b4a78c7049e6249b31","2020-04-04T20:00:00Z",0,NA,5,3,3,60,0,0,0,0,0
"1069",20200404,"AZ",2019,25141,NA,NA,NA,NA,NA,NA,NA,NA,"92d121ef592004f30d2027f8394c7d5b2003e425","2020-04-04T20:00:00Z",52,NA,27160,27160,27160,4,11,0,2237,250,2487
"1070",20200404,"CA",12026,101674,13000,2300,NA,1008,NA,NA,NA,NA,"4a3edf69851dfa895e0e69e83fb57f41cd4c4a9f","2020-04-04T20:00:00Z",276,NA,126700,113700,113700,6,39,0,77075,1325,78400
"1071",20200404,"CO",4173,17898,NA,777,823,NA,NA,NA,NA,NA,"864b034ba2cfbf7b77a5f90eafe2f95fc245b758","2020-04-04T20:00:00Z",111,823,22071,22071,22071,8,14,113,1215,445,1660
"1072",20200404,"CT",5276,16753,NA,1033,NA,NA,NA,NA,NA,NA,"6d7626dbd793cd794dc73f07b50278a1e51d9890","2020-04-04T20:00:00Z",165,NA,22029,22029,22029,9,34,0,1652,362,2014
"1073",20200404,"DC",902,5536,NA,NA,NA,NA,NA,NA,NA,235,"afaf508bebd20ff5f9dd84d3011a087369a8c2b7","2020-04-04T20:00:00Z",21,NA,6438,6438,6438,11,6,0,709,145,854
"1074",20200404,"DE",593,5874,NA,95,NA,NA,NA,NA,NA,71,"cc40395c305b43fd73a2e32bd1110b86b47e826b","2020-04-04T20:00:00Z",14,NA,6467,6467,6467,10,0,0,879,143,1022
"1075",20200404,"FL",11111,90956,1281,NA,1462,NA,NA,NA,NA,NA,"1f993ebcc7b85b2f8281d911efc5e3c78dda42e8","2020-04-04T20:00:00Z",191,1462,103348,102067,102067,12,28,175,8819,1526,10345
"1076",20200404,"GA",6160,20134,NA,NA,1239,NA,NA,NA,NA,NA,"18b3449ec335447f642a8016122da3ebf65fd362","2020-04-04T20:00:00Z",201,1239,26294,26294,26294,13,17,81,700,329,1029
"1077",20200404,"GU",93,472,NA,20,NA,2,NA,NA,NA,20,"8f8d2f5f8c4dd7332e8e2fc885fd5dbedfdcd645","2020-04-04T20:00:00Z",4,NA,565,565,565,66,0,0,13,9,22
"1078",20200404,"HI",319,11959,NA,NA,18,NA,6,NA,NA,78,"85b971fb96772bd9d5372009c96c64990057f4d5","2020-04-04T20:00:00Z",3,18,12278,12278,12278,15,1,3,1753,34,1787
"1079",20200404,"IA",786,9454,NA,85,153,NA,NA,NA,NA,188,"c2f4cc268e2b747cc59744241bf64e46a2935131","2020-04-04T20:00:00Z",14,153,10240,10240,10240,19,3,15,700,87,787
"1080",20200404,"ID",1013,7857,NA,NA,62,NA,8,NA,NA,NA,"ca14157f2fde1aec45469a4435b5ecac0c291f64","2020-04-04T20:00:00Z",10,62,8870,8870,8870,16,1,6,803,122,925
"1081",20200404,"IL",10357,43224,NA,NA,NA,NA,NA,NA,NA,NA,"3d772552de2938982868c2c2796802165dc593e4","2020-04-04T20:00:00Z",243,NA,53581,53581,53581,17,33,0,4080,1453,5533
"1082",20200404,"IN",3953,15847,NA,NA,NA,NA,NA,NA,NA,NA,"23917dae4d93280471686b45f6bc5b09a7c99781","2020-04-04T20:00:00Z",116,NA,19800,19800,19800,18,14,0,1449,516,1965
"1083",20200404,"KS",698,6880,NA,NA,172,NA,NA,NA,NA,NA,"1bd06ebda4fa4c851c7f1b7653fd751cdcbefeda","2020-04-04T20:00:00Z",21,172,7578,7578,7578,20,4,21,426,78,504
"1084",20200404,"KY",831,14741,NA,NA,NA,NA,NA,NA,NA,NA,"7303bebeca09a7039fc2cc1818e6edc0d80d62ed","2020-04-04T20:00:00Z",37,NA,15572,15572,15572,21,6,0,2707,61,2768
"1085",20200404,"LA",12496,46002,NA,1726,NA,NA,NA,571,NA,NA,"006a93457fa79372c9c83099dfe37f9b61ab0762","2020-04-04T20:00:00Z",409,NA,58498,58498,58498,22,39,0,2654,2199,4853
"1086",20200404,"MA",11736,57064,NA,NA,1068,NA,NA,NA,NA,NA,"9a85464df1b687aed82070c167ec82e4e12d66cc","2020-04-04T20:00:00Z",216,1068,68800,68800,68800,25,24,102,4504,1334,5838
"1087",20200404,"MD",3125,22485,NA,NA,821,NA,NA,NA,NA,159,"3e558ddd96779d7dcb9e3081fabf4cbf5ab62a55","2020-04-04T20:00:00Z",53,821,25610,25610,25610,24,11,157,1553,367,1920
"1088",20200404,"ME",456,6088,NA,NA,83,NA,NA,NA,NA,140,"02fc81a3dbc1ac48ca9090a7e206593d987d39f8","2020-04-04T20:00:00Z",10,83,6544,6544,6544,23,1,8,0,24,24
"1089",20200404,"MI",16395,37405,NA,NA,NA,NA,NA,NA,NA,56,"73be3a717edb05eb45181c6e0debaf9453593f29","2020-04-04T20:00:00Z",540,NA,53800,53800,53800,26,61,0,3735,1143,4878
"1090",20200404,"MN",865,24558,NA,95,180,42,69,NA,NA,440,"47151f187a4d69935f42b9cd12a42cfe7fe3f4db","2020-04-04T20:00:00Z",24,180,25423,25423,25423,27,2,24,1120,76,1196
"1091",20200404,"MO",2291,22614,NA,413,NA,NA,NA,NA,NA,NA,"1de6d799527bb662b4f811d06062ae19798cf39c","2020-04-04T20:00:00Z",24,NA,24905,24905,24905,29,5,0,3257,178,3435
"1092",20200404,"MP",8,13,10,NA,NA,NA,NA,NA,NA,NA,"c8062971344da9c2966da3616c662302e33beb22","2020-04-04T20:00:00Z",1,NA,31,21,21,69,0,0,0,0,0
"1093",20200404,"MS",1455,5133,NA,NA,436,NA,NA,NA,NA,NA,"e6b7dcd404a9b670553d7a858afe76f239b27d8f","2020-04-04T20:00:00Z",35,436,6588,6588,6588,28,6,16,380,97,477
"1094",20200404,"MT",265,5912,NA,NA,24,NA,NA,NA,NA,NA,"4d03e9b5ae1b42666266fddb59c97097f2f184cb","2020-04-04T20:00:00Z",5,24,6177,6177,6177,30,0,0,579,22,601
"1095",20200404,"NC",2402,36371,NA,271,NA,NA,NA,NA,NA,NA,"d376f1f555fd1f8eb9e9fb805c2a44b9c5879598","2020-04-04T20:00:00Z",24,NA,38773,38773,38773,37,5,0,6866,309,7175
"1096",20200404,"ND",186,6021,NA,NA,30,NA,NA,NA,NA,63,"c036a7908926a69e9d6abbabfbccb51600d6ef08","2020-04-04T20:00:00Z",3,30,6207,6207,6207,38,0,1,396,13,409
"1097",20200404,"NE",321,5058,10,NA,NA,NA,NA,NA,NA,NA,"7c8f0e5925f2794be243d16c543031154fca7f32","2020-04-04T20:00:00Z",6,NA,5389,5379,5379,31,0,0,571,42,613
"1098",20200404,"NH",540,6965,94,NA,80,NA,NA,NA,NA,144,"6a22cd2922422f2362f9ae8e0328e75a92305659","2020-04-04T20:00:00Z",7,80,7599,7505,7505,33,2,7,390,61,451
"1099",20200404,"NJ",34124,41232,NA,4000,NA,NA,NA,NA,NA,NA,"9403b0c89cae5f262e33a28b73e52734aa654d49","2020-04-04T20:00:00Z",846,NA,75356,75356,75356,34,200,0,3624,4229,7853
"1100",20200404,"NM",495,15137,NA,41,NA,NA,NA,18,NA,26,"2b94d66d25c501a9c947be0bd794488ff4d04abf","2020-04-04T20:00:00Z",10,NA,15632,15632,15632,35,3,0,762,92,854
"1101",20200404,"NV",1742,14421,NA,NA,NA,NA,NA,NA,NA,NA,"34a77b0dddf91a2c2c4ca6b188c57b511c9dcafe","2020-04-04T20:00:00Z",46,NA,16163,16163,16163,32,3,0,1403,228,1631
"1102",20200404,"NY",113704,169917,NA,15905,26383,4126,NA,NA,NA,10478,"792799b4ed7e06f7995dec04e454a37ec5edb0c0","2020-04-04T20:00:00Z",3565,26383,283621,283621,283621,36,630,2687,12260,10841,23101
"1103",20200404,"OH",3739,38132,NA,NA,1006,NA,326,NA,NA,NA,"f317223856900d8dd2a3ec361b5b3edc776a2cb5","2020-04-04T20:00:00Z",102,1006,41871,41871,41871,39,11,111,3069,427,3496
"1104",20200404,"OK",1159,1362,NA,NA,316,NA,NA,NA,NA,NA,"c009b48e99f48b5124644ba88479304de7eab155","2020-04-04T20:00:00Z",42,316,2521,2521,2521,40,4,27,47,171,218
"1105",20200404,"OR",999,16535,NA,NA,239,NA,NA,38,NA,NA,"0d38ab0fd06af64c96daa9315d986181158b3ded","2020-04-04T20:00:00Z",26,239,17534,17534,17534,41,4,35,0,100,100
"1106",20200404,"PA",10017,60013,NA,NA,1004,NA,NA,NA,NA,NA,"81ba5a1abe612a1fd95cedf0baeb4e7b9e446694","2020-04-04T20:00:00Z",136,1004,70030,70030,70030,42,34,152,6318,1597,7915
"1107",20200404,"PR",452,2605,1129,NA,NA,NA,NA,NA,NA,NA,"6df35c474e40400cf188b8e94850f9c371d1a88d","2020-04-04T20:00:00Z",18,NA,4186,3057,3057,72,3,0,556,74,630
"1108",20200404,"RI",806,5584,NA,93,NA,31,NA,6,NA,35,"a77810637e6c6db9721eaa87537095b5e2a2d791","2020-04-04T20:00:00Z",17,NA,6390,6390,6390,44,3,0,727,97,824
"1109",20200404,"SC",1917,16397,NA,NA,241,NA,NA,NA,NA,NA,"b0fb0beac6f2e84cb2ef41f3a01abcf88df02ad7","2020-04-04T20:00:00Z",40,241,18314,18314,18314,45,9,0,10956,363,11319
"1110",20200404,"SD",212,5012,1,NA,19,NA,NA,NA,NA,76,"f4760a4f2592a21960fa3a320e23904bd1425fe8","2020-04-04T20:00:00Z",2,19,5225,5224,5224,46,0,2,419,25,444
"1111",20200404,"TN",3321,38070,NA,NA,311,NA,NA,NA,NA,416,"9a4555b4ea0d32017009e836958512d05cc69e17","2020-04-04T20:00:00Z",43,311,41391,41391,41391,47,6,18,3298,254,3552
"1112",20200404,"TX",6110,57641,NA,196,NA,NA,NA,NA,NA,38,"48b48de447638a10ca85269ada674586a07c6519","2020-04-04T20:00:00Z",105,NA,63751,63751,63751,48,15,0,7207,780,7987
"1113",20200404,"UT",1428,26615,NA,NA,117,NA,NA,NA,NA,NA,"7488de1606fb85c66768cd77a8f5b6742325f57a","2020-04-04T20:00:00Z",8,117,28043,28043,28043,49,1,11,3613,182,3795
"1114",20200404,"VA",2407,19145,NA,NA,390,NA,145,NA,108,NA,"44eaf300e7ae68bb5f75324ab03882f20c0c5c6e","2020-04-04T20:00:00Z",52,390,21552,21552,21552,51,6,78,2152,395,2547
"1115",20200404,"VI",40,184,42,NA,NA,NA,NA,NA,NA,34,"1f30a0f58472c56075f6ceef3a03b932f858d499","2020-04-04T20:00:00Z",NA,NA,266,224,224,78,0,0,30,2,32
"1116",20200404,"VT",461,5383,NA,29,45,NA,NA,NA,NA,15,"360482bd60b638d752907eee73f063bb7c1298f4","2020-04-04T20:00:00Z",20,45,5844,5844,5844,50,3,0,544,72,616
"1117",20200404,"WA",7747,75633,NA,574,NA,174,NA,NA,NA,NA,"bd1d66b0a7c4329fe595c3c2f1ae11895a4a93e7","2020-04-04T20:00:00Z",345,NA,83380,83380,83380,53,20,0,2800,368,3168
"1118",20200404,"WI",2112,23859,NA,NA,588,NA,NA,NA,NA,NA,"53b4a4b3e0ef24896a5d026a80ca4246d6b4f550","2020-04-04T20:00:00Z",56,588,25971,25971,25971,55,19,101,1482,200,1682
"1119",20200404,"WV",282,7404,NA,NA,NA,NA,NA,NA,NA,NA,"d80af5ae8b58e07f6c9ff6bc393c3d2280e539aa","2020-04-04T20:00:00Z",2,NA,7686,7686,7686,54,0,0,1274,45,1319
"1120",20200404,"WY",187,2945,NA,NA,23,NA,NA,NA,NA,49,"415d73e6e2ac994fdc01d676595fb7ac5b666b1f","2020-04-04T20:00:00Z",0,23,3132,3132,3132,56,0,2,241,25,266
"1121",20200403,"AK",157,5859,NA,NA,15,NA,NA,NA,NA,NA,"192f851a8f9b68576ed308814322d1333b538699","2020-04-03T20:00:00Z",3,15,6016,6016,6016,2,0,6,980,14,994
"1122",20200403,"AL",1432,8187,NA,NA,NA,NA,NA,NA,NA,NA,"2321b8fce440dd33ac0feef0e923113ffffbf603","2020-04-03T20:00:00Z",35,NA,9619,9619,9619,1,3,0,684,199,883
"1123",20200403,"AR",704,8995,NA,71,105,NA,NA,26,39,60,"a129a75b81c57893907409886ae725cdb64e4b2c","2020-04-03T20:00:00Z",12,105,9699,9699,9699,5,0,5,1115,61,1176
"1124",20200403,"AS",0,3,2,NA,NA,NA,NA,NA,NA,NA,"927c34f4a05fc499874a1e27f00bc9b1f4fe7fe3","2020-04-03T20:00:00Z",0,NA,5,3,3,60,0,0,0,0,0
"1125",20200403,"AZ",1769,22904,NA,NA,NA,NA,NA,NA,NA,NA,"2034453edd5b83833266bd4b71eb40738571fb8e","2020-04-03T20:00:00Z",41,NA,24673,24673,24673,4,9,0,1793,171,1964
"1126",20200403,"CA",10701,24599,59500,2188,NA,901,NA,NA,NA,NA,"67f105bfa3690e07b85e362a0c6c43aa796aba45","2020-04-03T20:00:00Z",237,NA,94800,35300,35300,6,34,0,790,1510,2300
"1127",20200403,"CO",3728,16683,NA,739,710,NA,NA,NA,NA,NA,"7fabb770d24cefb51234aade04a64761abbb9ebd","2020-04-03T20:00:00Z",97,710,20411,20411,20411,8,17,90,1380,386,1766
"1128",20200403,"CT",4914,15101,NA,909,NA,NA,NA,NA,NA,NA,"1951d0ca03e6ab2d9bffc4856b060402c69ea7e6","2020-04-03T20:00:00Z",131,NA,20015,20015,20015,9,19,0,625,1090,1715
"1129",20200403,"DC",757,4827,NA,NA,NA,NA,NA,NA,NA,206,"fbf3f83530b301cee1d7dc47fd0719b435edc428","2020-04-03T20:00:00Z",15,NA,5584,5584,5584,11,3,0,410,104,514
"1130",20200403,"DE",450,4995,NA,63,NA,NA,NA,NA,NA,71,"b840b5921e6e7a1adc67cdefd1c22f4e046d277a","2020-04-03T20:00:00Z",14,NA,5445,5445,5445,10,2,0,429,57,486
"1131",20200403,"FL",9585,82137,1225,NA,1287,NA,NA,NA,NA,NA,"b57074c59ada3265eae0eff0d8740ad16a99e8cd","2020-04-03T20:00:00Z",163,1287,92947,91722,91722,12,35,164,12851,1575,14426
"1132",20200403,"GA",5831,19434,NA,NA,1158,NA,NA,NA,NA,NA,"c82f88637af7d0c85b2360390bb2386b0da43065","2020-04-03T20:00:00Z",184,1158,25265,25265,25265,13,21,102,1825,483,2308
"1133",20200403,"GU",84,459,NA,19,NA,2,NA,NA,NA,14,"043fa723d9c8baf2770180cf58a90543d8ada0b2","2020-04-03T20:00:00Z",4,NA,543,543,543,66,1,0,17,2,19
"1134",20200403,"HI",285,10206,NA,NA,15,NA,6,NA,NA,72,"1c81c643bccf41f562ee8a0b1565f639a71e5cb7","2020-04-03T20:00:00Z",2,15,10491,10491,10491,15,1,0,0,27,27
"1135",20200403,"IA",699,8754,NA,80,138,NA,NA,NA,NA,188,"feb894b5b255cf3a6496c9856b448a6307f9b022","2020-04-03T20:00:00Z",11,138,9453,9453,9453,19,0,18,700,85,785
"1136",20200403,"ID",891,7054,NA,NA,56,NA,7,NA,NA,NA,"a3f3c21c0ca004354535ce3e1e5108d313bd5a30","2020-04-03T20:00:00Z",9,56,7945,7945,7945,16,0,7,441,222,663
"1137",20200403,"IL",8904,39144,NA,NA,NA,NA,NA,NA,NA,NA,"5393eb554824524a4a63bbec9c795869c7869414","2020-04-03T20:00:00Z",210,NA,48048,48048,48048,17,53,0,3183,1209,4392
"1138",20200403,"IN",3437,14398,NA,NA,NA,NA,NA,NA,NA,NA,"b6a582ed478dfba401e4a56efe6e9e4a1b532d04","2020-04-03T20:00:00Z",102,NA,17835,17835,17835,18,24,0,1152,398,1550
"1139",20200403,"KS",620,6454,NA,NA,151,NA,NA,NA,NA,NA,"423f188ae5bf45319e336f75b49a3708bdbc8494","2020-04-03T20:00:00Z",17,151,7074,7074,7074,20,4,13,395,68,463
"1140",20200403,"KY",770,12034,NA,NA,NA,NA,NA,NA,NA,NA,"b7ec08543b9b2324d60694f6721979dc00c54543","2020-04-03T20:00:00Z",31,NA,12804,12804,12804,21,11,0,4814,90,4904
"1141",20200403,"LA",10297,43348,NA,1707,NA,NA,NA,535,NA,NA,"67272131caf7c308a8c118046b0f4720f48b292a","2020-04-03T20:00:00Z",370,NA,53645,53645,53645,22,60,0,1412,1147,2559
"1142",20200403,"MA",10402,52560,NA,NA,966,NA,NA,NA,NA,NA,"b7bee14b9475ba25ad0b28497d483cec03221230","2020-04-03T20:00:00Z",192,966,62962,62962,62962,25,38,153,4918,1436,6354
"1143",20200403,"MD",2758,20932,NA,NA,664,NA,NA,NA,NA,159,"748f7091af15d9ca085a92ba09b7390f763b6eb5","2020-04-03T20:00:00Z",42,664,23690,23690,23690,24,6,82,2042,427,2469
"1144",20200403,"ME",432,6088,NA,NA,75,NA,NA,NA,NA,113,"4b5209b1b8259d319beb467d9b74d759206853f8","2020-04-03T20:00:00Z",9,75,6520,6520,6520,23,2,7,0,56,56
"1145",20200403,"MI",15252,33670,NA,NA,NA,NA,NA,NA,NA,56,"6d7b1e9deef1dc89156d45d3791fd07684b2b368","2020-04-03T20:00:00Z",479,NA,48922,48922,48922,26,62,0,3302,1135,4437
"1146",20200403,"MN",789,23438,NA,86,156,40,40,NA,NA,NA,"6c45e5c1cc14d97b2d8c49fc1e64ae7a7ebb3861","2020-04-03T20:00:00Z",22,156,24227,24227,24227,27,4,18,1786,47,1833
"1147",20200403,"MO",2113,19357,NA,NA,NA,NA,NA,NA,NA,NA,"4b8f07be28b3788c1fbf8838dfb55730f628b262","2020-04-03T20:00:00Z",19,NA,21470,21470,21470,29,0,0,1508,279,1787
"1148",20200403,"MP",8,13,10,NA,NA,NA,NA,NA,NA,NA,"6642918d88a155cb1d4ec9916bd848942a950a82","2020-04-03T20:00:00Z",1,NA,31,21,21,69,0,0,0,0,0
"1149",20200403,"MS",1358,4753,NA,NA,420,NA,NA,NA,NA,NA,"8fa26347da7a40d2568c9ec1881dcb83d4ba139c","2020-04-03T20:00:00Z",29,420,6111,6111,6111,28,3,60,0,181,181
"1150",20200403,"MT",243,5333,NA,NA,24,NA,NA,NA,NA,NA,"58d29fc14826e53d165af859f9d3b6aa2a562cd4","2020-04-03T20:00:00Z",5,24,5576,5576,5576,30,0,4,240,16,256
"1151",20200403,"NC",2093,29505,NA,184,NA,NA,NA,NA,NA,NA,"f9a94cae7cfc07dcd853c4ffe5b95a6a7fb2b91c","2020-04-03T20:00:00Z",19,NA,31598,31598,31598,37,3,0,2683,236,2919
"1152",20200403,"ND",173,5625,NA,NA,29,NA,NA,NA,NA,55,"84ef01d179db6bf5d01711b8006489518c3cb319","2020-04-03T20:00:00Z",3,29,5798,5798,5798,38,0,1,804,14,818
"1153",20200403,"NE",279,4487,11,NA,NA,NA,NA,NA,NA,NA,"4afd0964d77f63c02401a16e57510b1d974e875d","2020-04-03T20:00:00Z",6,NA,4777,4766,4766,31,1,0,509,33,542
"1154",20200403,"NH",479,6575,114,NA,73,NA,NA,NA,NA,101,"d868c7b35e0058b0fc967b11ce603223586ff8a4","2020-04-03T20:00:00Z",5,73,7168,7054,7054,33,1,15,497,64,561
"1155",20200403,"NJ",29895,37608,NA,3016,NA,NA,NA,NA,NA,NA,"03c9451e42a8c786a5cf424ad0fbfb412981e80b","2020-04-03T20:00:00Z",646,NA,67503,67503,67503,34,109,0,4088,4305,8393
"1156",20200403,"NM",403,14375,NA,31,NA,NA,NA,NA,NA,26,"09eb92561715a0365bc92c3a3b35f0c08b82690e","2020-04-03T20:00:00Z",7,NA,14778,14778,14778,35,1,0,727,40,767
"1157",20200403,"NV",1514,13018,NA,NA,NA,NA,NA,NA,NA,NA,"b06428c9678bd268d2992c491635ac82ec96bf35","2020-04-03T20:00:00Z",43,NA,14532,14532,14532,32,5,0,430,56,486
"1158",20200403,"NY",102863,157657,NA,14810,23696,3731,NA,NA,NA,8886,"3581ea3846e784ce3996c873effe694f50617310","2020-04-03T20:00:00Z",2935,23696,260520,260520,260520,36,562,2879,11073,10482,21555
"1159",20200403,"OH",3312,35063,NA,NA,895,NA,288,NA,NA,NA,"4f9def22c6f51b8839104ffcb46d41122de71744","2020-04-03T20:00:00Z",91,895,38375,38375,38375,39,10,93,3047,410,3457
"1160",20200403,"OK",988,1315,NA,171,289,123,NA,NA,NA,383,"ce94ae6cd03042a8be757810176e3101087d0ee9","2020-04-03T20:00:00Z",38,289,2303,2303,2303,40,4,32,50,109,159
"1161",20200403,"OR",899,16535,NA,188,204,NA,NA,38,NA,NA,"bc8939b3d2eaa3d2307a465344d028859fb57771","2020-04-03T20:00:00Z",22,204,17434,17434,17434,41,1,16,1276,73,1349
"1162",20200403,"PA",8420,53695,NA,NA,852,NA,NA,NA,NA,NA,"aade9d40167b6e73754871c40386092b362363a2","2020-04-03T20:00:00Z",102,852,62115,62115,62115,42,12,122,5997,1404,7401
"1163",20200403,"PR",378,2049,1055,NA,NA,NA,NA,NA,NA,NA,"31c1cb53249716895ec3490c18feb99b785a620a","2020-04-03T20:00:00Z",15,NA,3482,2427,2427,72,3,0,445,62,507
"1164",20200403,"RI",709,4857,NA,77,NA,14,NA,6,NA,35,"0f4d117ec3f26dff910fff56bd42e00ac645986c","2020-04-03T20:00:00Z",14,NA,5566,5566,5566,44,2,0,445,52,497
"1165",20200403,"SC",1554,5441,NA,NA,241,NA,NA,NA,NA,NA,"83a9526f05767b32166dffbd1c0668fe1e12c1b5","2020-04-03T20:00:00Z",31,241,6995,6995,6995,45,0,-655,0,0,0
"1166",20200403,"SD",187,4593,3,NA,17,NA,NA,NA,NA,69,"aa416c771bd2c9e919678126e5564dbe952c2e46","2020-04-03T20:00:00Z",2,17,4783,4780,4780,46,0,0,376,22,398
"1167",20200403,"TN",3067,34772,NA,NA,293,NA,NA,NA,NA,248,"019351b10edda80786a653adea2799cab1992e8a","2020-04-03T20:00:00Z",37,293,37839,37839,37839,47,5,30,3006,222,3228
"1168",20200403,"TX",5330,50434,NA,196,NA,NA,NA,NA,NA,38,"d995c4ec3f315bd5c26553907caa07bff418a7d9","2020-04-03T20:00:00Z",90,NA,55764,55764,55764,48,20,0,4424,661,5085
"1169",20200403,"UT",1246,23002,NA,NA,106,NA,NA,NA,NA,NA,"be88433eea3c0ab307191b78f63c45fe05615642","2020-04-03T20:00:00Z",7,106,24248,24248,24248,49,0,6,2847,172,3019
"1170",20200403,"VA",2012,16993,NA,NA,312,NA,145,NA,108,NA,"cb349d06a8404e8ea589d4d05f5ae53dfdbd1692","2020-04-03T20:00:00Z",46,312,19005,19005,19005,51,5,7,1110,306,1416
"1171",20200403,"VI",38,154,56,NA,NA,NA,NA,NA,NA,29,"17ad51e2c11f205d7826f212c444c6191de61144","2020-04-03T20:00:00Z",NA,NA,248,192,192,78,0,0,5,5,10
"1172",20200403,"VT",389,4839,NA,29,45,NA,NA,NA,NA,15,"fd502b9dcb8608ca17ea5eecf37d01466c5f5389","2020-04-03T20:00:00Z",17,45,5228,5228,5228,50,0,0,128,51,179
"1173",20200403,"WA",7379,72833,NA,NA,NA,NA,NA,NA,NA,NA,"67f7ad7f47ce99f322aaea12971491beebb81826","2020-04-03T20:00:00Z",325,NA,80212,80212,80212,53,29,0,4019,526,4545
"1174",20200403,"WI",1912,22377,NA,NA,487,NA,NA,NA,NA,NA,"ac2e774ab91aaf87bd106a4d19ddc35d0a14d163","2020-04-03T20:00:00Z",37,487,24289,24289,24289,55,6,26,2060,182,2242
"1175",20200403,"WV",237,6130,NA,NA,1,NA,NA,NA,NA,NA,"0d5735f82295c4874f145fbc22684001af9837e6","2020-04-03T20:00:00Z",2,1,6367,6367,6367,54,0,0,854,20,874
"1176",20200403,"WY",162,2704,NA,NA,21,NA,NA,NA,NA,37,"3fa4d519d76a3a9a53f819f66887a8a4f7587958","2020-04-03T20:00:00Z",0,21,2866,2866,2866,56,0,2,265,12,277
"1177",20200402,"AK",143,4879,NA,NA,9,NA,NA,NA,NA,NA,"87a29f5de0e12ea1b772006bfa38cdee3327489e","2020-04-02T20:00:00Z",3,9,5022,5022,5022,2,0,0,409,10,419
"1178",20200402,"AL",1233,7503,NA,NA,NA,NA,NA,NA,NA,NA,"1a78d31c95bd0d315fc61461107fcd8c66e53b43","2020-04-02T20:00:00Z",32,NA,8736,8736,8736,1,6,0,806,156,962
"1179",20200402,"AR",643,7880,NA,66,100,NA,NA,23,32,47,"d9bd463d4e0eec83d73a3185176ba4d9bb0e7a98","2020-04-02T20:00:00Z",12,100,8523,8523,8523,5,2,10,526,59,585
"1180",20200402,"AS",0,3,2,NA,NA,NA,NA,NA,NA,NA,"33ed9ee9243012a2f29381536962f508253e1df0","2020-04-02T20:00:00Z",0,NA,5,3,3,60,0,0,0,0,0
"1181",20200402,"AZ",1598,21111,NA,NA,NA,NA,NA,NA,NA,NA,"6e70cfc7ece882cb642606ef4d42687c36b5f6cc","2020-04-02T20:00:00Z",32,NA,22709,22709,22709,4,3,0,1466,185,1651
"1182",20200402,"CA",9191,23809,59500,1922,NA,816,NA,NA,NA,NA,"99877fe91b05bb13daef3f63c02c50d2a271e7f5","2020-04-02T20:00:00Z",203,NA,92500,33000,33000,6,32,0,2037,1036,3073
"1183",20200402,"CO",3342,15303,NA,698,620,NA,NA,NA,NA,NA,"54c77e38711f0c15356f554fa669ccfb4f8e6f50","2020-04-02T20:00:00Z",80,620,18645,18645,18645,8,11,111,1420,376,1796
"1184",20200402,"CT",3824,14476,NA,827,NA,NA,NA,NA,NA,NA,"bbaf84bc79e98252465e76199b3d66cb58316223","2020-04-02T20:00:00Z",112,NA,18300,18300,18300,9,27,0,1433,267,1700
"1185",20200402,"DC",653,4417,NA,NA,NA,NA,NA,NA,NA,173,"bb0f0a7da39336cefc7629d9814ca0bd2a83e358","2020-04-02T20:00:00Z",12,NA,5070,5070,5070,11,1,0,1155,67,1222
"1186",20200402,"DE",393,4566,NA,56,NA,NA,NA,NA,NA,49,"ed433f1aae9fc98fb0f7510f5bbd3f0bd9cdf5ab","2020-04-02T20:00:00Z",12,NA,4959,4959,4959,10,1,0,551,25,576
"1187",20200402,"FL",8010,69286,1285,NA,1123,NA,NA,NA,NA,NA,"174161bf2644248219c4f77323f7aa378fc8d409","2020-04-02T20:00:00Z",128,1123,78581,77296,77296,12,41,174,9757,1055,10812
"1188",20200402,"GA",5348,17609,NA,NA,1056,NA,NA,NA,NA,NA,"15b36e0f73598e9edefa4eb26b735231587f472d","2020-04-02T20:00:00Z",163,1056,22957,22957,22957,13,24,104,1921,710,2631
"1189",20200402,"GU",82,442,NA,19,NA,2,NA,NA,NA,12,"50fcb6de190ca75d99bd2eaf474a7bf0c5156550","2020-04-02T20:00:00Z",3,NA,524,524,524,66,0,0,36,5,41
"1190",20200402,"HI",258,10206,NA,NA,15,NA,6,NA,NA,69,"ac8dc9b5da36db2163bbfdd8ca59dd03cfec5f3d","2020-04-02T20:00:00Z",1,15,10464,10464,10464,15,0,2,1485,50,1535
"1191",20200402,"IA",614,8054,NA,74,120,NA,NA,NA,NA,46,"1f5c0a22d84a29b633b8b5a1fd1154e5b7a69bd9","2020-04-02T20:00:00Z",11,120,8668,8668,8668,19,2,21,750,65,815
"1192",20200402,"ID",669,6613,NA,NA,49,NA,7,NA,NA,NA,"378cb12d7518fb0b43fcd79e17608a1b0d3a2d1c","2020-04-02T20:00:00Z",9,49,7282,7282,7282,16,0,3,537,144,681
"1193",20200402,"IL",7695,35961,NA,NA,NA,NA,NA,NA,NA,NA,"1a8b1e0bab7743ed9c982d78d0d7844622a6d6a3","2020-04-02T20:00:00Z",157,NA,43656,43656,43656,17,16,0,2557,715,3272
"1194",20200402,"IN",3039,13246,NA,NA,NA,NA,NA,NA,NA,NA,"7efa7f48655167cc1d748ae1740c9b97dd06a209","2020-04-02T20:00:00Z",78,NA,16285,16285,16285,18,13,0,1436,474,1910
"1195",20200402,"KS",552,6059,NA,NA,138,NA,NA,NA,NA,NA,"e1d064496cc599d8997422f5393e363895fed048","2020-04-02T20:00:00Z",13,138,6611,6611,6611,20,3,24,648,70,718
"1196",20200402,"KY",680,7220,NA,NA,NA,NA,NA,NA,NA,NA,"9ab2e64fd49a2aba449f469559e03c171789906f","2020-04-02T20:00:00Z",20,NA,7900,7900,7900,21,3,0,255,89,344
"1197",20200402,"LA",9150,41936,NA,1639,NA,NA,NA,507,NA,NA,"74378a606d03569d38f8e7ee8f3eb876d17a661a","2020-04-02T20:00:00Z",310,NA,51086,51086,51086,22,37,0,2584,2726,5310
"1198",20200402,"MA",8966,47642,NA,NA,813,NA,NA,NA,NA,NA,"79d0614d1b714ae75a41b332ec20fb5cbecebab8","2020-04-02T20:00:00Z",154,813,56608,56608,56608,25,32,131,3642,1228,4870
"1199",20200402,"MD",2331,18890,NA,NA,582,NA,NA,NA,NA,81,"ecc07bae25f936e57b3850a6ce3bcb5de2a72e94","2020-04-02T20:00:00Z",36,582,21221,21221,21221,24,5,60,1657,346,2003
"1200",20200402,"ME",376,6088,NA,NA,68,NA,NA,NA,NA,94,"06fbf4e13e1f498f67a0c8c3ed6230b5d2545f50","2020-04-02T20:00:00Z",7,68,6464,6464,6464,23,0,5,0,32,32
"1201",20200402,"MI",14117,30368,NA,NA,NA,NA,NA,NA,NA,NA,"abebb0f8a0764dcc090aee82a1c844333dae4b87","2020-04-02T20:00:00Z",417,NA,44485,44485,44485,26,80,0,3131,1229,4360
"1202",20200402,"MN",742,21652,NA,75,138,38,38,NA,NA,NA,"af6b7633af8e8dd204b0ba17fe37e8ade6cd0abb","2020-04-02T20:00:00Z",18,138,22394,22394,22394,27,1,16,1150,53,1203
"1203",20200402,"MO",1834,17849,NA,NA,NA,NA,NA,NA,NA,NA,"db61b660ddb54194c33a182e92605bcbeccb7e37","2020-04-02T20:00:00Z",19,NA,19683,19683,19683,29,1,0,2003,253,2256
"1204",20200402,"MP",8,13,12,NA,NA,NA,NA,NA,NA,NA,"4c6b9b16d6a6f74a9d5d88fac1a5f162fbf047df","2020-04-02T20:00:00Z",1,NA,33,21,21,69,1,0,13,2,15
"1205",20200402,"MS",1177,4753,NA,NA,360,NA,NA,NA,NA,NA,"3fcf47375c2d49eb03ea205131eac0e18c42a29d","2020-04-02T20:00:00Z",26,360,5930,5930,5930,28,4,28,1041,104,1145
"1206",20200402,"MT",227,5093,NA,NA,20,NA,NA,NA,NA,NA,"83ed127512ee7881e2dc28380478203d2775dbaa","2020-04-02T20:00:00Z",5,20,5320,5320,5320,30,0,3,383,19,402
"1207",20200402,"NC",1857,26822,NA,184,NA,NA,NA,NA,NA,NA,"02a3e91a943b52c408f70185009c0908f88ffe18","2020-04-02T20:00:00Z",16,NA,28679,28679,28679,37,6,0,2163,273,2436
"1208",20200402,"ND",159,4821,NA,NA,28,NA,NA,NA,NA,43,"772ba7dafcd9354101e253cccb816ef1eebf1dc7","2020-04-02T20:00:00Z",3,28,4980,4980,4980,38,0,5,470,17,487
"1209",20200402,"NE",246,3978,11,NA,NA,NA,NA,NA,NA,NA,"1e5adc3c19a8d6dfeddcd695a6e27c0091ee0f4a","2020-04-02T20:00:00Z",5,NA,4235,4224,4224,31,1,0,503,36,539
"1210",20200402,"NH",415,6078,126,NA,58,NA,NA,NA,NA,91,"85834510c408ec08a6cc26b011efba15b9c91fa4","2020-04-02T20:00:00Z",4,58,6619,6493,6493,33,0,2,93,0,93
"1211",20200402,"NJ",25590,33520,NA,2000,NA,NA,NA,NA,NA,NA,"787104ddf97e6c1c54a17fc84bff2f6cf5801c39","2020-04-02T20:00:00Z",537,NA,59110,59110,59110,34,182,0,3133,3335,6468
"1212",20200402,"NM",363,13648,NA,31,NA,NA,NA,NA,NA,26,"63f4d9a139969285dde777b0114ad3dfa234ef53","2020-04-02T20:00:00Z",6,NA,14011,14011,14011,35,1,0,723,48,771
"1213",20200402,"NV",1458,12588,NA,NA,NA,NA,NA,NA,NA,NA,"ac281047995939a05d81fab70153c5a347c9a93f","2020-04-02T20:00:00Z",38,NA,14046,14046,14046,32,12,0,1069,179,1248
"1214",20200402,"NY",92381,146584,NA,13383,20817,3396,NA,NA,NA,7434,"764d0566c27be04c416c502640d5fffbcb8cad26","2020-04-02T20:00:00Z",2373,20817,238965,238965,238965,36,432,2449,9416,8669,18085
"1215",20200402,"OH",2902,32016,NA,NA,802,NA,260,NA,NA,NA,"9cb637113ec0c42f449d0e11e3fb945befdcb348","2020-04-02T20:00:00Z",81,802,34918,34918,34918,39,16,123,5024,355,5379
"1216",20200402,"OK",879,1265,NA,182,257,144,NA,NA,NA,NA,"5085d08567113dc9cd8b3fe10058c452e252bef7","2020-04-02T20:00:00Z",34,257,2144,2144,2144,40,4,38,17,160,177
"1217",20200402,"OR",826,15259,NA,134,188,NA,NA,38,NA,NA,"52a7aca8aaa9fe439cda2bd887a39b03c5c9dd41","2020-04-02T20:00:00Z",21,188,16085,16085,16085,41,3,34,2123,90,2213
"1218",20200402,"PA",7016,47698,NA,NA,730,NA,NA,NA,NA,NA,"0dc7935c18797a0f7616c41c364e159c12d62657","2020-04-02T20:00:00Z",90,730,54714,54714,54714,42,16,110,5271,1211,6482
"1219",20200402,"PR",316,1604,1119,NA,NA,NA,NA,NA,NA,NA,"2b9a9af18f7c56e17ab89f48b071e4c9afd668a9","2020-04-02T20:00:00Z",12,NA,3039,1920,1920,72,1,0,195,30,225
"1220",20200402,"RI",657,4412,NA,72,NA,14,NA,6,NA,35,"5534b1ed82ad8e56d32d7f50c21589687d7b1c1f","2020-04-02T20:00:00Z",12,NA,5069,5069,5069,44,2,0,581,91,672
"1221",20200402,"SC",1554,5441,NA,NA,896,NA,NA,NA,NA,NA,"0226337007d3996a9de9db3c450c9eae6f65f47d","2020-04-02T20:00:00Z",31,896,6995,6995,6995,45,5,547,408,261,669
"1222",20200402,"SD",165,4217,0,NA,17,NA,NA,NA,NA,57,"4503bb5ad5f51410838cf0a227b9d7ebeb19f745","2020-04-02T20:00:00Z",2,17,4382,4382,4382,46,0,5,314,36,350
"1223",20200402,"TN",2845,31766,NA,NA,263,NA,NA,NA,NA,220,"59629453e17df16d80dffa1ce35c5dcb1e94c5a2","2020-04-02T20:00:00Z",32,263,34611,34611,34611,47,8,63,1997,162,2159
"1224",20200402,"TX",4669,46010,NA,196,NA,NA,NA,NA,NA,38,"57c7248c663ba35f47dddb6ce04cf2c62d885de3","2020-04-02T20:00:00Z",70,NA,50679,50679,50679,48,12,0,2150,672,2822
"1225",20200402,"UT",1074,20155,NA,NA,100,NA,NA,NA,NA,NA,"ae818e14f015da994e59de550caffbe290355ea3","2020-04-02T20:00:00Z",7,100,21229,21229,21229,49,0,9,0,62,62
"1226",20200402,"VA",1706,15883,NA,246,305,NA,145,NA,108,NA,"9796a8ec0aabb4d2cffe52ed46445fae43bd50c6","2020-04-02T20:00:00Z",41,305,17589,17589,17589,51,7,0,2023,222,2245
"1227",20200402,"VI",33,149,42,NA,NA,NA,NA,NA,NA,25,"0361adbd93f9cc390d8b9459a98f69fdd89577c7","2020-04-02T20:00:00Z",NA,NA,224,182,182,78,0,0,23,3,26
"1228",20200402,"VT",338,4711,NA,29,45,NA,NA,NA,NA,15,"7510d18997abe87e7201c6841efcdf23546e72e3","2020-04-02T20:00:00Z",17,45,5049,5049,5049,50,1,0,537,17,554
"1229",20200402,"WA",6853,68814,NA,NA,NA,NA,NA,NA,NA,NA,"eb8966aa609a512bd49e24c4499bcde5d8ccdb63","2020-04-02T20:00:00Z",296,NA,75667,75667,75667,53,26,0,8248,353,8601
"1230",20200402,"WI",1730,20317,NA,NA,461,NA,NA,NA,NA,NA,"834fc46c2905f903a94bd047bced3c8b65158dbe","2020-04-02T20:00:00Z",31,461,22047,22047,22047,55,7,63,1498,180,1678
"1231",20200402,"WV",217,5276,NA,NA,1,NA,NA,NA,NA,NA,"bf37a7e21c11c01b281839b088a20c114f1455eb","2020-04-02T20:00:00Z",2,1,5493,5493,5493,54,1,0,892,26,918
"1232",20200402,"WY",150,2439,NA,NA,19,NA,NA,NA,NA,31,"eb0c78de23230d157b8ec36ace867b3cb3657118","2020-04-02T20:00:00Z",0,19,2589,2589,2589,56,0,1,221,20,241
"1233",20200401,"AK",133,4470,NA,NA,9,NA,NA,NA,NA,NA,"28dfb9b2615a8df04f8c622ad2fb590a6f7da833","2020-04-01T20:00:00Z",3,9,4603,4603,4603,2,0,2,876,14,890
"1234",20200401,"AL",1077,6697,NA,NA,NA,NA,NA,NA,NA,NA,"9bd398e733a5ca5042bde1fd8ce2831fc248b0b1","2020-04-01T20:00:00Z",26,NA,7774,7774,7774,1,13,0,399,96,495
"1235",20200401,"AR",584,7354,NA,56,90,NA,NA,25,32,42,"eb0f33b592be1e182660fe530097a09b66431f2c","2020-04-01T20:00:00Z",10,90,7938,7938,7938,5,2,90,1395,61,1456
"1236",20200401,"AS",0,3,2,NA,NA,NA,NA,NA,NA,NA,"7474fa36854837781f641e06f111c2a7d8da13ac","2020-04-01T20:00:00Z",0,NA,5,3,3,60,0,0,0,0,0
"1237",20200401,"AZ",1413,19645,NA,NA,NA,NA,NA,NA,NA,NA,"d12f3f1c80a1844af89ea00e1077f5095cd54767","2020-04-01T20:00:00Z",29,NA,21058,21058,21058,4,5,0,1563,124,1687
"1238",20200401,"CA",8155,21772,57400,1855,NA,774,NA,NA,NA,NA,"36cc579cf1bdcc8118bbf943a1f3239abe7ce41b","2020-04-01T20:00:00Z",171,NA,87327,29927,29927,6,18,0,0,673,673
"1239",20200401,"CO",2966,13883,NA,574,509,NA,NA,NA,NA,NA,"8bf82f524a8c38e9ae041e7b6f92ab5b5e55426c","2020-04-01T20:00:00Z",69,509,16849,16849,16849,8,18,95,1146,339,1485
"1240",20200401,"CT",3557,13043,NA,766,NA,NA,NA,NA,NA,NA,"4a71572b502d2295cf11a95ae6bb803e6c0ac2eb","2020-04-01T20:00:00Z",85,NA,16600,16600,16600,9,16,0,14,429,443
"1241",20200401,"DC",586,3262,2,NA,NA,NA,NA,NA,NA,142,"8a7aef6408b5c008467ada52ef83bc9e47d8af28","2020-04-01T20:00:00Z",11,NA,3850,3848,3848,11,2,0,0,91,91
"1242",20200401,"DE",368,4015,NA,51,NA,NA,NA,NA,NA,49,"ff8626da96327ed24e907f8daedaf58b38fceca9","2020-04-01T20:00:00Z",11,NA,4383,4383,4383,10,1,0,319,49,368
"1243",20200401,"FL",6955,59529,1235,NA,949,NA,NA,NA,NA,NA,"d9a24f33db59e2a7276a3019ee2e37f41f9bfb06","2020-04-01T20:00:00Z",87,949,67719,66484,66484,12,10,126,5244,617,5861
"1244",20200401,"GA",4638,15688,NA,NA,952,NA,NA,NA,NA,NA,"d6147a1075561f5d68ac98a7cb4dedb3e75bcd4c","2020-04-01T20:00:00Z",139,952,20326,20326,20326,13,28,119,3436,709,4145
"1245",20200401,"GU",77,406,NA,19,NA,2,NA,NA,NA,9,"c96d716269ed8689ada87b505715996beb241cff","2020-04-01T20:00:00Z",3,NA,483,483,483,66,1,0,35,8,43
"1246",20200401,"HI",208,8721,NA,NA,13,NA,6,NA,NA,58,"46d6cbdc0fe52b7c89e99d61bc60c6ddb4a7ab6d","2020-04-01T20:00:00Z",1,13,8929,8929,8929,15,1,1,250,4,254
"1247",20200401,"IA",549,7304,NA,63,99,NA,NA,NA,NA,118,"c2d7f358dcc4c936b1651f06d65c5bd7ef3ab8a2","2020-04-01T20:00:00Z",9,99,7853,7853,7853,19,2,5,416,52,468
"1248",20200401,"ID",525,6076,NA,NA,46,NA,7,NA,NA,NA,"cc12e3fa599537f47fad0258e0009e6ef9fe0581","2020-04-01T20:00:00Z",9,46,6601,6601,6601,16,2,1,779,110,889
"1249",20200401,"IL",6980,33404,NA,NA,NA,NA,NA,NA,NA,NA,"026b984139faebf730612961db2541ecac874f45","2020-04-01T20:00:00Z",141,NA,40384,40384,40384,17,42,0,4173,986,5159
"1250",20200401,"IN",2565,11810,NA,NA,NA,NA,NA,NA,NA,NA,"fcc053001d98ddb6739b2610781931fbb476aac3","2020-04-01T20:00:00Z",65,NA,14375,14375,14375,18,16,0,596,406,1002
"1251",20200401,"KS",482,5411,NA,NA,114,NA,NA,NA,NA,NA,"d8abbc3a45478014e68bb1033ec072f19a68ec6a","2020-04-01T20:00:00Z",10,114,5893,5893,5893,20,1,35,415,54,469
"1252",20200401,"KY",591,6965,NA,NA,NA,NA,NA,NA,NA,NA,"d401a0f0702a3e7442668504f89d9bbf0fd9db08","2020-04-01T20:00:00Z",17,NA,7556,7556,7556,21,6,0,635,111,746
"1253",20200401,"LA",6424,39352,NA,1498,NA,NA,NA,490,NA,NA,"ac01fe3940d3352133ae344db486ff72f25cf244","2020-04-01T20:00:00Z",273,NA,45776,45776,45776,22,34,0,5622,1187,6809
"1254",20200401,"MA",7738,44000,NA,NA,682,NA,NA,NA,NA,NA,"70ea3d599c7c506eafd12cbed1d23daa16709040","2020-04-01T20:00:00Z",122,682,51738,51738,51738,25,33,120,3685,1118,4803
"1255",20200401,"MD",1985,17233,NA,NA,522,NA,NA,NA,NA,NA,"37fdabd80821d81988b5e5a11005bbe7e3a77a5f","2020-04-01T20:00:00Z",31,522,19218,19218,19218,24,13,93,2365,325,2690
"1256",20200401,"ME",344,6088,NA,NA,63,NA,NA,NA,NA,80,"d31aa8304a5b094eb4d5598468a141d0f896f408","2020-04-01T20:00:00Z",7,63,6432,6432,6432,23,2,6,0,41,41
"1257",20200401,"MI",12888,27237,NA,NA,NA,NA,NA,NA,NA,NA,"0792f1570e8e7519be93e514a705700ec6daeb6d","2020-04-01T20:00:00Z",337,NA,40125,40125,40125,26,78,0,3258,1013,4271
"1258",20200401,"MN",689,20502,NA,54,122,27,27,NA,NA,NA,"f3620fcfc12dce927a8e2f46922b59df0e351756","2020-04-01T20:00:00Z",17,122,21191,21191,21191,27,5,10,1351,60,1411
"1259",20200401,"MO",1581,15846,NA,NA,NA,NA,NA,NA,NA,NA,"dc97aa93ab282b95a3c23db92cd5efdf0b46ac22","2020-04-01T20:00:00Z",18,NA,17427,17427,17427,29,4,0,1232,254,1486
"1260",20200401,"MP",6,NA,NA,NA,NA,NA,NA,NA,NA,NA,"5fb1a4bb5496638fbba1216c23902a9938e1eaac","2020-04-01T20:00:00Z",NA,NA,6,6,6,69,0,0,0,4,4
"1261",20200401,"MS",1073,3712,NA,NA,332,NA,NA,NA,NA,NA,"03c61b979c5d42a05f6620424c0f7090acc01647","2020-04-01T20:00:00Z",22,332,4785,4785,4785,28,2,121,175,136,311
"1262",20200401,"MT",208,4710,NA,NA,17,NA,NA,NA,NA,NA,"5c9460763670b2514d789493ad77a8e06dc8bcc2","2020-04-01T20:00:00Z",5,17,4918,4918,4918,30,1,3,476,24,500
"1263",20200401,"NC",1584,24659,NA,204,NA,NA,NA,NA,NA,NA,"70807abafbcbc2da31b4f44c7523196116df4f15","2020-04-01T20:00:00Z",10,NA,26243,26243,26243,37,2,0,3051,86,3137
"1264",20200401,"ND",142,4351,NA,NA,23,NA,NA,NA,NA,34,"d5fcb30b1ccee3f5ace04e24072d51272e7e9d5b","2020-04-01T20:00:00Z",3,23,4493,4493,4493,38,0,2,220,16,236
"1265",20200401,"NE",210,3475,8,NA,NA,NA,NA,NA,NA,NA,"a736e9df99d379949dec4b420b4fe03c5a5b32b4","2020-04-01T20:00:00Z",4,NA,3693,3685,3685,31,1,0,544,38,582
"1266",20200401,"NH",415,5985,97,NA,56,NA,NA,NA,NA,56,"0a1a84677bbb59edf20b69ca4a71ad7f70bae202","2020-04-01T20:00:00Z",4,56,6497,6400,6400,33,1,11,572,101,673
"1267",20200401,"NJ",22255,30387,NA,2000,NA,NA,NA,NA,NA,NA,"970ca703cb183143daa9b6b3cb9b5b95746de860","2020-04-01T20:00:00Z",355,NA,52642,52642,52642,34,88,0,3310,3559,6869
"1268",20200401,"NM",315,12925,NA,24,NA,NA,NA,NA,NA,26,"3beefaa3bff9114ea2bf131529a2f0e13eecd129","2020-04-01T20:00:00Z",5,NA,13240,13240,13240,35,1,0,679,34,713
"1269",20200401,"NV",1279,11519,NA,NA,NA,NA,NA,NA,NA,NA,"99ca8c448bcd3a57ffe6454db6a4b2533447a96b","2020-04-01T20:00:00Z",26,NA,12798,12798,12798,32,9,0,838,166,1004
"1270",20200401,"NY",83712,137168,NA,12226,18368,3022,NA,NA,NA,6142,"0b906bb4c9631eecca95b6183d50bee067b4bbc2","2020-04-01T20:00:00Z",1941,18368,220880,220880,220880,36,391,2464,7777,7917,15694
"1271",20200401,"OH",2547,26992,NA,NA,679,NA,222,NA,NA,NA,"9742acfe1c987695868db136a9cc02a8e558dc7d","2020-04-01T20:00:00Z",65,679,29539,29539,29539,39,10,94,0,348,348
"1272",20200401,"OK",719,1248,NA,174,219,98,NA,NA,NA,NA,"857cacccae911c7d1d0003cb7fc05aa82d7ac1f1","2020-04-01T20:00:00Z",30,219,1967,1967,1967,40,7,42,19,154,173
"1273",20200401,"OR",736,13136,NA,132,154,NA,NA,40,NA,NA,"1f1edcb802acf42ba4967cdfed4f48c270347c97","2020-04-01T20:00:00Z",18,154,13872,13872,13872,41,0,0,0,46,46
"1274",20200401,"PA",5805,42427,NA,NA,620,NA,NA,NA,NA,NA,"575ea7e224d4f1f6797bed8fe0a7902daad3ffab","2020-04-01T20:00:00Z",74,620,48232,48232,48232,42,11,106,4782,962,5744
"1275",20200401,"PR",286,1409,897,NA,NA,NA,NA,NA,NA,NA,"ae0129f382eb5f04d790633ebc4cfb9e7e00f89a","2020-04-01T20:00:00Z",11,NA,2592,1695,1695,72,3,0,214,47,261
"1276",20200401,"RI",566,3831,NA,60,NA,14,NA,6,NA,35,"d6bd45c8f92d8d9e8b397cf13b291acb33c74944","2020-04-01T20:00:00Z",10,NA,4397,4397,4397,44,2,0,355,77,432
"1277",20200401,"SC",1293,5033,NA,NA,349,NA,NA,NA,NA,NA,"a321818d113ea1e8063433667ca10f117f264d11","2020-04-01T20:00:00Z",26,349,6326,6326,6326,45,4,90,417,210,627
"1278",20200401,"SD",129,3903,0,NA,12,NA,NA,NA,NA,51,"321e6948f2b0f05bf9e515252aed1d4ec4873a57","2020-04-01T20:00:00Z",2,12,4032,4032,4032,46,1,0,294,21,315
"1279",20200401,"TN",2683,29769,NA,NA,200,NA,NA,NA,NA,137,"9e9bb3593287cbf3b938263422d21dba45a771e1","2020-04-01T20:00:00Z",24,200,32452,32452,32452,47,1,25,4648,444,5092
"1280",20200401,"TX",3997,43860,NA,196,NA,NA,NA,NA,NA,38,"acd01e7eaf0e46a8473dd525c35a0c4fecbeca15","2020-04-01T20:00:00Z",58,NA,47857,47857,47857,48,17,0,4134,731,4865
"1281",20200401,"UT",1012,20155,NA,NA,91,NA,NA,NA,NA,NA,"3060e79ad1d88a94c41b61754e101f096b677716","2020-04-01T20:00:00Z",7,91,21167,21167,21167,49,2,18,2529,125,2654
"1282",20200401,"VA",1484,13860,NA,NA,305,NA,145,NA,108,NA,"3978f9b311c4141c1b8cab5ace841ef8bff698d3","2020-04-01T20:00:00Z",34,305,15344,15344,15344,51,7,140,1709,234,1943
"1283",20200401,"VI",30,126,24,NA,NA,NA,NA,NA,NA,21,"a7b58dc10565c19782a05701feaed42d38a8fb8e","2020-04-01T20:00:00Z",NA,NA,180,156,156,78,0,0,0,0,0
"1284",20200401,"VT",321,4174,NA,30,45,NA,NA,NA,NA,15,"09d62e8a97e7673d2cb199f97cefebe931639672","2020-04-01T20:00:00Z",16,45,4495,4495,4495,50,3,9,217,28,245
"1285",20200401,"WA",6500,60566,NA,NA,NA,NA,NA,NA,NA,NA,"71ad8a0f4d47a9252852fa7ab257428c08a44ba9","2020-04-01T20:00:00Z",270,NA,67066,67066,67066,53,18,0,0,487,487
"1286",20200401,"WI",1550,18819,NA,NA,398,NA,NA,NA,NA,NA,"3a304dc1edaaf3c59465b033f7b4aa76ad3dec32","2020-04-01T20:00:00Z",24,398,20369,20369,20369,55,8,61,1444,199,1643
"1287",20200401,"WV",191,4384,NA,NA,1,NA,NA,NA,NA,NA,"264082faaa6983c76d88bf13c4444943677bfd72","2020-04-01T20:00:00Z",1,1,4575,4575,4575,54,0,0,403,29,432
"1288",20200401,"WY",130,2218,NA,NA,18,NA,NA,NA,NA,31,"a5690ff900709e2e51e09c47b186c26c6bb7d126","2020-04-01T20:00:00Z",0,18,2348,2348,2348,56,0,1,219,21,240
"1289",20200331,"AK",119,3594,NA,NA,7,NA,NA,NA,NA,NA,"5ec8d7c9ede0e8d30b6f7b63be047ac0ead0b49b","2020-03-31T20:00:00Z",3,7,3713,3713,3713,2,0,0,54,5,59
"1290",20200331,"AL",981,6298,NA,NA,NA,NA,NA,NA,NA,NA,"42eecba7755e229592355c2a117a0c76245f655a","2020-03-31T20:00:00Z",13,NA,7279,7279,7279,1,7,0,604,122,726
"1291",20200331,"AR",523,5959,NA,64,NA,NA,NA,23,NA,35,"a9c9435748295307c8030289e3bbb22dbb61466f","2020-03-31T20:00:00Z",8,NA,6482,6482,6482,5,1,0,697,50,747
"1292",20200331,"AS",0,3,2,NA,NA,NA,NA,NA,NA,NA,"1c73590ddf391630382d8064191c344bc8195a3c","2020-03-31T20:00:00Z",0,NA,5,3,3,60,0,0,3,0,3
"1293",20200331,"AZ",1289,18082,NA,NA,NA,NA,NA,NA,NA,NA,"86a252a1dfcd2659cd4bebccacb9f93428dec0ce","2020-03-31T20:00:00Z",24,NA,19371,19371,19371,4,4,0,2480,132,2612
"1294",20200331,"CA",7482,21772,57400,1617,NA,657,NA,NA,NA,NA,"0d1f030c44db79d66aaebbed5cbc3c295b2838fe","2020-03-31T20:00:00Z",153,NA,86654,29254,29254,6,20,0,1223,1035,2258
"1295",20200331,"CO",2627,12737,NA,503,414,NA,NA,NA,NA,NA,"0736bc2e6ddb8489ecafa706a29941301edb7d9f","2020-03-31T20:00:00Z",51,414,15364,15364,15364,8,0,0,0,0,0
"1296",20200331,"CT",3128,13029,NA,608,NA,NA,NA,NA,NA,NA,"1dbf8c0e8e39af7461e15fb8855c64efc447b563","2020-03-31T20:00:00Z",69,NA,16157,16157,16157,9,33,0,1000,557,1557
"1297",20200331,"DC",495,3262,2,NA,NA,NA,NA,NA,NA,121,"5434bf0aabd9cdefb5f6ade62555f66bf0231f65","2020-03-31T20:00:00Z",9,NA,3759,3757,3757,11,0,0,580,94,674
"1298",20200331,"DE",319,3696,NA,57,NA,NA,NA,NA,NA,22,"2a0658af704fddd0065e7d3e957e71bf99c9f435","2020-03-31T20:00:00Z",10,NA,4015,4015,4015,10,4,0,1480,55,1535
"1299",20200331,"FL",6338,54285,1163,NA,823,NA,NA,NA,NA,NA,"c0d094c60a3352b108e4b759b45b066bd56cc068","2020-03-31T20:00:00Z",77,823,61786,60623,60623,12,14,171,6060,865,6925
"1300",20200331,"GA",3929,12252,NA,NA,833,NA,NA,NA,NA,NA,"59e2183e84ee35f0e1c3432ef7380d6b2ba4f740","2020-03-31T20:00:00Z",111,833,16181,16181,16181,13,24,126,2337,1120,3457
"1301",20200331,"GU",69,371,NA,19,NA,2,NA,NA,NA,7,"9bc093e770b32b248bc697d62d378eb33af1c668","2020-03-31T20:00:00Z",2,NA,440,440,440,66,1,0,19,11,30
"1302",20200331,"HI",204,8471,NA,NA,12,NA,6,NA,NA,49,"655f60069fde91c6736a5f66d52dbd65ea100e33","2020-03-31T20:00:00Z",NA,12,8675,8675,8675,15,0,0,646,29,675
"1303",20200331,"IA",497,6888,NA,61,94,NA,NA,NA,NA,33,"4ec1acfc172943306bb03e7153d7f1958591191d","2020-03-31T20:00:00Z",7,94,7385,7385,7385,19,1,20,726,73,799
"1304",20200331,"ID",415,5297,NA,NA,45,NA,6,NA,NA,NA,"6f7851470fbaf9166e84cbeb782d870ec1bbb384","2020-03-31T20:00:00Z",7,45,5712,5712,5712,16,1,6,901,105,1006
"1305",20200331,"IL",5994,29231,NA,NA,NA,NA,NA,NA,NA,NA,"979983c53f3fef1cf573ae3a61de7f9166197b17","2020-03-31T20:00:00Z",99,NA,35225,35225,35225,17,26,0,3842,937,4779
"1306",20200331,"IN",2159,11214,NA,NA,NA,NA,NA,NA,NA,NA,"76b4fbd00067fbb532bb2d0c63800ffa814d75c9","2020-03-31T20:00:00Z",49,NA,13373,13373,13373,18,14,0,1342,373,1715
"1307",20200331,"KS",428,4996,NA,NA,79,NA,NA,NA,NA,NA,"12716e5b136e60836429eab2bb08477c7ca6d529","2020-03-31T20:00:00Z",9,79,5424,5424,5424,20,1,13,442,60,502
"1308",20200331,"KY",480,6330,NA,NA,NA,NA,NA,NA,NA,NA,"37e85814eaa2e8744faaf12a5995d3a1d5958614","2020-03-31T20:00:00Z",11,NA,6810,6810,6810,21,2,0,751,41,792
"1309",20200331,"LA",5237,33730,NA,1355,NA,NA,NA,438,NA,NA,"cb012c368afcbcc2ef27ae4c8341f028b6d69381","2020-03-31T20:00:00Z",239,NA,38967,38967,38967,22,54,0,3722,1212,4934
"1310",20200331,"MA",6620,40315,NA,NA,562,NA,NA,NA,NA,NA,"b113daa2aa839e30f1f3605f00483292aa39a60e","2020-03-31T20:00:00Z",89,562,46935,46935,46935,25,33,109,3274,868,4142
"1311",20200331,"MD",1660,14868,NA,NA,429,NA,NA,NA,NA,NA,"d7bfec3c323983994ff111c9de7dc7addc251550","2020-03-31T20:00:00Z",18,429,16528,16528,16528,24,3,76,1552,247,1799
"1312",20200331,"ME",303,6088,NA,NA,57,NA,NA,NA,NA,68,"9a8dc48e67c43030905fcae8d51b29844ca227ad","2020-03-31T20:00:00Z",5,57,6391,6391,6391,23,2,8,2694,28,2722
"1313",20200331,"MI",11875,23979,NA,NA,NA,NA,NA,NA,NA,NA,"ab147c05b259014d46b9027e65d44d7d12f869f2","2020-03-31T20:00:00Z",259,NA,35854,35854,35854,26,75,0,2796,974,3770
"1314",20200331,"MN",629,19151,NA,56,112,26,26,NA,NA,NA,"cb5ae95ed3bb94c2e6a93343b3be56544a28c7e0","2020-03-31T20:00:00Z",12,112,19780,19780,19780,27,2,20,905,53,958
"1315",20200331,"MO",1327,14614,NA,NA,NA,NA,NA,NA,NA,NA,"4fc56f79bf2224a97947093ebb74ae8bf0a5c36f","2020-03-31T20:00:00Z",14,NA,15941,15941,15941,29,1,0,1410,296,1706
"1316",20200331,"MP",2,NA,NA,NA,NA,NA,NA,NA,NA,NA,"ffa5f54a292f871515c1817ce333527b48f76d79","2020-03-31T20:00:00Z",NA,NA,2,2,2,69,0,0,0,0,0
"1317",20200331,"MS",937,3537,NA,NA,211,NA,NA,NA,NA,NA,"b44e85184d9a95e733dd5b77766d46986a09876a","2020-03-31T20:00:00Z",20,211,4474,4474,4474,28,4,16,548,90,638
"1318",20200331,"MT",184,4234,NA,NA,14,NA,NA,NA,NA,NA,"501a4ed165fe9f891b45ef2af4b82b23f264ef3a","2020-03-31T20:00:00Z",4,14,4418,4418,4418,30,0,4,91,13,104
"1319",20200331,"NC",1498,21608,NA,157,NA,NA,NA,NA,NA,NA,"d94d3c30bef4275e3636d15317c59e0091ab2e9e","2020-03-31T20:00:00Z",8,NA,23106,23106,23106,37,2,0,2051,191,2242
"1320",20200331,"ND",126,4131,NA,NA,21,NA,NA,NA,NA,30,"165f85808067a5516ef0cffab5966fd74ac37fd3","2020-03-31T20:00:00Z",3,21,4257,4257,4257,38,1,2,403,17,420
"1321",20200331,"NE",172,2931,8,NA,NA,NA,NA,NA,NA,NA,"b3674a50a3d04771860eca37b3917ee82b88fbba","2020-03-31T20:00:00Z",3,NA,3111,3103,3103,31,1,0,347,27,374
"1322",20200331,"NH",314,5413,65,NA,45,NA,NA,NA,NA,NA,"68bb996e94c06de538bf71b4b97068a9acae4c3f","2020-03-31T20:00:00Z",3,45,5792,5727,5727,33,0,0,27,0,27
"1323",20200331,"NJ",18696,27077,NA,2000,NA,NA,NA,NA,NA,NA,"407885b56f3b2687f57779a9981c027b0ebd092d","2020-03-31T20:00:00Z",267,NA,45773,45773,45773,34,69,0,1853,2060,3913
"1324",20200331,"NM",281,12246,NA,22,NA,NA,NA,NA,NA,26,"9318d0f9b076da040387faac6c578323bf64ae5b","2020-03-31T20:00:00Z",4,NA,12527,12527,12527,35,2,0,1304,44,1348
"1325",20200331,"NV",1113,10681,NA,NA,NA,NA,NA,NA,NA,NA,"75bc5c5fe829f18065e4706cf35ef2994fb69f7b","2020-03-31T20:00:00Z",17,NA,11794,11794,11794,32,2,0,474,105,579
"1326",20200331,"NY",75795,129391,NA,10929,15904,2710,NA,NA,NA,4975,"b82085af96dba94baabf7e0b7cf6e7b539cce21b","2020-03-31T20:00:00Z",1550,15904,205186,205186,205186,36,332,2183,9420,9298,18718
"1327",20200331,"OH",2199,26992,NA,NA,585,NA,198,NA,NA,NA,"10fe4fc7d3c11a63cedf85d22ac82fcbee137d99","2020-03-31T20:00:00Z",55,585,29191,29191,29191,39,16,110,1650,266,1916
"1328",20200331,"OK",565,1229,NA,NA,177,83,NA,NA,NA,NA,"519df67e7bc7167c52872bf04f91fcbcabb2b786","2020-03-31T20:00:00Z",23,177,1794,1794,1794,40,6,24,22,84,106
"1329",20200331,"OR",690,13136,NA,132,154,NA,NA,40,NA,NA,"75deaaf7ba4817dfbf64577e2466eee6fd6d5a5b","2020-03-31T20:00:00Z",18,154,13826,13826,13826,41,2,14,859,84,943
"1330",20200331,"PA",4843,37645,NA,NA,514,NA,NA,NA,NA,NA,"f2ddb226108bf8650a4c9d6b6394ff9083e3adbc","2020-03-31T20:00:00Z",63,514,42488,42488,42488,42,14,128,3868,756,4624
"1331",20200331,"PR",239,1195,854,NA,NA,NA,NA,NA,NA,NA,"78117516d9037f5282375c81906d6c029a53bf68","2020-03-31T20:00:00Z",8,NA,2288,1434,1434,72,2,0,264,65,329
"1332",20200331,"RI",489,3476,NA,59,NA,9,NA,6,NA,35,"bf796f9edfb484dec716499b5f5cc3d2391f2b6a","2020-03-31T20:00:00Z",8,NA,3965,3965,3965,44,4,0,289,87,376
"1333",20200331,"SC",1083,4616,NA,NA,259,NA,NA,NA,NA,NA,"34a657bc2def360f99f18a1a872eae0f3b37583b","2020-03-31T20:00:00Z",22,259,5699,5699,5699,45,4,130,456,158,614
"1334",20200331,"SD",108,3609,0,NA,12,NA,NA,NA,NA,44,"1dfa391214d591fb4af733f72b7006016c4f3309","2020-03-31T20:00:00Z",1,12,3717,3717,3717,46,0,12,131,7,138
"1335",20200331,"TN",2239,25121,NA,NA,175,NA,NA,NA,NA,121,"8b236550ae5ec5e539ddcd63854658d0193987d2","2020-03-31T20:00:00Z",23,175,27360,27360,27360,47,10,27,3651,405,4056
"1336",20200331,"TX",3266,39726,NA,196,NA,NA,NA,NA,NA,38,"9566b8b35846c815aa661bd2eff724a717eb8062","2020-03-31T20:00:00Z",41,NA,42992,42992,42992,48,7,0,6723,389,7112
"1337",20200331,"UT",887,17626,NA,NA,73,NA,NA,NA,NA,NA,"df48bc20a6b94395ef809b6483a81ac976f07c72","2020-03-31T20:00:00Z",5,73,18513,18513,18513,49,1,73,2429,81,2510
"1338",20200331,"VA",1250,12151,NA,NA,165,NA,NA,NA,NA,NA,"94c6ced5cbd2d7474ef25844e4f1c69d185328b8","2020-03-31T20:00:00Z",27,165,13401,13401,13401,51,2,29,1133,230,1363
"1339",20200331,"VI",30,126,24,NA,NA,NA,NA,NA,NA,21,"aa85d4eb0661c567f1f2843ad6583c65fa67411e","2020-03-31T20:00:00Z",NA,NA,180,156,156,78,0,0,0,0,0
"1340",20200331,"VT",293,3957,NA,21,36,NA,NA,NA,NA,15,"f7ff1c5b387b478086752b2ba379a2aaab0bf9fd","2020-03-31T20:00:00Z",13,36,4250,4250,4250,50,1,18,283,37,320
"1341",20200331,"WA",6013,60566,NA,NA,NA,NA,NA,NA,NA,NA,"6e2b8a419da0dd614e50b05487e1bc8000467952","2020-03-31T20:00:00Z",252,NA,66579,66579,66579,53,13,0,0,457,457
"1342",20200331,"WI",1351,17375,NA,NA,337,NA,NA,NA,NA,NA,"5743ca4c966b5e5a927d00d404c31fbb7cc91341","2020-03-31T20:00:00Z",16,337,18726,18726,18726,55,2,337,1519,130,1649
"1343",20200331,"WV",162,3981,NA,NA,1,NA,NA,NA,NA,NA,"8e2d2b08f0436cdcaf61239f004ddbef807c2a89","2020-03-31T20:00:00Z",1,1,4143,4143,4143,54,0,0,997,36,1033
"1344",20200331,"WY",109,1999,NA,NA,17,NA,NA,NA,NA,26,"56481c095ddf7e629ed8e0a3c0eedf3ce33180f7","2020-03-31T20:00:00Z",0,17,2108,2108,2108,56,0,0,159,15,174
"1345",20200330,"AK",114,3540,NA,NA,7,NA,NA,NA,NA,NA,"98553897a21c05aeec18d5391001f5bdb25eb44e","2020-03-30T20:00:00Z",3,7,3654,3654,3654,2,1,1,308,12,320
"1346",20200330,"AL",859,5694,NA,NA,NA,NA,NA,NA,NA,NA,"4552863c924f79edb83615e6b3642696b80a83cf","2020-03-30T20:00:00Z",6,NA,6553,6553,6553,1,2,0,1510,53,1563
"1347",20200330,"AR",473,5262,NA,62,NA,NA,NA,21,NA,29,"0ec0c0c3df52146a28574929923168f0a9b419c9","2020-03-30T20:00:00Z",7,NA,5735,5735,5735,5,1,0,2235,47,2282
"1348",20200330,"AS",NA,NA,NA,NA,NA,NA,NA,NA,NA,NA,"016909ef598616403b32e8c8d61b26a0498b9bfb","2020-03-30T20:00:00Z",0,NA,0,0,0,60,0,0,0,0,0
"1349",20200330,"AZ",1157,15602,NA,NA,NA,NA,NA,NA,NA,NA,"22b1a4b417a7dc39db4d03f7a24e514e1624d7db","2020-03-30T20:00:00Z",20,NA,16759,16759,16759,4,3,0,2649,238,2887
"1350",20200330,"CA",6447,20549,64400,1432,NA,597,NA,NA,NA,NA,"a5728b6db27be0a303e8c2270385ec0c71bc63e8","2020-03-30T20:00:00Z",133,NA,91396,26996,26996,6,10,0,0,739,739
"1351",20200330,"CO",2627,12737,NA,358,414,NA,NA,NA,NA,NA,"5f4dd92269e69d023f8567062d1b845e6bdf8b17","2020-03-30T20:00:00Z",51,414,15364,15364,15364,8,7,140,1522,566,2088
"1352",20200330,"CT",2571,12029,NA,517,NA,NA,NA,NA,NA,NA,"70eb03d4fcfe461e62251eef8272509a3f9f5a7d","2020-03-30T20:00:00Z",36,NA,14600,14600,14600,9,2,0,2122,578,2700
"1353",20200330,"DC",401,2682,2,NA,NA,NA,NA,NA,NA,106,"ce7ca86d5bbfbde3f47a32e8e6d830701114a95e","2020-03-30T20:00:00Z",9,NA,3085,3083,3083,11,4,0,213,59,272
"1354",20200330,"DE",264,2216,NA,45,NA,NA,NA,NA,NA,9,"b9ca4ef7d7d27f1040cc1a3b2a77a6d9d1b87193","2020-03-30T20:00:00Z",6,NA,2480,2480,2480,10,0,0,2180,32,2212
"1355",20200330,"FL",5473,48225,NA,NA,652,NA,NA,NA,NA,NA,"9a3e8154ce0eca0c63b55151a437a020a79406e3","2020-03-30T20:00:00Z",63,652,53698,53698,53698,12,7,58,9155,1227,10382
"1356",20200330,"GA",2809,9915,NA,NA,707,NA,NA,NA,NA,NA,"25ceba85ecebfa065b3994c5a0511a721902a2a5","2020-03-30T20:00:00Z",87,707,12724,12724,12724,13,7,41,2,158,160
"1357",20200330,"GU",58,352,NA,19,NA,2,NA,NA,NA,7,"325e44bac3252c9555fc2ae45206f278b4c9a474","2020-03-30T20:00:00Z",1,NA,410,410,410,66,0,0,18,2,20
"1358",20200330,"HI",175,7825,NA,NA,12,NA,NA,NA,NA,NA,"399f627e033b6cacfd3f76187089f3f5f49d5462","2020-03-30T20:00:00Z",NA,12,8000,8000,8000,15,0,0,976,24,1000
"1359",20200330,"IA",424,6162,NA,51,74,NA,NA,NA,NA,23,"bb8559f53afd6bd1498d5d61c82adc745f314b7d","2020-03-30T20:00:00Z",6,74,6586,6586,6586,19,2,6,1149,88,1237
"1360",20200330,"ID",310,4396,NA,NA,39,NA,NA,NA,NA,NA,"7199499861b27b9737de62f8b6fcccfd09b03ad8","2020-03-30T20:00:00Z",6,39,4706,4706,4706,16,1,3,375,49,424
"1361",20200330,"IL",5057,25389,NA,NA,NA,NA,NA,NA,NA,NA,"49eda929cdc14ecc7beeaffc5a03863b651175f5","2020-03-30T20:00:00Z",73,NA,30446,30446,30446,17,8,0,2223,461,2684
"1362",20200330,"IN",1786,9872,NA,NA,NA,NA,NA,NA,NA,NA,"1eb08f6c84c1646c1611f46dfcb77c86a50479fc","2020-03-30T20:00:00Z",35,NA,11658,11658,11658,18,3,0,1556,272,1828
"1363",20200330,"KS",368,4554,NA,NA,66,NA,NA,NA,NA,NA,"740551d80bb24aabc7ddbc519fc876c31ec53920","2020-03-30T20:00:00Z",8,66,4922,4922,4922,20,2,11,360,49,409
"1364",20200330,"KY",439,5579,NA,NA,NA,NA,NA,NA,NA,NA,"e683db18146f3c70866e5138f7c84f76f04bc09a","2020-03-30T20:00:00Z",9,NA,6018,6018,6018,21,0,0,432,45,477
"1365",20200330,"LA",4025,30008,NA,1185,NA,NA,NA,385,NA,NA,"06ff7ea1f0e4cc7ea2a7b1d27e4e0ae275c5a43e","2020-03-30T20:00:00Z",185,NA,34033,34033,34033,22,34,0,5677,485,6162
"1366",20200330,"MA",5752,37041,NA,NA,453,NA,NA,NA,NA,NA,"559b7707f9c7203da0ea8c07a2bfc9577d331c97","2020-03-30T20:00:00Z",56,453,42793,42793,42793,25,8,54,2930,797,3727
"1367",20200330,"MD",1413,13316,NA,NA,353,NA,NA,NA,NA,NA,"ea51bd505bfb1c35306ee4e4b22abdad5d2820d8","2020-03-30T20:00:00Z",15,353,14729,14729,14729,24,5,76,962,174,1136
"1368",20200330,"ME",275,3394,NA,NA,49,NA,NA,NA,NA,41,"fe7606d23c550ea474d64f9540019641a5da2680","2020-03-30T20:00:00Z",3,49,3669,3669,3669,23,0,49,0,22,22
"1369",20200330,"MI",10901,21183,NA,NA,NA,NA,NA,NA,NA,NA,"2ceff9e794b8c31ee7d7191153cdbcfdae09ba51","2020-03-30T20:00:00Z",184,NA,32084,32084,32084,26,52,0,5507,891,6398
"1370",20200330,"MN",576,18246,NA,56,92,24,24,NA,NA,NA,"f4fd6f4736f788b58399563a48e0a4a14c120ff4","2020-03-30T20:00:00Z",10,92,18822,18822,18822,27,1,17,1092,73,1165
"1371",20200330,"MO",1031,13204,NA,NA,NA,NA,NA,NA,NA,NA,"932b312edc6f1709cc6feaa4afd9e492c17be555","2020-03-30T20:00:00Z",13,NA,14235,14235,14235,29,3,0,1657,193,1850
"1372",20200330,"MP",2,NA,NA,NA,NA,NA,NA,NA,NA,NA,"330007cfa03e74e1da2c74b8b75a41f075ed1f10","2020-03-30T20:00:00Z",NA,NA,2,2,2,69,0,0,0,0,0
"1373",20200330,"MS",847,2989,NA,NA,195,NA,NA,NA,NA,NA,"306cc9d00ab15c39bbba409f447156bbece99bfe","2020-03-30T20:00:00Z",16,195,3836,3836,3836,28,2,-40,429,89,518
"1374",20200330,"MT",171,4143,NA,NA,10,NA,NA,NA,NA,NA,"40066be19c800ef5911207f9d482f8ef230d6a60","2020-03-30T20:00:00Z",4,10,4314,4314,4314,30,3,2,0,17,17
"1375",20200330,"NC",1307,19557,NA,137,NA,NA,NA,NA,NA,NA,"4a55f1f47fc6384a52875c590477c7ebd61c8a40","2020-03-30T20:00:00Z",6,NA,20864,20864,20864,37,2,0,1652,267,1919
"1376",20200330,"ND",109,3728,NA,NA,19,NA,NA,NA,NA,19,"68a3b5338b8b1424629db87b97ecbd0c347d7317","2020-03-30T20:00:00Z",2,19,3837,3837,3837,38,1,2,373,11,384
"1377",20200330,"NE",145,2584,5,NA,NA,NA,NA,NA,NA,NA,"088432e8d55e51cb7eaba7eba13d364259f8842c","2020-03-30T20:00:00Z",2,NA,2734,2729,2729,31,0,0,616,37,653
"1378",20200330,"NH",314,5386,144,NA,45,NA,NA,NA,NA,NA,"09deb0331b52dd98962c90342290df5b9d20b889","2020-03-30T20:00:00Z",3,45,5844,5700,5700,33,1,12,862,100,962
"1379",20200330,"NJ",16636,25224,NA,2000,NA,NA,NA,NA,NA,NA,"f214c15223ba6282835a9b067f69ac4f17a2ed28","2020-03-30T20:00:00Z",198,NA,41860,41860,41860,34,37,0,3008,3250,6258
"1380",20200330,"NM",237,10942,NA,22,NA,NA,NA,NA,NA,26,"056758cf1a3b84770e2b01cb509251b9de1724c4","2020-03-30T20:00:00Z",2,NA,11179,11179,11179,35,0,0,173,0,173
"1381",20200330,"NV",1008,10207,NA,NA,NA,NA,NA,NA,NA,NA,"34628b797fa0cbc9196833ea89dc685929e71e86","2020-03-30T20:00:00Z",15,NA,11215,11215,11215,32,1,0,1795,270,2065
"1382",20200330,"NY",66497,119971,NA,9517,13721,2352,NA,NA,NA,4204,"8ff11bd6ca3432e7960be3f3c82d4cfd0f320843","2020-03-30T20:00:00Z",1218,13721,186468,186468,186468,36,253,1646,7124,6984,14108
"1383",20200330,"OH",1933,25342,NA,NA,475,NA,163,NA,NA,NA,"71bcd417ea0891e655685ed3f8422e79a59f4ba8","2020-03-30T20:00:00Z",39,475,27275,27275,27275,39,10,72,6330,280,6610
"1384",20200330,"OK",481,1207,NA,NA,153,103,NA,NA,NA,NA,"b47be4f15b256548273890888c642d0090fa49de","2020-03-30T20:00:00Z",17,153,1688,1688,1688,40,1,13,2,52,54
"1385",20200330,"OR",606,12277,NA,132,140,NA,NA,39,NA,NA,"5ebeddaa7dd640814bb167d138ece738953fc2fc","2020-03-30T20:00:00Z",16,140,12883,12883,12883,41,3,11,1399,58,1457
"1386",20200330,"PA",4087,33777,NA,NA,386,NA,NA,NA,NA,NA,"cac05153a6de7331306734979416c0bbbca4be85","2020-03-30T20:00:00Z",49,386,37864,37864,37864,42,11,33,3716,693,4409
"1387",20200330,"PR",174,931,794,NA,NA,NA,NA,NA,NA,NA,"fd89d6c3b101b8f486f201f326442d416bfd4a2d","2020-03-30T20:00:00Z",6,NA,1899,1105,1105,72,1,0,90,47,137
"1388",20200330,"RI",402,3187,NA,41,NA,9,NA,6,NA,NA,"8f178ec7116e1893386a3222bf829388d99b7499","2020-03-30T20:00:00Z",4,NA,3589,3589,3589,44,1,0,347,108,455
"1389",20200330,"SC",925,4160,NA,NA,129,NA,NA,NA,NA,NA,"ceb9937dd126bead37bfbbd92bde9286cf955c64","2020-03-30T20:00:00Z",18,129,5085,5085,5085,45,2,0,1145,151,1296
"1390",20200330,"SD",101,3478,0,NA,NA,NA,NA,NA,NA,34,"0bb03d9210c26f22f5301e7d3d05499e38494ffb","2020-03-30T20:00:00Z",1,NA,3579,3579,3579,46,0,0,351,11,362
"1391",20200330,"TN",1834,21470,NA,NA,148,NA,NA,NA,NA,NA,"ec22bf9d70375a31624ca8e4f9483a01aac06b52","2020-03-30T20:00:00Z",13,148,23304,23304,23304,47,6,15,2433,297,2730
"1392",20200330,"TX",2877,33003,NA,NA,NA,NA,NA,NA,NA,38,"97f0dea6f50c349bb0a5bb31afde8cf9ad5ffcf8","2020-03-30T20:00:00Z",34,NA,35880,35880,35880,48,0,0,9795,325,10120
"1393",20200330,"UT",806,15197,NA,NA,NA,NA,NA,NA,NA,NA,"9c05aaa04b932a442629dc78d9f4015fc3648184","2020-03-30T20:00:00Z",4,NA,16003,16003,16003,49,2,0,1923,87,2010
"1394",20200330,"VA",1020,11018,NA,NA,136,NA,NA,NA,NA,NA,"1b814b67e1fc83c5f9fdc2e3ca2dc1e7d1fa66d7","2020-03-30T20:00:00Z",25,136,12038,12038,12038,51,3,24,1299,130,1429
"1395",20200330,"VI",30,126,24,NA,NA,NA,NA,NA,NA,NA,"b32a1c0cf911b225e766bdbf0fd0890dc047acdc","2020-03-30T20:00:00Z",NA,NA,180,156,156,78,0,0,3,7,10
"1396",20200330,"VT",256,3674,NA,NA,18,NA,NA,NA,NA,NA,"707ea7e30f8939272fe9b6691b379a0385237953","2020-03-30T20:00:00Z",12,18,3930,3930,3930,50,0,0,208,21,229
"1397",20200330,"WA",5556,60566,NA,NA,NA,NA,NA,NA,NA,NA,"1176f4add62e7df73a5359d19e38f49663fcef0c","2020-03-30T20:00:00Z",239,NA,66122,66122,66122,53,11,0,5670,462,6132
"1398",20200330,"WI",1221,15856,NA,NA,NA,NA,NA,NA,NA,NA,"23dce446b3a30d5d3dda0c1c88c909196d75aaab","2020-03-30T20:00:00Z",14,NA,17077,17077,17077,55,1,0,-694,109,-585
"1399",20200330,"WV",126,2984,0,NA,1,NA,NA,NA,NA,NA,"ce4f1662c7da92e2834a2a7b3bfdc61882f80794","2020-03-30T20:00:00Z",1,1,3110,3110,3110,54,1,0,279,13,292
"1400",20200330,"WY",94,1840,NA,NA,17,NA,NA,NA,NA,24,"d063fc044d9f24bbc91ef6e673e1bc6e0a0b4e4b","2020-03-30T20:00:00Z",0,17,1934,1934,1934,56,0,2,286,8,294
"1401",20200329,"AK",102,3232,NA,NA,6,NA,NA,NA,NA,NA,"422bc4f921be7a7ead06e6f738314ef1911a8407","2020-03-29T20:00:00Z",2,6,3334,3334,3334,2,0,1,396,17,413
"1402",20200329,"AL",806,4184,NA,NA,NA,NA,NA,NA,NA,NA,"0c2a7ece10172b9bd60b53579fd6d9a53f5e9f03","2020-03-29T20:00:00Z",4,NA,4990,4990,4990,1,1,0,0,110,110
"1403",20200329,"AR",426,3027,NA,43,NA,NA,NA,16,NA,28,"b731e778cec28ea92d5307e74b6774e3a1f19f81","2020-03-29T20:00:00Z",6,NA,3453,3453,3453,5,1,0,89,22,111
"1404",20200329,"AS",NA,NA,NA,NA,NA,NA,NA,NA,NA,NA,"b71912eee827fe10f806cb56123974239fa7b3d5","2020-03-29T20:00:00Z",0,NA,0,0,0,60,0,0,0,0,0
"1405",20200329,"AZ",919,12953,NA,NA,NA,NA,NA,NA,NA,NA,"467d5839bc5cfabb09479bd53472842bf24f4f43","2020-03-29T20:00:00Z",17,NA,13872,13872,13872,4,2,0,5498,46,5544
"1406",20200329,"CA",5708,20549,64400,1034,NA,410,NA,NA,NA,NA,"21f0bf97cbd1f715f37780ee6f00cdb4442ffebb","2020-03-29T20:00:00Z",123,NA,90657,26257,26257,6,22,0,0,1065,1065
"1407",20200329,"CO",2061,11215,NA,332,274,NA,NA,NA,NA,NA,"095a08fb57b9e544ba799a68a2e34bb2e95b8189","2020-03-29T20:00:00Z",44,274,13276,13276,13276,8,13,35,1273,327,1600
"1408",20200329,"CT",1993,9907,NA,404,NA,NA,NA,NA,NA,NA,"029989758f7a0426df84362ece8d2fe9fc5e34a8","2020-03-29T20:00:00Z",34,NA,11900,11900,11900,9,7,0,2798,702,3500
"1409",20200329,"DC",342,2469,1,NA,NA,NA,NA,NA,NA,66,"4781282de2140f0f63dcd581d9f45c684bf3fb32","2020-03-29T20:00:00Z",5,NA,2812,2811,2811,11,1,0,258,38,296
"1410",20200329,"DE",232,36,NA,33,NA,NA,NA,NA,NA,9,"f501e8507f242da253b2646cb974edc30bc67370","2020-03-29T20:00:00Z",6,NA,268,268,268,10,3,0,0,18,18
"1411",20200329,"FL",4246,39070,NA,NA,594,NA,NA,NA,NA,NA,"39553e3ec095e3143e776031465d2e90ade6c787","2020-03-29T20:00:00Z",56,594,43316,43316,43316,12,2,68,3704,483,4187
"1412",20200329,"GA",2651,9913,NA,NA,666,NA,NA,NA,NA,NA,"8fd5124a5d60c405bdada62747c232a41e2f9111","2020-03-29T20:00:00Z",80,666,12564,12564,12564,13,11,49,1228,285,1513
"1413",20200329,"GU",56,334,NA,15,NA,NA,NA,NA,NA,7,"b2cb617f4bd3a7be5db2e39016e92ab8bf2f1efb","2020-03-29T20:00:00Z",1,NA,390,390,390,66,0,0,35,1,36
"1414",20200329,"HI",151,6849,NA,NA,12,NA,NA,NA,NA,NA,"840860ca961633c9010ff0a1373e16b2d9146a30","2020-03-29T20:00:00Z",NA,12,7000,7000,7000,15,0,4,2492,31,2523
"1415",20200329,"IA",336,5013,NA,51,68,NA,NA,NA,NA,17,"0390f1a7c97c62a24050e5d9ebac698026cb1467","2020-03-29T20:00:00Z",4,68,5349,5349,5349,19,1,7,638,38,676
"1416",20200329,"ID",261,4021,NA,NA,36,NA,NA,NA,NA,NA,"8979502556f020e81fc4c2989d1a752bf6e3068d","2020-03-29T20:00:00Z",5,36,4282,4282,4282,16,1,11,679,31,710
"1417",20200329,"IL",4596,23166,NA,NA,NA,NA,NA,NA,NA,NA,"bd7639325f1e033630241a08bc0e4cfebae48436","2020-03-29T20:00:00Z",65,NA,27762,27762,27762,17,18,0,1166,1105,2271
"1418",20200329,"IN",1514,8316,NA,NA,NA,NA,NA,NA,NA,NA,"7218f7ee5dcf63b69f6d3a8be6ab8404ecd588c4","2020-03-29T20:00:00Z",32,NA,9830,9830,9830,18,1,0,1141,282,1423
"1419",20200329,"KS",319,4194,NA,NA,55,NA,NA,NA,NA,NA,"5bcb9dae92d0bbe8c3b18551ded266dd24876d38","2020-03-29T20:00:00Z",6,55,4513,4513,4513,20,1,28,523,58,581
"1420",20200329,"KY",394,5147,NA,NA,NA,NA,NA,NA,NA,NA,"466fb0bcb56c8e91014554ef6a8818029299ecfd","2020-03-29T20:00:00Z",9,NA,5541,5541,5541,21,1,0,326,92,418
"1421",20200329,"LA",3540,24331,NA,1127,NA,NA,NA,380,NA,NA,"540faf48376478e6345cb140616c5c5ad0fe45c5","2020-03-29T20:00:00Z",151,NA,27871,27871,27871,22,14,0,2485,225,2710
"1422",20200329,"MA",4955,34111,NA,NA,399,NA,NA,NA,NA,NA,"1de5b22e00296e1b0a1fea40b858c4f6d2eeb1b0","2020-03-29T20:00:00Z",48,399,39066,39066,39066,25,4,49,3319,698,4017
"1423",20200329,"MD",1239,12354,NA,NA,277,NA,NA,NA,NA,NA,"43e502f79bd427c342c79c2281412b86f1c174e1","2020-03-29T20:00:00Z",10,277,13593,13593,13593,24,5,51,838,247,1085
"1424",20200329,"ME",253,3394,NA,NA,NA,NA,NA,NA,NA,41,"1f1feafef96ccfc55b84c7fc1ec38625fc276029","2020-03-29T20:00:00Z",3,NA,3647,3647,3647,23,2,0,0,42,42
"1425",20200329,"MI",10010,15676,NA,NA,NA,NA,NA,NA,NA,NA,"78103abcede4de100cefa054c696ba6ad96716cf","2020-03-29T20:00:00Z",132,NA,25686,25686,25686,26,40,0,1493,723,2216
"1426",20200329,"MN",503,17154,NA,39,75,NA,17,NA,NA,252,"74247593bee28b5b049c8db9e1db79859e9d48fb","2020-03-29T20:00:00Z",9,75,17657,17657,17657,27,4,18,1466,62,1528
"1427",20200329,"MO",838,11547,NA,NA,NA,NA,NA,NA,NA,NA,"c9427dccdae92e441cee6fbb2787ea3a231dc686","2020-03-29T20:00:00Z",10,NA,12385,12385,12385,29,0,0,1465,0,1465
"1428",20200329,"MP",2,NA,NA,NA,NA,NA,NA,NA,NA,NA,"80c72d24c28e3245151244a3e59d6ee9fe9a391b","2020-03-29T20:00:00Z",NA,NA,2,2,2,69,0,0,0,0,0
"1429",20200329,"MS",758,2560,NA,NA,235,NA,NA,NA,NA,NA,"7e0258b174e76d4043c8b6164aa265e2ea9b1f53","2020-03-29T20:00:00Z",14,235,3318,3318,3318,28,1,16,0,95,95
"1430",20200329,"MT",154,4143,NA,NA,8,NA,NA,NA,NA,NA,"8e59ae6eb967f41c99ed548a2cd1a8e66fafb8e1","2020-03-29T20:00:00Z",1,8,4297,4297,4297,30,0,1,887,25,912
"1431",20200329,"NC",1040,17905,NA,91,NA,NA,NA,NA,NA,NA,"48107df93e16171dfd6faf7dbaf698bb19af8b2c","2020-03-29T20:00:00Z",4,NA,18945,18945,18945,37,0,0,1313,105,1418
"1432",20200329,"ND",98,3355,NA,NA,17,NA,NA,NA,NA,18,"9ea37c7842380c19726ed92b58103490a1d7de53","2020-03-29T20:00:00Z",1,17,3453,3453,3453,38,0,1,546,15,561
"1433",20200329,"NE",108,1968,4,NA,NA,NA,NA,NA,NA,NA,"a91fc8b0c0abec3ecc573422316a5421f9afd0ed","2020-03-29T20:00:00Z",2,NA,2080,2076,2076,31,0,0,64,12,76
"1434",20200329,"NH",214,4524,285,NA,33,NA,NA,NA,NA,NA,"0802aecb450515b575cf19e88b8b137764d666dc","2020-03-29T20:00:00Z",2,33,5023,4738,4738,33,0,3,868,27,895
"1435",20200329,"NJ",13386,22216,NA,2000,NA,NA,NA,NA,NA,NA,"25ca9138c4a2da1c7d10525cb7bd148761303d58","2020-03-29T20:00:00Z",161,NA,35602,35602,35602,34,21,0,2830,2262,5092
"1436",20200329,"NM",237,10769,NA,19,NA,NA,NA,NA,NA,2,"3650556fd86edbe68b549235d70d2605865aa335","2020-03-29T20:00:00Z",2,NA,11006,11006,11006,35,1,0,1573,46,1619
"1437",20200329,"NV",738,8412,NA,NA,NA,NA,NA,NA,NA,NA,"0c74530736aea27f85556493e8fa89eb8b417763","2020-03-29T20:00:00Z",14,NA,9150,9150,9150,32,4,0,511,117,628
"1438",20200329,"NY",59513,112847,NA,8503,12075,2037,NA,NA,NA,3572,"1c5d1ed64f0ad27a41286104875c23a773a62a40","2020-03-29T20:00:00Z",965,12075,172360,172360,172360,36,237,2021,9231,7195,16426
"1439",20200329,"OH",1653,19012,NA,NA,403,NA,139,NA,NA,NA,"10c9da94683ad45dfb568422d04af2604ade7ca3","2020-03-29T20:00:00Z",29,403,20665,20665,20665,39,4,59,0,247,247
"1440",20200329,"OK",429,1205,NA,NA,140,NA,NA,NA,NA,NA,"90830f70410babf14d5be9257a440aec4c3a2752","2020-03-29T20:00:00Z",16,140,1634,1634,1634,40,1,14,25,52,77
"1441",20200329,"OR",548,10878,NA,107,129,NA,NA,37,NA,NA,"58e5cfeaabed045338f7db94d98652bce8b93797","2020-03-29T20:00:00Z",13,129,11426,11426,11426,41,0,12,1185,69,1254
"1442",20200329,"PA",3394,30061,NA,NA,353,NA,NA,NA,NA,NA,"da55c1eba9c83cb8c9e3ce7b474a2d7f74f7ecbc","2020-03-29T20:00:00Z",38,353,33455,33455,33455,42,4,37,4807,643,5450
"1443",20200329,"PR",127,841,817,NA,NA,NA,NA,NA,NA,NA,"e0fd73e5dd7429d9fdff54eda5df78010bbd83c6","2020-03-29T20:00:00Z",5,NA,1785,968,968,72,2,0,102,27,129
"1444",20200329,"RI",294,2840,NA,35,NA,9,NA,6,NA,NA,"b90aa14699c9395b429ef0673f23fa9863cc8fa0","2020-03-29T20:00:00Z",3,NA,3134,3134,3134,44,3,0,299,55,354
"1445",20200329,"SC",774,3015,NA,NA,129,NA,NA,NA,NA,NA,"6e080ec1f424aec417c9000a8c610501e2870c5a","2020-03-29T20:00:00Z",16,129,3789,3789,3789,45,3,0,607,235,842
"1446",20200329,"SD",90,3127,1,NA,NA,NA,NA,NA,NA,29,"c81ef2d008bae4c0458db5684079af5ccdbe5abe","2020-03-29T20:00:00Z",1,NA,3218,3217,3217,46,0,0,535,22,557
"1447",20200329,"TN",1537,19037,NA,NA,133,NA,NA,NA,NA,NA,"13f3a406e572a8d2c810f9154c0c08a615f21fb1","2020-03-29T20:00:00Z",7,133,20574,20574,20574,47,1,15,2072,164,2236
"1448",20200329,"TX",2552,23208,NA,NA,NA,NA,NA,NA,NA,NA,"a9b7fb107b90949f6bd5ab29b957e2cf6e46f9c5","2020-03-29T20:00:00Z",34,NA,25760,25760,25760,48,7,0,0,500,500
"1449",20200329,"UT",719,13274,NA,NA,NA,NA,NA,NA,NA,NA,"c9720da2b069f73256af2086f464a94afc3ade35","2020-03-29T20:00:00Z",2,NA,13993,13993,13993,49,0,0,2564,117,2681
"1450",20200329,"VA",890,9719,NA,NA,112,NA,NA,NA,NA,NA,"c69c5d634a01118e8c0e248abc63805871431f51","2020-03-29T20:00:00Z",22,112,10609,10609,10609,51,5,13,1292,151,1443
"1451",20200329,"VI",23,123,37,NA,NA,NA,NA,NA,NA,NA,"fc797a1ff071a1407658e2f2635370e51d0b804d","2020-03-29T20:00:00Z",NA,NA,183,146,146,78,0,0,17,1,18
"1452",20200329,"VT",235,3466,NA,NA,18,NA,NA,NA,NA,NA,"6378ad325a9d0e9f7f1edfeb369856d460b5e9d8","2020-03-29T20:00:00Z",12,18,3701,3701,3701,50,0,0,1303,24,1327
"1453",20200329,"WA",5094,54896,NA,NA,NA,NA,NA,NA,NA,NA,"91d826da9d750864be8f7cbe7c925e08d72a4008","2020-03-29T20:00:00Z",228,NA,59990,59990,59990,53,17,0,5881,382,6263
"1454",20200329,"WI",1112,16550,NA,NA,NA,NA,NA,NA,NA,NA,"8687db826f68ba2e1871b9798043b5acf7de9e5e","2020-03-29T20:00:00Z",13,NA,17662,17662,17662,55,0,0,1318,123,1441
"1455",20200329,"WV",113,2705,0,NA,1,NA,NA,NA,NA,NA,"95339cc3a82c7850a55cdc2d30895277e29795d5","2020-03-29T20:00:00Z",0,1,2818,2818,2818,54,0,0,374,17,391
"1456",20200329,"WY",86,1554,NA,NA,15,NA,NA,NA,NA,20,"521448649e211047b886a9ac18dbc0b0bd35cf3e","2020-03-29T20:00:00Z",0,15,1640,1640,1640,56,0,1,79,4,83
"1457",20200328,"AK",85,2836,NA,NA,5,NA,NA,NA,NA,NA,"8a84438657945de664a61b77351faf30fafb9111","2020-03-28T20:00:00Z",2,5,2921,2921,2921,2,1,2,517,16,533
"1458",20200328,"AL",696,4184,NA,NA,NA,NA,NA,NA,NA,NA,"63de5e074e982530fe275d036c8318c14eabf49f","2020-03-28T20:00:00Z",3,NA,4880,4880,4880,1,0,0,0,109,109
"1459",20200328,"AR",404,2938,NA,48,NA,NA,NA,17,NA,24,"821e36063f84aa707c0d1ebd3983a4abfa560ac0","2020-03-28T20:00:00Z",5,NA,3342,3342,3342,5,2,0,1393,23,1416
"1460",20200328,"AS",NA,NA,NA,NA,NA,NA,NA,NA,NA,NA,"1cd7c88c7f467edd373751178a42f7123d5d457b","2020-03-28T20:00:00Z",0,NA,0,0,0,60,0,0,0,0,0
"1461",20200328,"AZ",873,7455,21,NA,NA,NA,NA,NA,NA,NA,"06aad51da966e2299f0c0537e0cf4fbba4c6c696","2020-03-28T20:00:00Z",15,NA,8349,8328,8328,4,2,0,0,137,137
"1462",20200328,"CA",4643,20549,64400,1034,NA,410,NA,NA,NA,NA,"b157cc0b84b971d5a3a02d83eff554903bc4e42f","2020-03-28T20:00:00Z",101,NA,89592,25192,25192,6,23,0,3169,764,3933
"1463",20200328,"CO",1734,9942,NA,307,239,NA,NA,NA,NA,NA,"0f504f665e7ee9fb3f5a32de281e25f407499940","2020-03-28T20:00:00Z",31,239,11676,11676,11676,8,7,55,1250,304,1554
"1464",20200328,"CT",1291,7109,NA,173,NA,NA,NA,NA,NA,NA,"4b54cec168b8c41b7f2e60c54af8db39164dd3ad","2020-03-28T20:00:00Z",27,NA,8400,8400,8400,9,0,0,0,0,0
"1465",20200328,"DC",304,2211,1,NA,NA,NA,NA,NA,NA,51,"1a0f746e0a4c29b6d4b0f58ba80a30d82fbc3ccb","2020-03-28T20:00:00Z",4,NA,2516,2515,2515,11,1,0,314,37,351
"1466",20200328,"DE",214,36,NA,31,NA,NA,NA,NA,NA,9,"a6e34ce456e231c698fdc1ee16f40c4858227866","2020-03-28T20:00:00Z",3,NA,250,250,250,10,1,0,0,51,51
"1467",20200328,"FL",3763,35366,NA,NA,526,NA,NA,NA,NA,NA,"14cf93a61518d7efeec334a7c7fb1c959060c9f8","2020-03-28T20:00:00Z",54,526,39129,39129,39129,12,20,70,7180,998,8178
"1468",20200328,"GA",2366,8685,NA,NA,617,NA,NA,NA,NA,NA,"202f88e65247b72d32891c53d6d6c15fd209d322","2020-03-28T20:00:00Z",69,617,11051,11051,11051,13,5,51,821,365,1186
"1469",20200328,"GU",55,299,NA,15,NA,NA,NA,NA,NA,7,"b1d234c73440aba9439f6b60529423ffc740bf70","2020-03-28T20:00:00Z",1,NA,354,354,354,66,0,0,0,4,4
"1470",20200328,"HI",120,4357,NA,NA,8,NA,NA,NA,NA,NA,"37b251fd5f1651b4c76855ef6f4077c6c4a39f5e","2020-03-28T20:00:00Z",NA,8,4477,4477,4477,15,0,1,0,14,14
"1471",20200328,"IA",298,4375,NA,46,61,NA,NA,NA,NA,15,"a6e6297aaacb70cf1998fe078852e2d7c0446496","2020-03-28T20:00:00Z",3,61,4673,4673,4673,19,0,11,635,63,698
"1472",20200328,"ID",230,3342,NA,NA,25,NA,NA,NA,NA,NA,"9a384c62a22020c8ec086d3f520e57d5f47d80e1","2020-03-28T20:00:00Z",4,25,3572,3572,3572,16,1,25,674,41,715
"1473",20200328,"IL",3491,22000,NA,NA,NA,NA,NA,NA,NA,NA,"073372a26378c93d1b5b6ee7307fb9c030f82f2d","2020-03-28T20:00:00Z",47,NA,25491,25491,25491,17,13,0,3484,465,3949
"1474",20200328,"IN",1232,7175,NA,NA,NA,NA,NA,NA,NA,NA,"bb33e7862d580175dc4ae2bfe3b91be2dd68c719","2020-03-28T20:00:00Z",31,NA,8407,8407,8407,18,7,0,1220,251,1471
"1475",20200328,"KS",261,3671,NA,NA,27,NA,NA,NA,NA,NA,"aa84b44c0851b4d887ab1410a969451c25976b52","2020-03-28T20:00:00Z",5,27,3932,3932,3932,20,1,0,442,59,501
"1476",20200328,"KY",302,4821,NA,NA,NA,NA,NA,NA,NA,NA,"ea4c264896e76b10ebe1600f6c5705d613dc6f9e","2020-03-28T20:00:00Z",8,NA,5123,5123,5123,21,2,0,1053,54,1107
"1477",20200328,"LA",3315,21846,NA,927,NA,NA,NA,336,NA,NA,"0a37aa047446a367cce2ff12aebc516ae46b6ed5","2020-03-28T20:00:00Z",137,NA,25161,25161,25161,22,18,0,3233,569,3802
"1478",20200328,"MA",4257,30792,NA,NA,350,NA,NA,NA,NA,NA,"c038ffa81528722c23a2ffffda17f2495a188ded","2020-03-28T20:00:00Z",44,350,35049,35049,35049,25,9,131,4661,1017,5678
"1479",20200328,"MD",992,11516,NA,NA,226,NA,NA,NA,NA,NA,"9a4f0c46cc3178a20535820bef6c0096ec60c487","2020-03-28T20:00:00Z",5,226,12508,12508,12508,24,0,53,11422,218,11640
"1480",20200328,"ME",211,3394,NA,NA,NA,NA,NA,NA,NA,36,"6a5bccaf6b59cc976bba660e1db01c905136fd21","2020-03-28T20:00:00Z",1,NA,3605,3605,3605,23,0,0,0,43,43
"1481",20200328,"MI",9287,14183,NA,NA,NA,NA,NA,NA,NA,NA,"4d982f1ea0d2d1f67634828a85f3e5d5837db62f","2020-03-28T20:00:00Z",92,NA,23470,23470,23470,26,0,0,1544,628,2172
"1482",20200328,"MN",441,15688,NA,30,57,NA,17,NA,NA,220,"a8973e480f151382f19549d1bdfc538a4e03c387","2020-03-28T20:00:00Z",5,57,16129,16129,16129,27,1,6,2083,43,2126
"1483",20200328,"MO",838,10082,NA,NA,NA,NA,NA,NA,NA,NA,"e3f4b93a6ae042958eb8189a70db6a5157dcbfbe","2020-03-28T20:00:00Z",10,NA,10920,10920,10920,29,2,0,9713,169,9882
"1484",20200328,"MP",2,NA,NA,NA,NA,NA,NA,NA,NA,NA,"7b50f60167cf1b698fab776267ec6db2d2d94e8e","2020-03-28T20:00:00Z",NA,NA,2,2,2,69,0,0,0,2,2
"1485",20200328,"MS",663,2560,NA,NA,219,NA,NA,NA,NA,NA,"6abee145ef8e88027852840cb9a48bc1ad203737","2020-03-28T20:00:00Z",13,219,3223,3223,3223,28,5,34,0,84,84
"1486",20200328,"MT",129,3256,NA,NA,7,NA,NA,NA,NA,NA,"92e123a507931bf1b282c0575331bdd0d17fba98","2020-03-28T20:00:00Z",1,7,3385,3385,3385,30,1,0,666,21,687
"1487",20200328,"NC",935,16592,NA,87,NA,NA,NA,NA,NA,NA,"f85a64360e16bd10ae0bfae5989948e04dfa3b74","2020-03-28T20:00:00Z",4,NA,17527,17527,17527,37,1,0,2219,172,2391
"1488",20200328,"ND",83,2809,NA,NA,16,NA,NA,NA,NA,16,"b3dcd39ac30934f3e505d5d57bc88442172b358f","2020-03-28T20:00:00Z",1,16,2892,2892,2892,38,1,3,382,18,400
"1489",20200328,"NE",96,1904,NA,NA,NA,NA,NA,NA,NA,NA,"ba991b0ef3a5d94c0f5b994ff54cc8053cfde2b7","2020-03-28T20:00:00Z",2,NA,2000,2000,2000,31,2,0,143,11,154
"1490",20200328,"NH",187,3656,296,NA,30,NA,NA,NA,NA,NA,"3372eb26e404d2af3105361a92e2fcff4bdd04e7","2020-03-28T20:00:00Z",2,30,4139,3843,3843,33,1,5,261,29,290
"1491",20200328,"NJ",11124,19386,NA,2000,NA,NA,NA,NA,NA,NA,"d013d501bf506e7978b59f0fd09793994ed757b3","2020-03-28T20:00:00Z",140,NA,30510,30510,30510,34,32,0,2839,2299,5138
"1492",20200328,"NM",191,9196,NA,17,NA,NA,NA,NA,NA,NA,"d150e7faad5390184e84f058771ebe3e21a2c2b3","2020-03-28T20:00:00Z",1,NA,9387,9387,9387,35,0,0,819,55,874
"1493",20200328,"NV",621,7901,NA,NA,NA,NA,NA,NA,NA,NA,"38aee6610ca54e785d7593c3916d7256e0ac2a9b","2020-03-28T20:00:00Z",10,NA,8522,8522,8522,32,0,0,1740,86,1826
"1494",20200328,"NY",52318,103616,NA,7328,10054,1755,NA,NA,NA,2726,"9d3efd380bf48a8a6a2ff98004ddd6a29a59c988","2020-03-28T20:00:00Z",728,10054,155934,155934,155934,36,209,1528,2498,7683,10181
"1495",20200328,"OH",1406,19012,NA,NA,344,NA,123,NA,NA,NA,"e1ae2e6533d6476a00dce3fdf53a9d06d6df11c3","2020-03-28T20:00:00Z",25,344,20418,20418,20418,39,6,68,0,269,269
"1496",20200328,"OK",377,1180,NA,NA,126,NA,NA,NA,NA,NA,"0955acd0f7dadd282ecf522f79bd9042b3af7b95","2020-03-28T20:00:00Z",15,126,1557,1557,1557,40,7,21,96,55,151
"1497",20200328,"OR",479,9693,NA,107,117,NA,NA,31,NA,NA,"4b290ff3db90da090eab1f7a1f4cefcde650b790","2020-03-28T20:00:00Z",13,117,10172,10172,10172,41,1,15,1183,65,1248
"1498",20200328,"PA",2751,25254,NA,NA,316,NA,NA,NA,NA,NA,"0b00e5e4eec84c744f25bfd23aa3ff905cca2f2e","2020-03-28T20:00:00Z",34,316,28005,28005,28005,42,12,75,4238,533,4771
"1499",20200328,"PR",100,739,792,NA,NA,NA,NA,NA,NA,NA,"c1f61bf559aeba0b90d63533c15308234532ea16","2020-03-28T20:00:00Z",3,NA,1631,839,839,72,0,0,220,21,241
"1500",20200328,"RI",239,2541,138,29,NA,9,NA,6,NA,NA,"7e5f58bc1722f99ce207cc0d9f753d553667b66a","2020-03-28T20:00:00Z",NA,NA,2918,2780,2780,44,0,0,235,36,271
"1501",20200328,"SC",539,2408,NA,NA,129,NA,NA,NA,NA,NA,"4328bb39fcb99f8666b72daf09cc3812ab1727cf","2020-03-28T20:00:00Z",13,129,2947,2947,2947,45,4,20,101,83,184
"1502",20200328,"SD",68,2592,0,NA,NA,NA,NA,NA,NA,26,"f6d58782a216be383150078737dd5aa359ef916d","2020-03-28T20:00:00Z",1,NA,2660,2660,2660,46,0,0,205,10,215
"1503",20200328,"TN",1373,16965,NA,NA,118,NA,NA,NA,NA,NA,"645205ffe209d5acbff94f4dd98d7d981e97a644","2020-03-28T20:00:00Z",6,118,18338,18338,18338,47,0,15,2077,170,2247
"1504",20200328,"TX",2052,23208,NA,NA,NA,NA,NA,NA,NA,NA,"9d601857ab7b38aa375d52c046e21db2fe147e92","2020-03-28T20:00:00Z",27,NA,25260,25260,25260,48,4,0,1273,321,1594
"1505",20200328,"UT",602,10710,NA,NA,NA,NA,NA,NA,NA,NA,"eff17f1a0f1557568ff842519c39e1fbc56c66ae","2020-03-28T20:00:00Z",2,NA,11312,11312,11312,49,0,0,1946,122,2068
"1506",20200328,"VA",739,8427,NA,NA,99,NA,NA,NA,NA,NA,"4a9486b875debc40351684839a6e07900f0fd3ca","2020-03-28T20:00:00Z",17,99,9166,9166,9166,51,3,16,1694,135,1829
"1507",20200328,"VI",22,106,55,NA,NA,NA,NA,NA,NA,NA,"d4ffcf812bce08ca20c0cc0a25c40adbedd622db","2020-03-28T20:00:00Z",NA,NA,183,128,128,78,0,0,51,3,54
"1508",20200328,"VT",211,2163,NA,NA,18,NA,NA,NA,NA,NA,"c531c6adaae5c5623a25bebe275eb0269f0e549e","2020-03-28T20:00:00Z",12,18,2374,2374,2374,50,2,0,86,27,113
"1509",20200328,"WA",4712,49015,NA,NA,NA,NA,NA,NA,NA,NA,"926c0421a4cc6394468e499f811924cf346c72d4","2020-03-28T20:00:00Z",211,NA,53727,53727,53727,53,20,0,5842,432,6274
"1510",20200328,"WI",989,15232,NA,NA,NA,NA,NA,NA,NA,NA,"cc9a38626e488667d80901c4814ba600f9f923cb","2020-03-28T20:00:00Z",13,NA,16221,16221,16221,55,0,0,2092,147,2239
"1511",20200328,"WV",96,2331,6,NA,1,NA,NA,NA,NA,NA,"673594f71200f16f129f2a5e2d70765e7785bb3e","2020-03-28T20:00:00Z",0,1,2433,2427,2427,54,0,0,552,20,572
"1512",20200328,"WY",82,1475,NA,NA,14,NA,NA,NA,NA,18,"33814ce4191a5dcfd2db3346f01e91095209c877","2020-03-28T20:00:00Z",0,14,1557,1557,1557,56,0,3,264,12,276
"1513",20200327,"AK",69,2319,13,NA,3,NA,NA,NA,NA,NA,"4440492623bf23f8e264cde045f01820bcf5eb1f","2020-03-27T20:00:00Z",1,3,2401,2388,2388,2,0,0,518,10,528
"1514",20200327,"AL",587,4184,NA,NA,NA,NA,NA,NA,NA,NA,"07d7df62adf5e730a3da751291c1fba471551397","2020-03-27T20:00:00Z",3,NA,4771,4771,4771,1,2,0,591,81,672
"1515",20200327,"AR",381,1545,NA,48,NA,NA,NA,17,NA,19,"00b098e286ece2617f1acecb0abd238b8b786f1a","2020-03-27T20:00:00Z",3,NA,1926,1926,1926,5,0,0,41,46,87
"1516",20200327,"AS",NA,NA,NA,NA,NA,NA,NA,NA,NA,NA,"e56724c557d48a4cb6080632b317c35eea41e880","2020-03-27T20:00:00Z",0,NA,0,0,0,60,0,0,0,0,0
"1517",20200327,"AZ",736,7455,30,NA,NA,NA,NA,NA,NA,NA,"ed32559e21a38aa4dcf186932bc2e858d1974669","2020-03-27T20:00:00Z",13,NA,8221,8191,8191,4,5,0,7108,159,7267
"1518",20200327,"CA",3879,17380,57400,746,NA,200,NA,NA,NA,NA,"8d4a4c3407f121198d45ea520a0fead10e78b7ea","2020-03-27T20:00:00Z",78,NA,78659,21259,21259,6,13,0,0,873,873
"1519",20200327,"CO",1430,8692,NA,278,184,NA,NA,NA,NA,NA,"c0a340133fc94be89c0606305c4c1361b1ff14d7","2020-03-27T20:00:00Z",24,184,10122,10122,10122,8,5,36,1714,344,2058
"1520",20200327,"CT",1291,7109,NA,173,NA,NA,NA,NA,NA,NA,"a8a5f5f6ff700aca7582d8fc72d71f5fde38fc69","2020-03-27T20:00:00Z",27,NA,8400,8400,8400,9,6,0,1484,279,1763
"1521",20200327,"DC",267,1897,2,NA,NA,NA,NA,NA,NA,49,"05e7fe78e293ec8a664077ad665e2495d86713bd","2020-03-27T20:00:00Z",3,NA,2166,2164,2164,11,0,0,271,36,307
"1522",20200327,"DE",163,36,NA,15,NA,NA,NA,NA,NA,9,"bad5bab1f9987dd260382f36323623a344953a31","2020-03-27T20:00:00Z",2,NA,199,199,199,10,1,0,0,33,33
"1523",20200327,"FL",2765,28186,1517,NA,456,NA,NA,NA,NA,NA,"b93ab29f799aa9d89c0f98c7f427278725445572","2020-03-27T20:00:00Z",34,456,32468,30951,30951,12,6,50,4445,410,4855
"1524",20200327,"GA",2001,7864,NA,NA,566,NA,NA,NA,NA,NA,"b85e11000166a29096d95a7188bd6313144ef7fe","2020-03-27T20:00:00Z",64,566,9865,9865,9865,13,16,93,463,476,939
"1525",20200327,"GU",51,299,NA,13,NA,NA,NA,NA,NA,NA,"b0946d74b2f737a6121bcccad2d6d512e5238d43","2020-03-27T20:00:00Z",1,NA,350,350,350,66,0,0,36,6,42
"1526",20200327,"HI",106,4357,NA,NA,7,NA,NA,NA,NA,NA,"8abd3d7a2e51102bd77b1d155788a12a5405e9ab","2020-03-27T20:00:00Z",NA,7,4463,4463,4463,15,0,2,0,11,11
"1527",20200327,"IA",235,3740,NA,32,50,NA,NA,NA,NA,18,"a23c3b107d9c1fdabfcdbf0d850c781b78831c20","2020-03-27T20:00:00Z",3,50,3975,3975,3975,19,2,4,1162,56,1218
"1528",20200327,"ID",189,2668,NA,NA,NA,NA,NA,NA,NA,NA,"e07b9d6372f5b9719ff22ba8d64b136f5aabe538","2020-03-27T20:00:00Z",3,NA,2857,2857,2857,16,3,0,603,66,669
"1529",20200327,"IL",3026,18516,NA,NA,NA,NA,NA,NA,NA,NA,"65f47d4e133e84caba214c7a0efd4f69e51ceb5a","2020-03-27T20:00:00Z",34,NA,21542,21542,21542,17,8,0,4423,488,4911
"1530",20200327,"IN",981,5955,NA,NA,NA,NA,NA,NA,NA,NA,"3708ffb8604728a20d1032f73b6da67ee72ea866","2020-03-27T20:00:00Z",24,NA,6936,6936,6936,18,7,0,1949,336,2285
"1531",20200327,"KS",202,3229,NA,NA,27,NA,NA,NA,NA,NA,"00010abd938af813b268bdf5dfe70271ba5d42aa","2020-03-27T20:00:00Z",4,27,3431,3431,3431,20,1,27,360,34,394
"1532",20200327,"KY",248,3768,NA,NA,NA,NA,NA,NA,NA,NA,"c8caceb5970b63067f283dfe604e520e4034f198","2020-03-27T20:00:00Z",6,NA,4016,4016,4016,21,2,0,666,50,716
"1533",20200327,"LA",2746,18613,NA,773,NA,NA,NA,270,NA,NA,"82b631667fdd96fa61e4fc1733f03cc43182176b","2020-03-27T20:00:00Z",119,NA,21359,21359,21359,22,36,0,2889,441,3330
"1534",20200327,"MA",3240,26131,NA,NA,219,NA,NA,NA,NA,NA,"016484cf6143f06b89bdb98758e558945940304e","2020-03-27T20:00:00Z",35,219,29371,29371,29371,25,10,0,4927,823,5750
"1535",20200327,"MD",774,94,NA,NA,173,NA,NA,NA,NA,25,"0a28c9d4e27baa6cdf5626370be8d76e282880d6","2020-03-27T20:00:00Z",5,173,868,868,868,24,1,41,0,194,194
"1536",20200327,"ME",168,3394,NA,NA,NA,NA,NA,NA,NA,24,"7150d501b5d1f77e6ab73e054bb65b8ac1d6685b","2020-03-27T20:00:00Z",1,NA,3562,3562,3562,23,1,0,0,13,13
"1537",20200327,"MI",8659,12639,NA,NA,NA,NA,NA,NA,NA,NA,"8bc1808989463af326a28c9e670034c077877e70","2020-03-27T20:00:00Z",92,NA,21298,21298,21298,26,32,0,2334,892,3226
"1538",20200327,"MN",398,13605,NA,34,51,NA,17,NA,NA,180,"7c0b3f30124d18556eddb9a53cba26e8b144daca","2020-03-27T20:00:00Z",4,51,14003,14003,14003,27,2,10,1001,52,1053
"1539",20200327,"MO",669,369,NA,NA,NA,NA,NA,NA,NA,NA,"e164635689d048e1c9a7125b8b7fe42bd18dfd3d","2020-03-27T20:00:00Z",8,NA,1038,1038,1038,29,0,0,0,167,167
"1540",20200327,"MP",0,NA,NA,NA,NA,NA,NA,NA,NA,NA,"2f5f231a6bd383fd894c67af3b27dee189d2815e","2020-03-27T20:00:00Z",0,NA,0,0,0,69,0,0,0,0,0
"1541",20200327,"MS",579,2560,NA,NA,185,NA,NA,NA,NA,NA,"cb4ab3b814e5417a4015c0a7ae69eb7eaa092c9a","2020-03-27T20:00:00Z",8,185,3139,3139,3139,28,2,35,269,94,363
"1542",20200327,"MT",108,2590,NA,NA,7,NA,NA,NA,NA,NA,"80cf224382b2b613d31d3a1a3987b68e42389ca3","2020-03-27T20:00:00Z",NA,7,2698,2698,2698,30,0,6,462,37,499
"1543",20200327,"NC",763,14373,NA,77,NA,NA,NA,NA,NA,NA,"d165f85a12dbab90b0ab2cea143f8bb4f6907b29","2020-03-27T20:00:00Z",3,NA,15136,15136,15136,37,1,0,2099,127,2226
"1544",20200327,"ND",65,2427,NA,NA,13,NA,NA,NA,NA,15,"4211f51616b6afba9db6498b58fc90ab33be7172","2020-03-27T20:00:00Z",0,13,2492,2492,2492,38,0,3,388,13,401
"1545",20200327,"NE",85,1761,NA,NA,NA,NA,NA,NA,NA,NA,"64cd084ae1882a6e72f9f4b3908fd89881bb007f","2020-03-27T20:00:00Z",0,NA,1846,1846,1846,31,0,0,177,12,189
"1546",20200327,"NH",158,3395,592,NA,25,NA,NA,NA,NA,NA,"a82fcad4f7253fef19c71e71f7f2429e17e1c1a7","2020-03-27T20:00:00Z",1,25,4145,3553,3553,33,0,6,394,21,415
"1547",20200327,"NJ",8825,16547,NA,2000,NA,NA,NA,NA,NA,NA,"97947965fc4783e404b2b3f653e188ca13eedfdc","2020-03-27T20:00:00Z",108,NA,25372,25372,25372,34,27,0,2886,1949,4835
"1548",20200327,"NM",136,8377,NA,NA,NA,NA,NA,NA,NA,NA,"a96718b15dd4f8b2bf0aa0cf64145d513d35f6e6","2020-03-27T20:00:00Z",1,NA,8513,8513,8513,35,0,0,696,24,720
"1549",20200327,"NV",535,6161,NA,NA,NA,NA,NA,NA,NA,NA,"c45254e1c7f4cc7635c3cc42cc996a47b745d36c","2020-03-27T20:00:00Z",10,NA,6696,6696,6696,32,0,0,1464,115,1579
"1550",20200327,"NY",44635,101118,NA,6481,8526,1583,NA,NA,NA,2045,"e450c496d8e40791775087cd390d8f9ac5f298cd","2020-03-27T20:00:00Z",519,8526,145753,145753,145753,36,134,1682,16272,7377,23649
"1551",20200327,"OH",1137,19012,NA,NA,276,NA,107,NA,NA,NA,"775347bbd54dbd3e3235391c7d2d5eb4c87cab2c","2020-03-27T20:00:00Z",19,276,20149,20149,20149,39,4,53,2563,270,2833
"1552",20200327,"OK",322,1084,NA,NA,105,NA,NA,NA,NA,NA,"01208f5d22ac2638f9654bb25fdb4bbe426dd561","2020-03-27T20:00:00Z",8,105,1406,1406,1406,40,1,19,126,74,200
"1553",20200327,"OR",414,8510,NA,91,102,NA,NA,31,NA,NA,"41d09c4e184746901e91a26a1f302dde797b8058","2020-03-27T20:00:00Z",12,102,8924,8924,8924,41,1,12,1557,87,1644
"1554",20200327,"PA",2218,21016,NA,NA,241,NA,NA,NA,NA,NA,"e80400da9fd2c8e84d22566050fa2b705d7fdde0","2020-03-27T20:00:00Z",22,241,23234,23234,23234,42,6,241,4575,531,5106
"1555",20200327,"PR",79,519,334,NA,NA,NA,NA,NA,NA,NA,"aefe7a30d1464bfc9d4213163b6f4e311db5a14b","2020-03-27T20:00:00Z",3,NA,932,598,598,72,1,0,142,15,157
"1556",20200327,"RI",203,2306,138,28,NA,9,NA,6,NA,NA,"96f0e54cf6fb06d019b82a2ae42e7b9ed4ac1135","2020-03-27T20:00:00Z",NA,NA,2647,2509,2509,44,0,0,1044,38,1082
"1557",20200327,"SC",456,2307,NA,NA,109,NA,NA,NA,NA,NA,"eba42fa8d4d9d65fdf8d2aefb0cc7cf13e75ee31","2020-03-27T20:00:00Z",9,109,2763,2763,2763,45,0,0,0,0,0
"1558",20200327,"SD",58,2387,20,NA,NA,NA,NA,NA,NA,21,"5d1fd96fd9c93ab88a3ac21f0a7fb8314ab018ef","2020-03-27T20:00:00Z",1,NA,2465,2445,2445,46,0,0,414,12,426
"1559",20200327,"TN",1203,14888,NA,NA,103,NA,NA,NA,NA,NA,"c3a5af8cf2531b13791648be5b30584a9e811787","2020-03-27T20:00:00Z",6,103,16091,16091,16091,47,3,27,936,246,1182
"1560",20200327,"TX",1731,21935,NA,NA,NA,NA,NA,NA,NA,NA,"8409fedc70d96ce072fcd2c62d1101488f155d94","2020-03-27T20:00:00Z",23,NA,23666,23666,23666,48,5,0,1907,335,2242
"1561",20200327,"UT",480,8764,NA,NA,NA,NA,NA,NA,NA,NA,"59049455f72c15c38a8ad386ca6a601e271b4a6d","2020-03-27T20:00:00Z",2,NA,9244,9244,9244,49,1,0,1456,78,1534
"1562",20200327,"VA",604,6733,NA,NA,83,NA,NA,NA,NA,NA,"376dd9385db92b70861adb4e990699e2ae38ea4f","2020-03-27T20:00:00Z",14,83,7337,7337,7337,51,1,18,1004,144,1148
"1563",20200327,"VI",19,55,2,NA,NA,NA,NA,NA,NA,NA,"32ebeb6f98af6bf98f77c8511e2ec314bc5b8869","2020-03-27T20:00:00Z",NA,NA,76,74,74,78,0,0,0,2,2
"1564",20200327,"VT",184,2077,NA,NA,18,NA,NA,NA,NA,NA,"0064eda2b4b2bd74f386a29d0fa13b8378aff141","2020-03-27T20:00:00Z",10,18,2261,2261,2261,50,1,18,227,26,253
"1565",20200327,"WA",4280,43173,NA,NA,NA,NA,NA,NA,NA,NA,"083a03d9c9a6febff07c2c8acfffedbb719a56e5","2020-03-27T20:00:00Z",191,NA,47453,47453,47453,53,14,0,11461,479,11940
"1566",20200327,"WI",842,13140,NA,NA,NA,NA,NA,NA,NA,NA,"8c63c548c621e8d51f2c08c5e2e7a34947238262","2020-03-27T20:00:00Z",13,NA,13982,13982,13982,55,5,0,1557,135,1692
"1567",20200327,"WV",76,1779,43,NA,1,NA,NA,NA,NA,NA,"67ad4031bd5dd9dfb1b414880205d3698549469c","2020-03-27T20:00:00Z",0,1,1898,1855,1855,54,0,0,748,25,773
"1568",20200327,"WY",70,1211,NA,NA,11,NA,NA,NA,NA,17,"ece3b4c4bd5b7103d4e083be4a022cb425a1924f","2020-03-27T20:00:00Z",0,11,1281,1281,1281,56,0,11,159,17,176
"1569",20200326,"AK",59,1801,NA,NA,3,NA,NA,NA,NA,NA,"141c8e163d64a2762eb6ce6fab3863ab853929a4","2020-03-26T20:00:00Z",1,3,1860,1860,1860,2,0,2,152,17,169
"1570",20200326,"AL",506,3593,NA,NA,NA,NA,NA,NA,NA,NA,"fbb44aa6b758e39d9ca03edb761c2463bc6d09e7","2020-03-26T20:00:00Z",1,NA,4099,4099,4099,1,1,0,1064,223,1287
"1571",20200326,"AR",335,1504,NA,41,NA,NA,NA,13,NA,13,"b3807a88dfed74bba84ae7ae53bc48ae629efe67","2020-03-26T20:00:00Z",3,NA,1839,1839,1839,5,1,0,67,55,122
"1572",20200326,"AS",NA,NA,NA,NA,NA,NA,NA,NA,NA,NA,"0d9d160c81296656a218a2713654bbbae3d967a5","2020-03-26T20:00:00Z",0,NA,0,0,0,60,0,0,0,0,0
"1573",20200326,"AZ",577,347,33,NA,NA,NA,NA,NA,NA,NA,"fc2dfd68a669b464fea245b75014240abefeee52","2020-03-26T20:00:00Z",8,NA,957,924,924,4,2,0,24,127,151
"1574",20200326,"CA",3006,17380,57400,NA,NA,NA,NA,NA,NA,NA,"d073989819811eaa4edd1a4f71a3716c44b653ac","2020-03-26T20:00:00Z",65,NA,77786,20386,20386,6,12,0,1459,651,2110
"1575",20200326,"CO",1086,6978,NA,230,148,NA,NA,NA,NA,NA,"a1c2870d7b6a658d2e68fc29e800e75e1cda421f","2020-03-26T20:00:00Z",19,148,8064,8064,8064,8,8,64,189,174,363
"1576",20200326,"CT",1012,5625,NA,125,NA,NA,NA,NA,NA,NA,"1742b9a50eb648ea5cd758b44de2e4ded9b8bfcf","2020-03-26T20:00:00Z",21,NA,6637,6637,6637,9,2,0,602,137,739
"1577",20200326,"DC",231,1626,1,NA,NA,NA,NA,NA,NA,21,"be59e63006a0dcd465209f8d1b3097218f92f343","2020-03-26T20:00:00Z",3,NA,1858,1857,1857,11,1,0,203,48,251
"1578",20200326,"DE",130,36,NA,13,NA,NA,NA,NA,NA,4,"19405b8d3a5695178ede4bb185d23fa2eec6654d","2020-03-26T20:00:00Z",1,NA,166,166,166,10,1,0,0,15,15
"1579",20200326,"FL",2355,23741,1443,NA,406,NA,NA,NA,NA,NA,"1290ba6a489ffe158fa4333c279e73b7c728543e","2020-03-26T20:00:00Z",28,406,27539,26096,26096,12,6,90,8367,673,9040
"1580",20200326,"GA",1525,7401,NA,NA,473,NA,NA,NA,NA,NA,"5bd7f61bc12b4e207e0ceda50e5fe469273a6b44","2020-03-26T20:00:00Z",48,473,8926,8926,8926,13,8,79,2469,278,2747
"1581",20200326,"GU",45,263,NA,11,NA,NA,NA,NA,NA,NA,"d5ec60b36b329b943e899f07431485ec8ab96ea6","2020-03-26T20:00:00Z",1,NA,308,308,308,66,0,0,30,8,38
"1582",20200326,"HI",95,4357,NA,NA,5,NA,NA,NA,NA,NA,"cdbfa8c05d4138523b7bd76294518d1ef0dac898","2020-03-26T20:00:00Z",NA,5,4452,4452,4452,15,0,-1,0,5,5
"1583",20200326,"IA",179,2578,NA,31,46,NA,NA,NA,NA,15,"411e2fbdf3f70764fb24db7b34feb147bc2ecb13","2020-03-26T20:00:00Z",1,46,2757,2757,2757,19,0,10,0,34,34
"1584",20200326,"ID",123,2065,NA,NA,NA,NA,NA,NA,NA,NA,"accd7f2d4f84c66bb09e13ee9e72790b73ed7751","2020-03-26T20:00:00Z",0,NA,2188,2188,2188,16,0,0,178,50,228
"1585",20200326,"IL",2538,14093,NA,NA,NA,NA,NA,NA,NA,NA,"ede372266e78d0a0ceff08d95ac84932e0fcfc7d","2020-03-26T20:00:00Z",26,NA,16631,16631,16631,17,7,0,1749,673,2422
"1586",20200326,"IN",645,4006,NA,NA,NA,NA,NA,NA,NA,NA,"d09dec87fbea244ee83df1fb0d61288197978934","2020-03-26T20:00:00Z",17,NA,4651,4651,4651,18,3,0,1127,168,1295
"1587",20200326,"KS",168,2869,NA,NA,NA,NA,NA,NA,NA,NA,"aa2e17ec747401ff3e73105d0b833fa0b4f03d67","2020-03-26T20:00:00Z",3,NA,3037,3037,3037,20,0,0,509,42,551
"1588",20200326,"KY",198,3102,NA,NA,NA,NA,NA,NA,NA,NA,"3a82ab3456c2469d52b7790c96cb4cfa30f25cd5","2020-03-26T20:00:00Z",4,NA,3300,3300,3300,21,0,0,237,41,278
"1589",20200326,"LA",2305,15724,NA,676,NA,NA,NA,239,NA,NA,"ca5bdffed97943221ff58631ebd9789d4a5aa600","2020-03-26T20:00:00Z",83,NA,18029,18029,18029,22,18,0,6068,510,6578
"1590",20200326,"MA",2417,21204,NA,NA,219,NA,NA,NA,NA,NA,"83a4a37ff66f38e205b0b18839828d141802f5c1","2020-03-26T20:00:00Z",25,219,23621,23621,23621,25,10,116,3248,579,3827
"1591",20200326,"MD",580,94,NA,NA,132,NA,NA,NA,NA,NA,"871e46620cc8507563260a7f3a0336d8e426ab51","2020-03-26T20:00:00Z",4,132,674,674,674,24,0,132,0,157,157
"1592",20200326,"ME",155,3394,NA,NA,NA,NA,NA,NA,NA,16,"482e706965e1aaacc7b8f40547be7a63dbcb4b7d","2020-03-26T20:00:00Z",NA,NA,3549,3549,3549,23,0,0,217,6,223
"1593",20200326,"MI",7767,10305,NA,NA,NA,NA,NA,NA,NA,NA,"e1de57b6e220762fddb1d9ed686161ea23799666","2020-03-26T20:00:00Z",60,NA,18072,18072,18072,26,17,0,2768,707,3475
"1594",20200326,"MN",346,12604,NA,31,41,NA,NA,NA,NA,NA,"54abcd207865204ef3da6e8985ee95f798f94255","2020-03-26T20:00:00Z",2,41,12950,12950,12950,27,1,6,1416,59,1475
"1595",20200326,"MO",502,369,NA,NA,NA,NA,NA,NA,NA,NA,"5d322e752d7a1f4672917629e7702c7bc26a93f6","2020-03-26T20:00:00Z",8,NA,871,871,871,29,0,0,0,146,146
"1596",20200326,"MP",0,NA,NA,NA,NA,NA,NA,NA,NA,NA,"4f1e047c3e63f3349e4f7c617874492431c8a5f9","2020-03-26T20:00:00Z",0,NA,0,0,0,69,0,0,0,0,0
"1597",20200326,"MS",485,2291,NA,NA,150,NA,NA,NA,NA,NA,"20667611a63432824d0ff16867b5adc4c06b5936","2020-03-26T20:00:00Z",6,150,2776,2776,2776,28,4,33,725,108,833
"1598",20200326,"MT",71,2128,NA,NA,1,NA,NA,NA,NA,NA,"e7caf7619a1d9a6677a95d9d85eb24598221158d","2020-03-26T20:00:00Z",NA,1,2199,2199,2199,30,0,1,180,18,198
"1599",20200326,"NC",636,12274,NA,29,NA,NA,NA,NA,NA,NA,"384b4ce0619787f46136d144e17bc74618e69bad","2020-03-26T20:00:00Z",2,NA,12910,12910,12910,37,1,0,2289,132,2421
"1600",20200326,"ND",52,2039,NA,NA,10,NA,NA,NA,NA,NA,"e574ee98155f078e25da07dbc6404e23add90f9b","2020-03-26T20:00:00Z",0,10,2091,2091,2091,38,0,2,305,13,318
"1601",20200326,"NE",73,1584,NA,NA,NA,NA,NA,NA,NA,NA,"b1e3ffd00324b8a8500be3b3a4b0e378b57710b5","2020-03-26T20:00:00Z",0,NA,1657,1657,1657,31,0,0,280,12,292
"1602",20200326,"NH",137,3001,712,NA,19,NA,NA,NA,NA,NA,"a37cd44af5e89e3f36bcbc424c61162b18173e05","2020-03-26T20:00:00Z",1,19,3850,3138,3138,33,0,6,645,29,674
"1603",20200326,"NJ",6876,13661,NA,1080,NA,NA,NA,NA,NA,NA,"164bbcd99de9fa76ebb40894fd2d348c5e384d71","2020-03-26T20:00:00Z",81,NA,20537,20537,20537,34,19,0,3209,2474,5683
"1604",20200326,"NM",112,7681,NA,NA,NA,NA,NA,NA,NA,NA,"1e43be6fccfd53482152b6f0032c9f5380179480","2020-03-26T20:00:00Z",1,NA,7793,7793,7793,35,0,0,939,12,951
"1605",20200326,"NV",420,4697,NA,NA,NA,NA,NA,NA,NA,NA,"8439b92c8ef2ecd1b055e3ed1acbab7bedd90001","2020-03-26T20:00:00Z",10,NA,5117,5117,5117,32,4,0,446,99,545
"1606",20200326,"NY",37258,84846,NA,5327,6844,1290,NA,NA,NA,NA,"0058535329a967d92568319188616fcc3ddde2da","2020-03-26T20:00:00Z",385,6844,122104,122104,122104,36,100,3039,12178,6447,18625
"1607",20200326,"OH",867,16449,NA,NA,223,NA,91,NA,NA,NA,"ec54f23b722a56fc6cb60ec0603c774a574b1b58","2020-03-26T20:00:00Z",15,223,17316,17316,17316,39,5,41,2389,163,2552
"1608",20200326,"OK",248,958,NA,NA,86,NA,NA,NA,NA,NA,"6a5dd746a3fa2c1898256473098b5715589457c2","2020-03-26T20:00:00Z",7,86,1206,1206,1206,40,2,27,153,84,237
"1609",20200326,"OR",327,6953,NA,NA,90,NA,NA,NA,NA,NA,"ddb030ea072a2fe01a8d71d2a5a24e917d4e8ea2","2020-03-26T20:00:00Z",11,90,7280,7280,7280,41,3,29,2603,118,2721
"1610",20200326,"PA",1687,16441,NA,NA,NA,NA,NA,NA,NA,NA,"7712fd7f15f40e975c2a503bd7633edd4387df7e","2020-03-26T20:00:00Z",16,NA,18128,18128,18128,42,5,0,5248,560,5808
"1611",20200326,"PR",64,377,335,NA,NA,NA,NA,NA,NA,NA,"f0017006486c2085b91f1f75468f643da3153af8","2020-03-26T20:00:00Z",2,NA,776,441,441,72,0,0,60,13,73
"1612",20200326,"RI",165,1262,181,23,NA,9,NA,6,NA,NA,"a61cfb3d2f6c540ab418b7ebe42eee237687da77","2020-03-26T20:00:00Z",NA,NA,1608,1427,1427,44,0,0,0,33,33
"1613",20200326,"SC",456,2307,NA,NA,109,NA,NA,NA,NA,NA,"4c55b055bf2708a25455b71cdb3d6115453ed71c","2020-03-26T20:00:00Z",9,109,2763,2763,2763,45,2,7,4,32,36
"1614",20200326,"SD",46,1973,125,NA,NA,NA,NA,NA,NA,16,"279cd2d4767245d1841274ed2d19a0a4f5c9b673","2020-03-26T20:00:00Z",1,NA,2144,2019,2019,46,0,0,1154,5,1159
"1615",20200326,"TN",957,13952,NA,NA,76,NA,NA,NA,NA,NA,"d3ce5ed8216ba2c78107cb4d4ec9da1dd0b0f77f","2020-03-26T20:00:00Z",3,76,14909,14909,14909,47,0,23,2940,173,3113
"1616",20200326,"TX",1396,20028,NA,NA,NA,NA,NA,NA,NA,NA,"fa643c14dbc1c896f7d243f22f25aa05e563d6af","2020-03-26T20:00:00Z",18,NA,21424,21424,21424,48,6,0,7508,422,7930
"1617",20200326,"UT",402,7308,NA,NA,NA,NA,NA,NA,NA,NA,"dd83cffb270720784e9e520a6513c7c8f1ec68c5","2020-03-26T20:00:00Z",1,NA,7710,7710,7710,49,0,0,817,56,873
"1618",20200326,"VA",460,5729,NA,NA,65,NA,NA,NA,NA,NA,"60d151765c90a17f38487d1089ef283796e1c122","2020-03-26T20:00:00Z",13,65,6189,6189,6189,51,4,6,750,69,819
"1619",20200326,"VI",17,55,2,NA,NA,NA,NA,NA,NA,NA,"7387909f4f1f9ad32b038215b37dd6819ef2eb15","2020-03-26T20:00:00Z",NA,NA,74,72,72,78,0,0,0,0,0
"1620",20200326,"VT",158,1850,NA,NA,NA,NA,NA,NA,NA,NA,"994b0d80648160d62da49b803410ff385ef7f906","2020-03-26T20:00:00Z",9,NA,2008,2008,2008,50,1,0,261,35,296
"1621",20200326,"WA",3801,31712,NA,NA,NA,NA,NA,NA,NA,NA,"4f064aa22d43dc43aabe785d7d4e43ee9bd7e74c","2020-03-26T20:00:00Z",177,NA,35513,35513,35513,53,22,0,0,476,476
"1622",20200326,"WI",707,11583,NA,NA,NA,NA,NA,NA,NA,NA,"9683cfe2bd653af14dcfc375a493d40198712796","2020-03-26T20:00:00Z",8,NA,12290,12290,12290,55,1,0,1494,122,1616
"1623",20200326,"WV",51,1031,19,NA,1,NA,NA,NA,NA,NA,"ea32f587f060c45231c6013fa4924abbc339400a","2020-03-26T20:00:00Z",0,1,1101,1082,1082,54,0,0,272,12,284
"1624",20200326,"WY",53,1052,NA,NA,NA,NA,NA,NA,NA,12,"4fb67721dfe7158af2d510dc704638497f0a8359","2020-03-26T20:00:00Z",NA,NA,1105,1105,1105,56,0,0,98,9,107
"1625",20200325,"AK",42,1649,NA,NA,1,NA,NA,NA,NA,NA,"d0981dc0ff9e0b50793d2307ce11831905ea3c01","2020-03-25T20:00:00Z",1,1,1691,1691,1691,2,1,1,663,6,669
"1626",20200325,"AL",283,2529,NA,NA,NA,NA,NA,NA,NA,NA,"2f45607dc8271295dd36e91588d93ebaa1bc3110","2020-03-25T20:00:00Z",0,NA,2812,2812,2812,1,0,0,423,68,491
"1627",20200325,"AR",280,1437,NA,22,NA,NA,NA,4,NA,11,"a55c4c11c7faab713d2bd57c30acda12f8a79830","2020-03-25T20:00:00Z",2,NA,1717,1717,1717,5,2,0,490,62,552
"1628",20200325,"AS",NA,NA,NA,NA,NA,NA,NA,NA,NA,NA,"d12176b38413ba2e195f83b80e78bdf6dae954ec","2020-03-25T20:00:00Z",0,NA,0,0,0,60,0,0,0,0,0
"1629",20200325,"AZ",450,323,53,NA,NA,NA,NA,NA,NA,NA,"825d3e27cef83c2a2f4fd66b0ce710ea0cdd8340","2020-03-25T20:00:00Z",6,NA,826,773,773,4,1,0,10,93,103
"1630",20200325,"CA",2355,15921,48600,NA,NA,NA,NA,NA,NA,NA,"8d9cf944b6bf56c413644ce7729ef18efa3d75a0","2020-03-25T20:00:00Z",53,NA,66876,18276,18276,6,13,0,2469,253,2722
"1631",20200325,"CO",912,6789,NA,152,84,NA,NA,NA,NA,NA,"885c5f3d8965666c6728d14e4dd6adf737aa2076","2020-03-25T20:00:00Z",11,84,7701,7701,7701,8,4,12,1285,192,1477
"1632",20200325,"CT",875,5023,NA,113,NA,NA,NA,NA,NA,NA,"26bda0962bcd2c46918956f27804c62275c6be2d","2020-03-25T20:00:00Z",19,NA,5898,5898,5898,9,7,0,341,257,598
"1633",20200325,"DC",183,1423,3,NA,NA,NA,NA,NA,NA,NA,"4c94c1d06cba80ba6ca85bc5eb70dab16b46b6bf","2020-03-25T20:00:00Z",2,NA,1609,1606,1606,11,0,0,228,46,274
"1634",20200325,"DE",115,36,NA,11,NA,NA,NA,NA,NA,NA,"d451aedba3efc2662603737e82f38aed0fb267e2","2020-03-25T20:00:00Z",0,NA,151,151,151,10,0,0,0,24,24
"1635",20200325,"FL",1682,15374,1233,NA,316,NA,NA,NA,NA,NA,"3824a66b112cf25a03e7e1701dc1af01026bd711","2020-03-25T20:00:00Z",22,316,18289,17056,17056,12,4,57,2247,270,2517
"1636",20200325,"GA",1247,4932,NA,NA,394,NA,NA,NA,NA,NA,"0608d7952fefcad2df075352ee28eb32e13426be","2020-03-25T20:00:00Z",40,394,6179,6179,6179,13,8,394,474,221,695
"1637",20200325,"GU",37,233,NA,10,NA,NA,NA,NA,NA,NA,"68ef6bb52723460829502eba44a7ffe48e78388d","2020-03-25T20:00:00Z",1,NA,270,270,270,66,0,0,32,5,37
"1638",20200325,"HI",90,4357,NA,NA,6,NA,NA,NA,NA,NA,"9bb75dd30e325c6a18abe4a0b7efc5abf0c2ef57","2020-03-25T20:00:00Z",NA,6,4447,4447,4447,15,0,2,768,13,781
"1639",20200325,"IA",145,2578,NA,23,36,NA,NA,NA,NA,NA,"13d8e16121979021bb57103d7b961e31b3dfee2e","2020-03-25T20:00:00Z",1,36,2723,2723,2723,19,1,9,263,21,284
"1640",20200325,"ID",73,1887,NA,NA,NA,NA,NA,NA,NA,NA,"a4fa527e00632ae29efb14c92c81b06642e554cb","2020-03-25T20:00:00Z",0,NA,1960,1960,1960,16,0,0,0,23,23
"1641",20200325,"IL",1865,12344,NA,NA,NA,NA,NA,NA,NA,NA,"de4c69056480e6111af2b8aeb434f5f8d597b170","2020-03-25T20:00:00Z",19,NA,14209,14209,14209,17,3,0,2410,330,2740
"1642",20200325,"IN",477,2879,NA,NA,1,NA,NA,NA,NA,NA,"1a6af9e7ccb688e3321a736a824bb1fe799b7ef8","2020-03-25T20:00:00Z",14,1,3356,3356,3356,18,2,0,313,112,425
"1643",20200325,"KS",126,2360,NA,NA,NA,NA,NA,NA,NA,NA,"deae962902c0a2fb252f981aaba83eda616d6029","2020-03-25T20:00:00Z",3,NA,2486,2486,2486,20,1,0,274,28,302
"1644",20200325,"KY",157,2865,NA,NA,NA,NA,NA,NA,NA,NA,"8fc7de737c41520c298dcbceba279e065ddceeb7","2020-03-25T20:00:00Z",4,NA,3022,3022,3022,21,0,0,1103,33,1136
"1645",20200325,"LA",1795,9656,NA,491,NA,NA,NA,163,NA,NA,"f8bc75603abe9cb7b1b17b37196513f9f0916e82","2020-03-25T20:00:00Z",65,NA,11451,11451,11451,22,19,0,2441,407,2848
"1646",20200325,"MA",1838,17956,NA,NA,103,NA,NA,NA,NA,NA,"95bb4fdcf8938f1681915e4ab6cd29914ed60b24","2020-03-25T20:00:00Z",15,103,19794,19794,19794,25,4,9,5366,679,6045
"1647",20200325,"MD",423,94,NA,NA,NA,NA,NA,NA,NA,NA,"ef79567177f07f1f10279b6a4bbb1326684bbd00","2020-03-25T20:00:00Z",4,NA,517,517,517,24,1,0,0,74,74
"1648",20200325,"ME",149,3177,NA,NA,NA,NA,NA,NA,NA,7,"6a21285c01dfd9378d220175d14dc3a772dfe3fe","2020-03-25T20:00:00Z",NA,NA,3326,3326,3326,23,0,0,163,24,187
"1649",20200325,"MI",7060,7537,NA,NA,NA,NA,NA,NA,NA,NA,"8caeeec0387cf6fe763f8215ab7d28c56c8ad0a7","2020-03-25T20:00:00Z",43,NA,14597,14597,14597,26,19,0,1741,619,2360
"1650",20200325,"MN",287,11188,NA,26,35,NA,NA,NA,NA,122,"0901433ad4b755a7fa7bf999a5d1cb967f3b843e","2020-03-25T20:00:00Z",1,35,11475,11475,11475,27,0,14,5638,25,5663
"1651",20200325,"MO",356,369,NA,NA,NA,NA,NA,NA,NA,NA,"f7ac8ac4376125f549f2d3237af885e7effab1b5","2020-03-25T20:00:00Z",8,NA,725,725,725,29,5,0,0,173,173
"1652",20200325,"MP",0,NA,NA,NA,NA,NA,NA,NA,NA,NA,"2412f6b612ee38dd778455fcf069651b33a164a0","2020-03-25T20:00:00Z",0,NA,0,0,0,69,0,0,0,0,0
"1653",20200325,"MS",377,1566,NA,NA,117,NA,NA,NA,NA,NA,"9968fd3d3074b5b25f4930d48c5c7269f0a83495","2020-03-25T20:00:00Z",2,117,1943,1943,1943,28,1,31,14,57,71
"1654",20200325,"MT",53,1948,NA,NA,NA,NA,NA,NA,NA,NA,"25cdd51b3866c8760da24735f8c0b495d8ea371c","2020-03-25T20:00:00Z",NA,NA,2001,2001,2001,30,0,0,305,7,312
"1655",20200325,"NC",504,9985,NA,29,NA,NA,NA,NA,NA,NA,"ee6173b3a7357aaa26da71326ded7a234fa338c1","2020-03-25T20:00:00Z",1,NA,10489,10489,10489,37,1,0,1844,106,1950
"1656",20200325,"ND",39,1734,NA,NA,8,NA,NA,NA,NA,NA,"6c0feae4a6bfd4cf279d43da9bed66faff769fa4","2020-03-25T20:00:00Z",0,8,1773,1773,1773,38,0,3,280,5,285
"1657",20200325,"NE",61,1304,NA,NA,NA,NA,NA,NA,NA,NA,"72bc397b422f829aa332430ba9e018a98aec8427","2020-03-25T20:00:00Z",0,NA,1365,1365,1365,31,0,0,329,9,338
"1658",20200325,"NH",108,2356,804,NA,13,NA,NA,NA,NA,NA,"ba894271c0369b91572e02c61dbe15afd68c146b","2020-03-25T20:00:00Z",1,13,3268,2464,2464,33,0,2,909,7,916
"1659",20200325,"NJ",4402,10452,NA,NA,NA,NA,NA,NA,NA,NA,"db32961abdc494e4610cb9201238755c5dbe9c9d","2020-03-25T20:00:00Z",62,NA,14854,14854,14854,34,18,0,2127,727,2854
"1660",20200325,"NM",100,6742,NA,NA,NA,NA,NA,NA,NA,NA,"b1128704739dbdde58897b48092a9f580fa1ee73","2020-03-25T20:00:00Z",1,NA,6842,6842,6842,35,1,0,852,17,869
"1661",20200325,"NV",321,4251,NA,NA,NA,NA,NA,NA,NA,NA,"527559709b16a14d2f376fb0df0c1c90150a4399","2020-03-25T20:00:00Z",6,NA,4572,4572,4572,32,2,0,297,43,340
"1662",20200325,"NY",30811,72668,NA,NA,3805,NA,NA,NA,NA,NA,"332b18596170cd3e35617cfba48a5723aa2ec8f3","2020-03-25T20:00:00Z",285,3805,103479,103479,103479,36,75,571,7063,5146,12209
"1663",20200325,"OH",704,14060,NA,NA,182,NA,74,NA,NA,NA,"37f081a41326a68ac5070d7ed52344f4839699b4","2020-03-25T20:00:00Z",10,182,14764,14764,14764,39,2,37,13920,140,14060
"1664",20200325,"OK",164,805,NA,NA,59,NA,NA,NA,NA,NA,"0a9c58ed26188df9e615374204dca8c4e9bded41","2020-03-25T20:00:00Z",5,59,969,969,969,40,2,34,70,58,128
"1665",20200325,"OR",209,4350,NA,NA,61,NA,NA,NA,NA,NA,"5a3e8848f9b6371e0c31274fd62117c40f06a0a3","2020-03-25T20:00:00Z",8,61,4559,4559,4559,41,0,0,0,0,0
"1666",20200325,"PA",1127,11193,NA,NA,NA,NA,NA,NA,NA,NA,"a04cdbf57ddbd0c489b48882295db9559fb037b5","2020-03-25T20:00:00Z",11,NA,12320,12320,12320,42,4,0,2550,276,2826
"1667",20200325,"PR",51,317,70,NA,NA,NA,NA,NA,NA,NA,"a29866b5ad6a6ac14b8d352af3b9af315c1f1c63","2020-03-25T20:00:00Z",2,NA,438,368,368,72,0,0,49,12,61
"1668",20200325,"RI",132,1262,196,15,NA,NA,NA,NA,NA,NA,"375952097e60875f852b8b4afdec4b37e5e1872e","2020-03-25T20:00:00Z",NA,NA,1590,1394,1394,44,0,0,62,8,70
"1669",20200325,"SC",424,2303,NA,NA,102,NA,NA,NA,NA,NA,"eee95db6f47c1427fd6e5482cf0deeced90a8f05","2020-03-25T20:00:00Z",7,102,2727,2727,2727,45,2,102,291,126,417
"1670",20200325,"SD",41,819,268,NA,NA,NA,NA,NA,NA,NA,"26eb16cec32ca8e58e78f3faa6b2bf73b60aeecc","2020-03-25T20:00:00Z",1,NA,1128,860,860,46,0,0,29,11,40
"1671",20200325,"TN",784,11012,NA,NA,53,NA,NA,NA,NA,NA,"99bf1065223280d5519a05c0f2363f77244d41a9","2020-03-25T20:00:00Z",3,53,11796,11796,11796,47,1,53,495,117,612
"1672",20200325,"TX",974,12520,NA,NA,NA,NA,NA,NA,NA,NA,"94d22076ee33e8232bf343c6e7cb48853cad8083","2020-03-25T20:00:00Z",12,NA,13494,13494,13494,48,3,0,1763,564,2327
"1673",20200325,"UT",346,6491,NA,NA,NA,NA,NA,NA,NA,NA,"0edf4fe386389c4acf4c834fa913fa86ba48669b","2020-03-25T20:00:00Z",1,NA,6837,6837,6837,49,0,0,967,47,1014
"1674",20200325,"VA",391,4979,NA,NA,59,NA,NA,NA,NA,NA,"f6276b380e5e6e9a92435116b52b41ae24db94df","2020-03-25T20:00:00Z",9,59,5370,5370,5370,51,2,14,799,101,900
"1675",20200325,"VI",17,55,2,NA,NA,NA,NA,NA,NA,NA,"ef607d6eacdb14ebba28bb521e766e6bbbd21a77","2020-03-25T20:00:00Z",NA,NA,74,72,72,78,0,0,55,0,55
"1676",20200325,"VT",123,1589,NA,NA,NA,NA,NA,NA,NA,NA,"007aa638edad042e4ae3bc4e7d899f62b3d3ffee","2020-03-25T20:00:00Z",8,NA,1712,1712,1712,50,1,0,149,28,177
"1677",20200325,"WA",3325,31712,NA,NA,NA,NA,NA,NA,NA,NA,"92feca03fcaf0015ee1cf7218904f6803401dffc","2020-03-25T20:00:00Z",155,NA,35037,35037,35037,53,13,0,0,457,457
"1678",20200325,"WI",585,10089,NA,NA,NA,NA,NA,NA,NA,NA,"990d1cee0a0325690dd1ddb866cc2ec4d457130a","2020-03-25T20:00:00Z",7,NA,10674,10674,10674,55,2,0,1852,128,1980
"1679",20200325,"WV",39,759,6,NA,1,NA,NA,NA,NA,NA,"e23f509ba05bca7c485e27672c0beea77f7608e7","2020-03-25T20:00:00Z",0,1,804,798,798,54,0,0,149,19,168
"1680",20200325,"WY",44,954,NA,NA,NA,NA,NA,NA,NA,7,"9eeedd6bac08a0fa82e127b99fd62ab414a2f690","2020-03-25T20:00:00Z",NA,NA,998,998,998,56,0,0,244,15,259
"1681",20200324,"AK",36,986,NA,NA,0,NA,NA,NA,NA,NA,"08ee797011e15cf7528034c8de823ae36dcc4164","2020-03-24T20:00:00Z",0,0,1022,1022,1022,2,0,0,40,14,54
"1682",20200324,"AL",215,2106,NA,NA,NA,NA,NA,NA,NA,NA,"c212a8468e01e67b91f78d053b0440276641d84f","2020-03-24T20:00:00Z",0,NA,2321,2321,2321,1,0,0,441,48,489
"1683",20200324,"AR",218,947,NA,22,NA,NA,NA,NA,NA,NA,"d8534a438538284a464f1162c4502b3b09e3d903","2020-03-24T20:00:00Z",0,NA,1165,1165,1165,5,0,0,41,44,85
"1684",20200324,"AS",NA,NA,NA,NA,NA,NA,NA,NA,NA,NA,"6be3aad6eae6ca42ef1d4cf38e24ab40cf817ce1","2020-03-24T20:00:00Z",0,NA,0,0,0,60,0,0,0,0,0
"1685",20200324,"AZ",357,313,22,NA,NA,NA,NA,NA,NA,NA,"e5040b6755e38071fb65133e5ff2fb1d49b41c70","2020-03-24T20:00:00Z",5,NA,692,670,670,4,3,0,4,92,96
"1686",20200324,"CA",2102,13452,12100,NA,NA,NA,NA,NA,NA,NA,"de4019ee1e7e99d093947ecd2a91c6093439f221","2020-03-24T20:00:00Z",40,NA,27654,15554,15554,6,13,0,885,369,1254
"1687",20200324,"CO",720,5504,NA,116,72,NA,NA,NA,NA,NA,"58e00f78f651ee87b7972b5186f98b000a969926","2020-03-24T20:00:00Z",7,72,6224,6224,6224,8,1,14,659,129,788
"1688",20200324,"CT",618,4682,NA,71,NA,NA,NA,NA,NA,NA,"0029ca1528305bb39b465eaadfee22f7cc558888","2020-03-24T20:00:00Z",12,NA,5300,5300,5300,9,2,0,597,203,800
"1689",20200324,"DC",137,1195,2,NA,NA,NA,NA,NA,NA,NA,"b0e3891c7034fd64b2031778208ec8934a5f2ddf","2020-03-24T20:00:00Z",2,NA,1334,1332,1332,11,0,0,82,21,103
"1690",20200324,"DE",91,36,NA,NA,NA,NA,NA,NA,NA,NA,"87f8b0a23f5fb9719ce50fb40b83be4b7fd9b03b","2020-03-24T20:00:00Z",0,NA,127,127,127,10,0,0,0,23,23
"1691",20200324,"FL",1412,13127,1008,NA,259,NA,NA,NA,NA,NA,"01f224778b595c53a53b114c66966c5987214220","2020-03-24T20:00:00Z",18,259,15547,14539,14539,12,4,42,2064,241,2305
"1692",20200324,"GA",1026,4458,NA,NA,NA,NA,NA,NA,NA,NA,"837865a88d570829d28bd06b24a4d97e5e901ddb","2020-03-24T20:00:00Z",32,NA,5484,5484,5484,13,7,0,161,254,415
"1693",20200324,"GU",32,201,NA,5,NA,NA,NA,NA,NA,NA,"277343684f9e9751ef5a043c295d7c4da955a35e","2020-03-24T20:00:00Z",1,NA,233,233,233,66,0,0,40,3,43
"1694",20200324,"HI",77,3589,NA,NA,4,NA,NA,NA,NA,NA,"c8688910d03a46dcdec0bba2338d32b386e8e7af","2020-03-24T20:00:00Z",NA,4,3666,3666,3666,15,0,4,634,21,655
"1695",20200324,"IA",124,2315,NA,NA,27,NA,NA,NA,NA,NA,"7cc0fd2b921b97c1bfacb447011ac898b4781078","2020-03-24T20:00:00Z",NA,27,2439,2439,2439,19,0,27,272,19,291
"1696",20200324,"ID",50,1887,NA,NA,NA,NA,NA,NA,NA,NA,"027fc25af7fa5b80a0a2d8e1f588710a5a0b223f","2020-03-24T20:00:00Z",0,NA,1937,1937,1937,16,0,0,578,3,581
"1697",20200324,"IL",1535,9934,NA,NA,NA,NA,NA,NA,NA,NA,"9c757789b4681fc36efffd962d3e75fb4ee6374f","2020-03-24T20:00:00Z",16,NA,11469,11469,11469,17,4,0,1351,262,1613
"1698",20200324,"IN",365,2566,NA,NA,1,NA,NA,NA,NA,NA,"d20aff6badc212807b7cd5db58fc6d2b08795e49","2020-03-24T20:00:00Z",12,1,2931,2931,2931,18,5,0,865,106,971
"1699",20200324,"KS",98,2086,NA,NA,NA,NA,NA,NA,NA,NA,"282cc098a42c426e6cf2f9a0d3fcff306bfe1547","2020-03-24T20:00:00Z",2,NA,2184,2184,2184,20,0,0,1669,16,1685
"1700",20200324,"KY",124,1762,NA,NA,NA,NA,NA,NA,NA,NA,"7f736e70b653bb755683c7b68cb76e5e19b363de","2020-03-24T20:00:00Z",4,NA,1886,1886,1886,21,1,0,0,20,20
"1701",20200324,"LA",1388,7215,NA,271,NA,NA,NA,NA,NA,NA,"ae625456c944c9cff54c9690466a68e937f61f64","2020-03-24T20:00:00Z",46,NA,8603,8603,8603,22,12,0,2439,216,2655
"1702",20200324,"MA",1159,12590,NA,NA,94,NA,NA,NA,NA,NA,"7dba190b6c130ef5b8427912adbcf550a3e63368","2020-03-24T20:00:00Z",11,94,13749,13749,13749,25,2,15,4445,382,4827
"1703",20200324,"MD",349,94,NA,NA,NA,NA,NA,NA,NA,NA,"266357ae1f44a606612441a5a7418a525dda2e4b","2020-03-24T20:00:00Z",3,NA,443,443,443,24,0,0,0,61,61
"1704",20200324,"ME",125,3014,NA,NA,NA,NA,NA,NA,NA,NA,"9f0c2d2a6bfd36968270dd1dce4ecdfcb0e894bd","2020-03-24T20:00:00Z",NA,NA,3139,3139,3139,23,0,0,223,18,241
"1705",20200324,"MI",6441,5796,NA,NA,NA,NA,NA,NA,NA,NA,"66254caf8469cb1c8d0754f0db17253a5d906c37","2020-03-24T20:00:00Z",24,NA,12237,12237,12237,26,9,0,1099,652,1751
"1706",20200324,"MN",262,5550,NA,NA,21,NA,NA,NA,NA,NA,"4359be22f1d018582c52f57f0005ecd6da7e3697","2020-03-24T20:00:00Z",1,21,5812,5812,5812,27,0,4,1039,27,1066
"1707",20200324,"MO",183,369,NA,NA,NA,NA,NA,NA,NA,NA,"9e947531084071a07ed377efd8d57dac769fed9f","2020-03-24T20:00:00Z",3,NA,552,552,552,29,0,0,0,0,0
"1708",20200324,"MP",0,NA,NA,NA,NA,NA,NA,NA,NA,NA,"52d83ea3d9e40fdcb085782a62b7e421b38959eb","2020-03-24T20:00:00Z",0,NA,0,0,0,69,0,0,0,0,0
"1709",20200324,"MS",320,1552,NA,NA,86,NA,NA,NA,NA,NA,"4b6d159c684e2e8f23fc95e94397d786890afbd4","2020-03-24T20:00:00Z",1,86,1872,1872,1872,28,0,53,409,71,480
"1710",20200324,"MT",46,1643,NA,NA,NA,NA,NA,NA,NA,NA,"fc865b228236789c9beaaf57416291a8b341f1ed","2020-03-24T20:00:00Z",NA,NA,1689,1689,1689,30,0,0,497,12,509
"1711",20200324,"NC",398,8141,NA,NA,NA,NA,NA,NA,NA,NA,"48a75030e4fdc67a802eb4afde3e104c229b4eca","2020-03-24T20:00:00Z",0,NA,8539,8539,8539,37,0,0,0,101,101
"1712",20200324,"ND",34,1454,NA,NA,5,NA,NA,NA,NA,NA,"4e468d07760eca0f47732febc8a8afab1800febe","2020-03-24T20:00:00Z",0,5,1488,1488,1488,38,0,1,101,4,105
"1713",20200324,"NE",52,975,NA,NA,NA,NA,NA,NA,NA,NA,"8b9d1afc73a62509d249a7f707364e01b05db6b1","2020-03-24T20:00:00Z",0,NA,1027,1027,1027,31,0,0,619,2,621
"1714",20200324,"NH",101,1447,869,NA,11,NA,NA,NA,NA,NA,"eb6013bb5115cbbe92d9b4d3830dd1fc8f64c164","2020-03-24T20:00:00Z",1,11,2417,1548,1548,33,1,11,73,23,96
"1715",20200324,"NJ",3675,8325,45,NA,NA,NA,NA,NA,NA,NA,"3298b6676fb93503cc4695dfd502db188db72854","2020-03-24T20:00:00Z",44,NA,12045,12000,12000,34,17,0,7966,831,8797
"1716",20200324,"NM",83,5890,NA,NA,NA,NA,NA,NA,NA,NA,"01ee7963abb7aa5321d1d1ea06baaad72fc05588","2020-03-24T20:00:00Z",NA,NA,5973,5973,5973,35,0,0,569,18,587
"1717",20200324,"NV",278,3954,NA,NA,NA,NA,NA,NA,NA,NA,"7850dc16931857b0e4f9b31620513a89c7ce8cda","2020-03-24T20:00:00Z",4,NA,4232,4232,4232,32,0,0,464,33,497
"1718",20200324,"NY",25665,65605,NA,NA,3234,NA,NA,NA,NA,NA,"ea3323c8187b8ff5574d3576f83791e01dd1521f","2020-03-24T20:00:00Z",210,3234,91270,91270,91270,36,96,599,8191,4790,12981
"1719",20200324,"OH",564,140,NA,NA,145,NA,NA,NA,NA,NA,"63b5a22304ed473e83bfbf270a76c1032acea29e","2020-03-24T20:00:00Z",8,145,704,704,704,39,2,41,0,122,122
"1720",20200324,"OK",106,735,NA,NA,25,NA,NA,NA,NA,NA,"6f7920a3fbf6e8734988631827d4e088b3e392e1","2020-03-24T20:00:00Z",3,25,841,841,841,40,1,10,41,25,66
"1721",20200324,"OR",209,4350,NA,NA,61,NA,NA,NA,NA,NA,"48f6f90138b010e86974032f5c2c2831e7fb4a75","2020-03-24T20:00:00Z",8,61,4559,4559,4559,41,3,5,701,18,719
"1722",20200324,"PA",851,8643,NA,NA,NA,NA,NA,NA,NA,NA,"ce0a280d338c6cb38fc09e23260c4a9d36b61a64","2020-03-24T20:00:00Z",7,NA,9494,9494,9494,42,1,0,2048,207,2255
"1723",20200324,"PR",39,268,42,NA,NA,NA,NA,NA,NA,NA,"a4422b62864b4880eb9b5ca60650238cb712aae5","2020-03-24T20:00:00Z",2,NA,349,307,307,72,0,0,79,8,87
"1724",20200324,"RI",124,1200,77,NA,NA,NA,NA,NA,NA,NA,"83b358e9dcb98725c3bf61a3b2beb27af76f6c0c","2020-03-24T20:00:00Z",NA,NA,1401,1324,1324,44,0,0,57,18,75
"1725",20200324,"SC",298,2012,NA,NA,NA,NA,NA,NA,NA,NA,"3ee6b47e4fe208a1a7422880f344f3f32f67679b","2020-03-24T20:00:00Z",5,NA,2310,2310,2310,45,0,0,546,0,546
"1726",20200324,"SD",30,790,268,NA,NA,NA,NA,NA,NA,NA,"f1b660e61e0b8a627c426d7b62a346a72b2e7797","2020-03-24T20:00:00Z",1,NA,1088,820,820,46,0,0,28,2,30
"1727",20200324,"TN",667,10517,NA,NA,NA,NA,NA,NA,NA,NA,"4c9bb8e4a36f22b926ee84af65928e341d4fef89","2020-03-24T20:00:00Z",2,NA,11184,11184,11184,47,0,0,7245,52,7297
"1728",20200324,"TX",410,10757,NA,NA,NA,NA,NA,NA,NA,NA,"f004eb8a9503c7e97a5fc6cd7c6d33278d7a4305","2020-03-24T20:00:00Z",9,NA,11167,11167,11167,48,1,0,1054,58,1112
"1729",20200324,"UT",299,5524,NA,NA,NA,NA,NA,NA,NA,NA,"ded18a05ae98e3a2dd796af47b0463703d38fd1e","2020-03-24T20:00:00Z",1,NA,5823,5823,5823,49,0,0,734,42,776
"1730",20200324,"VA",290,4180,NA,NA,45,NA,NA,NA,NA,NA,"c50739256e2bff651beb24c7d3bf783301d228bd","2020-03-24T20:00:00Z",7,45,4470,4470,4470,51,1,7,737,36,773
"1731",20200324,"VI",17,NA,NA,NA,NA,NA,NA,NA,NA,NA,"43ac7cddd17387c1b7958570250a1d74710ce525","2020-03-24T20:00:00Z",NA,NA,17,17,17,78,0,0,0,0,0
"1732",20200324,"VT",95,1440,NA,NA,NA,NA,NA,NA,NA,NA,"a0057043daf21cd5b60d9e10d5109d9aa2dbb574","2020-03-24T20:00:00Z",7,NA,1535,1535,1535,50,2,0,334,20,354
"1733",20200324,"WA",2868,31712,NA,NA,NA,NA,NA,NA,NA,NA,"2084b35bdf05790a9c3c86cd4c0f4b41f1f0916e","2020-03-24T20:00:00Z",142,NA,34580,34580,34580,53,9,0,2833,379,3212
"1734",20200324,"WI",457,8237,NA,NA,NA,NA,NA,NA,NA,NA,"f3b3b8071eeb99db0f8a0ba361cffbf1d17aa843","2020-03-24T20:00:00Z",5,NA,8694,8694,8694,55,0,0,1187,41,1228
"1735",20200324,"WV",20,610,0,NA,1,NA,NA,NA,NA,NA,"b1e8c04bf831d17f0262bc42ab7656b32f937f44","2020-03-24T20:00:00Z",0,1,630,630,630,54,0,0,166,4,170
"1736",20200324,"WY",29,710,NA,NA,NA,NA,NA,NA,NA,NA,"98459e884507e1d53a1bdd0bc4cb1ab9ccd26ffc","2020-03-24T20:00:00Z",NA,NA,739,739,739,56,0,0,118,3,121
"1737",20200323,"AK",22,946,NA,NA,0,NA,NA,NA,NA,NA,"476e17c6b73b3b5062fe1e1dba6f79e2dd1500f3","2020-03-23T20:00:00Z",0,0,968,968,968,2,0,0,0,0,0
"1738",20200323,"AL",167,1665,NA,NA,NA,NA,NA,NA,NA,NA,"83712877a917de925fb93de8aaa8443850e13f5e","2020-03-23T20:00:00Z",0,NA,1832,1832,1832,1,0,0,201,29,230
"1739",20200323,"AR",174,906,NA,13,NA,NA,NA,NA,NA,NA,"71896654761ce8d7ad037266afe060c7c3aca297","2020-03-23T20:00:00Z",0,NA,1080,1080,1080,5,0,0,195,9,204
"1740",20200323,"AS",NA,NA,NA,NA,NA,NA,NA,NA,NA,NA,"90a046f9acb7ff5dfa0d4311a5b944b5103ab579","2020-03-23T20:00:00Z",0,NA,0,0,0,60,0,0,0,0,0
"1741",20200323,"AZ",265,309,6,NA,NA,NA,NA,NA,NA,NA,"14d6aadf353c2d7f46fa679d1eef562ab766560e","2020-03-23T20:00:00Z",2,NA,580,574,574,4,0,0,27,113,140
"1742",20200323,"CA",1733,12567,12100,NA,NA,NA,NA,NA,NA,NA,"71c982ee815f7305f8cc4c93014774584620fa5f","2020-03-23T20:00:00Z",27,NA,26400,14300,14300,6,0,0,1263,197,1460
"1743",20200323,"CO",591,4845,NA,74,58,NA,NA,NA,NA,NA,"6ed9e7b28dc4485bafe179736fb6e52983f505d3","2020-03-23T20:00:00Z",6,58,5436,5436,5436,8,1,9,770,116,886
"1744",20200323,"CT",415,4085,NA,54,NA,NA,NA,NA,NA,NA,"d805e0c66ee0456c42148c9494eba857b18aec51","2020-03-23T20:00:00Z",10,NA,4500,4500,4500,9,5,0,1208,192,1400
"1745",20200323,"DC",116,1113,NA,NA,NA,NA,NA,NA,NA,NA,"a4ac9750469218e985257eae6f8bf345a38e2e94","2020-03-23T20:00:00Z",2,NA,1229,1229,1229,11,1,0,156,18,174
"1746",20200323,"DE",68,36,NA,NA,NA,NA,NA,NA,NA,NA,"ccdc7a3c1ce545efc42901ab13fd6f7add956503","2020-03-23T20:00:00Z",0,NA,104,104,104,10,0,0,0,12,12
"1747",20200323,"FL",1171,11063,860,NA,217,NA,NA,NA,NA,NA,"fefea265e78e4106c70c1907bee630dd8b5d76ad","2020-03-23T20:00:00Z",14,217,13094,12234,12234,12,1,32,3073,341,3414
"1748",20200323,"GA",772,4297,NA,NA,NA,NA,NA,NA,NA,NA,"0f7832c9c3f96874233ce85032ac2f2d78f66eb8","2020-03-23T20:00:00Z",25,NA,5069,5069,5069,13,2,0,877,172,1049
"1749",20200323,"GU",29,161,NA,NA,NA,NA,NA,NA,NA,NA,"ce31ff4a54165054ac6f5f94f5fe0f449c7fa847","2020-03-23T20:00:00Z",1,NA,190,190,190,66,0,0,35,2,37
"1750",20200323,"HI",56,2955,NA,NA,NA,NA,NA,NA,NA,NA,"a64b1c79f254b53625563c06841dd934ec71c54b","2020-03-23T20:00:00Z",NA,NA,3011,3011,3011,15,0,0,2692,8,2700
"1751",20200323,"IA",105,2043,NA,NA,NA,NA,NA,NA,NA,NA,"e300223bdb614731413a2a2689d16cd9d67b28be","2020-03-23T20:00:00Z",NA,NA,2148,2148,2148,19,0,0,828,15,843
"1752",20200323,"ID",47,1309,NA,NA,NA,NA,NA,NA,NA,NA,"671c3f6d3a73ffe687fb7f61e9f4ee48557c2217","2020-03-23T20:00:00Z",0,NA,1356,1356,1356,16,0,0,134,5,139
"1753",20200323,"IL",1273,8583,NA,NA,NA,NA,NA,NA,NA,NA,"0d6671c3e7d63029f51e664df09115c8458b7875","2020-03-23T20:00:00Z",12,NA,9856,9856,9856,17,3,0,1312,224,1536
"1754",20200323,"IN",259,1701,NA,NA,1,NA,NA,NA,NA,NA,"b98a92f68b8f40cdb0f7aac19be6caeff46c5480","2020-03-23T20:00:00Z",7,1,1960,1960,1960,18,1,0,408,58,466
"1755",20200323,"KS",82,417,NA,NA,NA,NA,NA,NA,NA,NA,"3e1f376103afb2bf2e72cbfb075ca706098eecda","2020-03-23T20:00:00Z",2,NA,499,499,499,20,0,0,0,18,18
"1756",20200323,"KY",104,1762,NA,NA,NA,NA,NA,NA,NA,NA,"1da5d1dc8e4c52e1ff55eb3170d02ea0200a4cb0","2020-03-23T20:00:00Z",3,NA,1866,1866,1866,21,0,0,290,5,295
"1757",20200323,"LA",1172,4776,NA,NA,NA,NA,NA,NA,NA,NA,"fd499be556bb029c4bc349ac19373d9ba7b95fcd","2020-03-23T20:00:00Z",34,NA,5948,5948,5948,22,14,0,2115,335,2450
"1758",20200323,"MA",777,8145,NA,NA,79,NA,NA,NA,NA,NA,"40b8c6ab57a8cd588c84704eea95f5d596cb66f6","2020-03-23T20:00:00Z",9,79,8922,8922,8922,25,4,8,2686,131,2817
"1759",20200323,"MD",288,94,NA,NA,NA,NA,NA,NA,NA,NA,"6e4ed4b8716381c2a1daaa4d89c4647815bc188e","2020-03-23T20:00:00Z",3,NA,382,382,382,24,0,0,0,44,44
"1760",20200323,"ME",107,2791,NA,NA,NA,NA,NA,NA,NA,NA,"88636589511012ea8869a31269dbb2c701023479","2020-03-23T20:00:00Z",NA,NA,2898,2898,2898,23,0,0,527,18,545
"1761",20200323,"MI",5789,4697,NA,NA,NA,NA,NA,NA,NA,NA,"84a4b69577379e2159ba9c4e79e2bf4bae5122ff","2020-03-23T20:00:00Z",15,NA,10486,10486,10486,26,7,0,985,691,1676
"1762",20200323,"MN",235,4511,NA,NA,17,NA,NA,NA,NA,NA,"d688eeb57c635ed77ed2196359d616a3dae38e3e","2020-03-23T20:00:00Z",1,17,4746,4746,4746,27,0,5,0,66,66
"1763",20200323,"MO",183,369,NA,NA,NA,NA,NA,NA,NA,NA,"d451a8053ea326216b31c935b674d0457532b596","2020-03-23T20:00:00Z",3,NA,552,552,552,29,0,0,0,93,93
"1764",20200323,"MP",0,NA,NA,NA,NA,NA,NA,NA,NA,NA,"55022701b87eeeffb616fb7eae76d2e2fe55bb3b","2020-03-23T20:00:00Z",0,NA,0,0,0,69,0,0,0,0,0
"1765",20200323,"MS",249,1143,NA,NA,33,NA,NA,NA,NA,NA,"2ed97cbc9d4455685f466d3ba3c9e7edbd3413ef","2020-03-23T20:00:00Z",1,33,1392,1392,1392,28,0,0,29,42,71
"1766",20200323,"MT",34,1146,NA,NA,NA,NA,NA,NA,NA,NA,"e824730ff62964c60931b7f59c00c1e8ee7ea035","2020-03-23T20:00:00Z",NA,NA,1180,1180,1180,30,0,0,0,3,3
"1767",20200323,"NC",297,8141,NA,NA,NA,NA,NA,NA,NA,NA,"f498171c52256d450302d4d6e478d260e7d5b51d","2020-03-23T20:00:00Z",0,NA,8438,8438,8438,37,0,0,1958,42,2000
"1768",20200323,"ND",30,1353,NA,NA,4,NA,NA,NA,NA,NA,"b45813a4a0e083874a405d5ffb64d2944abf2d5f","2020-03-23T20:00:00Z",0,4,1383,1383,1383,38,0,1,93,2,95
"1769",20200323,"NE",50,356,NA,NA,NA,NA,NA,NA,NA,NA,"93f27986c82b8f07b7360321ad9d715951ff14e0","2020-03-23T20:00:00Z",0,NA,406,406,406,31,0,0,0,2,2
"1770",20200323,"NH",78,1374,889,NA,NA,NA,NA,NA,NA,NA,"ea9ab3f6c3061a5ed37885a1478f700d7c44c9b6","2020-03-23T20:00:00Z",NA,NA,2341,1452,1452,33,0,0,186,13,199
"1771",20200323,"NJ",2844,359,94,NA,NA,NA,NA,NA,NA,NA,"31b24615de8d15c0b6de14c1d8d6d4f06708f56f","2020-03-23T20:00:00Z",27,NA,3297,3203,3203,34,7,0,32,930,962
"1772",20200323,"NM",65,5321,NA,NA,NA,NA,NA,NA,NA,NA,"fd468d865dcbf3b9efc33a3819fbe8ad824cbec7","2020-03-23T20:00:00Z",NA,NA,5386,5386,5386,35,0,0,599,8,607
"1773",20200323,"NV",245,3490,NA,NA,NA,NA,NA,NA,NA,NA,"fb2100c3617a15181d8fdb28298b8be70790c0e0","2020-03-23T20:00:00Z",4,NA,3735,3735,3735,32,2,0,1042,55,1097
"1774",20200323,"NY",20875,57414,NA,NA,2635,NA,NA,NA,NA,NA,"40440cdc2bc6ecd1d88040f01ebbdcb130a33257","2020-03-23T20:00:00Z",114,2635,78289,78289,78289,36,0,661,11181,5707,16888
"1775",20200323,"OH",442,140,NA,NA,104,NA,NA,NA,NA,NA,"8966d12c492b67747a0413f8a0fb4ee97bc8b1d6","2020-03-23T20:00:00Z",6,104,582,582,582,39,3,21,0,91,91
"1776",20200323,"OK",81,694,102,NA,15,NA,NA,NA,NA,NA,"06988832908c4bd0101aa70897aaa31f44bf1f07","2020-03-23T20:00:00Z",2,15,877,775,775,40,0,4,25,14,39
"1777",20200323,"OR",191,3649,NA,NA,56,NA,NA,NA,NA,NA,"d32dc80aee60746bbda8cd2ded2558efd103b76d","2020-03-23T20:00:00Z",5,56,3840,3840,3840,41,1,13,785,30,815
"1778",20200323,"PA",644,6595,NA,NA,NA,NA,NA,NA,NA,NA,"f34848bd60ba259abd8ba905bbf1a2edc2e450da","2020-03-23T20:00:00Z",6,NA,7239,7239,7239,42,4,0,1631,165,1796
"1779",20200323,"PR",31,189,35,NA,NA,NA,NA,NA,NA,NA,"f11fb4d67e27feb9ecd7b591d6c96fd2073b15eb","2020-03-23T20:00:00Z",2,NA,255,220,220,72,2,0,6,8,14
"1780",20200323,"RI",106,1143,216,NA,NA,NA,NA,NA,NA,NA,"e756bdb973c135644d91e1f1cd4a9f53467e0375","2020-03-23T20:00:00Z",NA,NA,1465,1249,1249,44,0,0,211,23,234
"1781",20200323,"SC",298,1466,NA,NA,NA,NA,NA,NA,NA,NA,"6065c53119b350f0a5abc09e33240e8344459d65","2020-03-23T20:00:00Z",5,NA,1764,1764,1764,45,2,0,0,103,103
"1782",20200323,"SD",28,762,265,NA,NA,NA,NA,NA,NA,NA,"042646860048b05f38e0717c8322ccb5dcf0a33e","2020-03-23T20:00:00Z",1,NA,1055,790,790,46,0,0,22,7,29
"1783",20200323,"TN",615,3272,NA,NA,NA,NA,NA,NA,NA,NA,"2c5ac2c1a6353ca8ed3b942a6580e298e333a7ff","2020-03-23T20:00:00Z",2,NA,3887,3887,3887,47,2,0,0,110,110
"1784",20200323,"TX",352,9703,NA,NA,NA,NA,NA,NA,NA,NA,"b8898c676a614ee7ce5cba28465922cb7b1b025e","2020-03-23T20:00:00Z",8,NA,10055,10055,10055,48,3,0,1281,18,1299
"1785",20200323,"UT",257,4790,NA,NA,NA,NA,NA,NA,NA,NA,"1c0d56f6022578f0b588db0251a1c880d278c1c8","2020-03-23T20:00:00Z",1,NA,5047,5047,5047,49,0,0,1282,76,1358
"1786",20200323,"VA",254,3443,NA,NA,38,NA,NA,NA,NA,NA,"f04ccf03a897d757c0d98d7b10c12edb59dbbc33","2020-03-23T20:00:00Z",6,38,3697,3697,3697,51,3,6,325,35,360
"1787",20200323,"VI",17,NA,NA,NA,NA,NA,NA,NA,NA,NA,"6b742c14c76705483cc3fe5bb6aeb86828d935de","2020-03-23T20:00:00Z",NA,NA,17,17,17,78,0,0,0,11,11
"1788",20200323,"VT",75,1106,NA,NA,NA,NA,NA,NA,NA,NA,"72af0f2c9c2f632f233a942199d61c606b68fd90","2020-03-23T20:00:00Z",5,NA,1181,1181,1181,50,3,0,0,23,23
"1789",20200323,"WA",2489,28879,NA,NA,NA,NA,NA,NA,NA,NA,"c4c395361b8a775fb417e6a3c419a2e53d397008","2020-03-23T20:00:00Z",133,NA,31368,31368,31368,53,11,0,3551,211,3762
"1790",20200323,"WI",416,7050,NA,NA,NA,NA,NA,NA,NA,NA,"4d367dd2bdc949d101983f7dca73a29062b3f1f7","2020-03-23T20:00:00Z",5,NA,7466,7466,7466,55,1,0,820,31,851
"1791",20200323,"WV",16,444,4,NA,1,NA,NA,NA,NA,NA,"93a7366dbdbbe8314dac0702465b28a583e20467","2020-03-23T20:00:00Z",0,1,464,460,460,54,0,0,59,4,63
"1792",20200323,"WY",26,592,NA,NA,NA,NA,NA,NA,NA,NA,"61e5cc96d0195daeb49d495e5abec3130fbb841f","2020-03-23T20:00:00Z",NA,NA,618,618,618,56,0,0,154,2,156
"1793",20200322,"AK",22,946,NA,NA,0,NA,NA,NA,NA,NA,"954538b091e0df5320af2ba9881b4b4e9a10fcb2","2020-03-22T20:00:00Z",0,0,968,968,968,2,0,0,188,8,196
"1794",20200322,"AL",138,1464,NA,NA,NA,NA,NA,NA,NA,NA,"336c2b990aa3df11f73436c012fb53a71c5b36fd","2020-03-22T20:00:00Z",0,NA,1602,1602,1602,1,0,0,1436,14,1450
"1795",20200322,"AR",165,711,119,13,NA,NA,NA,NA,NA,NA,"7a7789c5ffc39500e1fb19708f57b9c5729c8530","2020-03-22T20:00:00Z",0,NA,995,876,876,5,0,0,144,47,191
"1796",20200322,"AS",NA,NA,NA,NA,NA,NA,NA,NA,NA,NA,"7922fdb5c81d4a4b4549e23485608a699255d3c9","2020-03-22T20:00:00Z",0,NA,0,0,0,60,0,0,0,0,0
"1797",20200322,"AZ",152,282,87,NA,NA,NA,NA,NA,NA,NA,"4cbd0a587cb58735684352d0a8dea494c4e5510a","2020-03-22T20:00:00Z",2,NA,521,434,434,4,1,0,42,48,90
"1798",20200322,"CA",1536,11304,NA,NA,NA,NA,NA,NA,NA,NA,"894c0795f019e9dad5fb2ea4b76464bd93ca011e","2020-03-22T20:00:00Z",27,NA,12840,12840,12840,6,3,0,55,257,312
"1799",20200322,"CO",475,4075,NA,56,49,NA,NA,NA,NA,NA,"168a6003a0f0dc9dd310312e1b35b8d0cc2ccf77","2020-03-22T20:00:00Z",5,49,4550,4550,4550,8,1,5,758,112,870
"1800",20200322,"CT",223,2877,NA,43,NA,NA,NA,NA,NA,NA,"9bc80cd28db75381e9b8018f53c24796f3b6a842","2020-03-22T20:00:00Z",5,NA,3100,3100,3100,9,1,0,771,29,800
"1801",20200322,"DC",98,957,NA,NA,NA,NA,NA,NA,NA,NA,"6cd7f2b5c81f8b714e6564b8bcd9309604c9d92e","2020-03-22T20:00:00Z",1,NA,1055,1055,1055,11,0,0,451,21,472
"1802",20200322,"DE",56,36,NA,NA,NA,NA,NA,NA,NA,NA,"853edea9e9aa87a30f9e8d40e2f4a73735f35606","2020-03-22T20:00:00Z",0,NA,92,92,92,10,0,0,0,11,11
"1803",20200322,"FL",830,7990,963,NA,185,NA,NA,NA,NA,NA,"4e90c613758e8eb9c13d69d3d68c462bba4cb68f","2020-03-22T20:00:00Z",13,185,9783,8820,8820,12,1,27,1411,172,1583
"1804",20200322,"GA",600,3420,NA,NA,NA,NA,NA,NA,NA,NA,"69702dd23d01e4995145ae809b89338c1dd848e2","2020-03-22T20:00:00Z",23,NA,4020,4020,4020,13,9,0,863,93,956
"1805",20200322,"GU",27,126,NA,NA,NA,NA,NA,NA,NA,NA,"760562a7cce7809e06d7d66233f2168e78f3ae9f","2020-03-22T20:00:00Z",1,NA,153,153,153,66,1,0,18,12,30
"1806",20200322,"HI",48,263,NA,NA,NA,NA,NA,NA,NA,NA,"6daf3b6060a3ba24489bc466e6e5c190b15955c4","2020-03-22T20:00:00Z",NA,NA,311,311,311,15,0,0,139,11,150
"1807",20200322,"IA",90,1215,NA,NA,NA,NA,NA,NA,NA,NA,"0d5c8c0464af1d50dab5ca09cb810e469781a539","2020-03-22T20:00:00Z",NA,NA,1305,1305,1305,19,0,0,166,22,188
"1808",20200322,"ID",42,1175,NA,NA,NA,NA,NA,NA,NA,NA,"f79d41155ce5dde0d4087aceff09c30b8b2f5ad9","2020-03-22T20:00:00Z",0,NA,1217,1217,1217,16,0,0,295,11,306
"1809",20200322,"IL",1049,7271,NA,NA,NA,NA,NA,NA,NA,NA,"54f72764f10b61ac90bf334158a12c9193e78805","2020-03-22T20:00:00Z",9,NA,8320,8320,8320,17,3,0,1783,296,2079
"1810",20200322,"IN",201,1293,NA,NA,1,NA,NA,NA,NA,NA,"753c16b219930207a817b10f2ad60504a7a5762d","2020-03-22T20:00:00Z",6,1,1494,1494,1494,18,2,0,586,75,661
"1811",20200322,"KS",64,417,NA,NA,NA,NA,NA,NA,NA,NA,"699f1a58fbe837f26dfaa7bf2bb51d82ce9c6928","2020-03-22T20:00:00Z",2,NA,481,481,481,20,0,0,0,9,9
"1812",20200322,"KY",99,1472,NA,NA,NA,NA,NA,NA,NA,NA,"a9002192cd7888064a4a40cd704e6b6f19933dc9","2020-03-22T20:00:00Z",3,NA,1571,1571,1571,21,1,0,758,45,803
"1813",20200322,"LA",837,2661,NA,NA,NA,NA,NA,NA,NA,NA,"c89220ae4e2b0931fb785ec35f44887bf5a5355b","2020-03-22T20:00:00Z",20,NA,3498,3498,3498,22,4,0,481,252,733
"1814",20200322,"MA",646,5459,NA,NA,71,NA,NA,NA,NA,NA,"80dbca40ed272bb21a8cb8dc36290f39876b1ad2","2020-03-22T20:00:00Z",5,71,6105,6105,6105,25,4,10,707,121,828
"1815",20200322,"MD",244,94,NA,NA,NA,NA,NA,NA,NA,NA,"d9cf183ca3af60eaff0e839e6542a4ae56000e2d","2020-03-22T20:00:00Z",3,NA,338,338,338,24,1,0,0,54,54
"1816",20200322,"ME",89,2264,NA,NA,NA,NA,NA,NA,NA,NA,"75a9c5c5d650bb96972accb662c7a1498fc48e10","2020-03-22T20:00:00Z",NA,NA,2353,2353,2353,23,0,0,0,16,16
"1817",20200322,"MI",5098,3712,NA,NA,NA,NA,NA,NA,NA,NA,"c9cf971e323b571b235d5f65cab54d551f16a902","2020-03-22T20:00:00Z",8,NA,8810,8810,8810,26,3,0,16,555,571
"1818",20200322,"MN",169,4511,NA,NA,12,NA,NA,NA,NA,NA,"eca43d6a5a1e21aef9b115cbf6c37684dfe5daff","2020-03-22T20:00:00Z",1,12,4680,4680,4680,27,0,12,559,31,590
"1819",20200322,"MO",90,369,NA,NA,NA,NA,NA,NA,NA,NA,"4ccad6d58d6ff133d8f62d55cdee11096e9c76c3","2020-03-22T20:00:00Z",3,NA,459,459,459,29,0,0,0,17,17
"1820",20200322,"MP",0,NA,NA,NA,NA,NA,NA,NA,NA,NA,"47a1f8351b146d34fc8eca53b5de76e4487e7dcc","2020-03-22T20:00:00Z",0,NA,0,0,0,69,0,0,0,0,0
"1821",20200322,"MS",207,1114,NA,NA,33,NA,NA,NA,NA,NA,"894b62e8c387654b1a0363daf8a6664d1ec4f1a3","2020-03-22T20:00:00Z",1,33,1321,1321,1321,28,0,33,419,67,486
"1822",20200322,"MT",31,1146,NA,NA,NA,NA,NA,NA,NA,NA,"b2c90f7ae286607e49a984824d71835787a69bf8","2020-03-22T20:00:00Z",NA,NA,1177,1177,1177,30,0,0,0,11,11
"1823",20200322,"NC",255,6183,NA,NA,NA,NA,NA,NA,NA,NA,"f7ae5da72d04953c92dbeded88d4532bcc0e7cf5","2020-03-22T20:00:00Z",0,NA,6438,6438,6438,37,0,0,1091,71,1162
"1824",20200322,"ND",28,1260,NA,NA,3,NA,NA,NA,NA,NA,"7549a624b49809d6eac8a3c40e3b6617c40ff00a","2020-03-22T20:00:00Z",0,3,1288,1288,1288,38,0,0,119,0,119
"1825",20200322,"NE",48,356,NA,NA,NA,NA,NA,NA,NA,NA,"7689257b7671d64bc5dc19ab900cc8be6d724b4a","2020-03-22T20:00:00Z",0,NA,404,404,404,31,0,0,0,10,10
"1826",20200322,"NH",65,1188,959,NA,NA,NA,NA,NA,NA,NA,"0b7e1e183feb671d98bc630201bb3f4af7bf1187","2020-03-22T20:00:00Z",NA,NA,2212,1253,1253,33,0,0,215,10,225
"1827",20200322,"NJ",1914,327,49,NA,NA,NA,NA,NA,NA,NA,"facc3296d95ab4cdeff98dca4f6628c0c6c8a193","2020-03-22T20:00:00Z",20,NA,2290,2241,2241,34,4,0,33,587,620
"1828",20200322,"NM",57,4722,NA,NA,NA,NA,NA,NA,NA,NA,"41571c753abe314b81f1a7a40a28672e2d5620c0","2020-03-22T20:00:00Z",NA,NA,4779,4779,4779,35,0,0,951,0,951
"1829",20200322,"NV",190,2448,NA,NA,NA,NA,NA,NA,NA,NA,"0dc69efb9cfc8c62e6017e048e94bd390c94d17a","2020-03-22T20:00:00Z",2,NA,2638,2638,2638,32,0,0,64,66,130
"1830",20200322,"NY",15168,46233,NA,NA,1974,NA,NA,NA,NA,NA,"0df3f76e6407f511b0c5bf4f5647cce8f407250e","2020-03-22T20:00:00Z",114,1974,61401,61401,61401,36,70,371,11152,4812,15964
"1831",20200322,"OH",351,140,NA,NA,83,NA,NA,NA,NA,NA,"39a31d5f0d426b43011e943369aa758634b79c97","2020-03-22T20:00:00Z",3,83,491,491,491,39,0,25,0,104,104
"1832",20200322,"OK",67,669,102,NA,11,NA,NA,NA,NA,NA,"9ffd88f2064177c641dd3d488b2e05f323b81e67","2020-03-22T20:00:00Z",2,11,838,736,736,40,1,1,109,14,123
"1833",20200322,"OR",161,2864,NA,NA,43,NA,NA,NA,NA,NA,"ce0d62ce9e64793f5c0c0061df7f500c056f1f94","2020-03-22T20:00:00Z",4,43,3025,3025,3025,41,1,43,861,47,908
"1834",20200322,"PA",479,4964,NA,NA,NA,NA,NA,NA,NA,NA,"e55025d414359bd8039b3a89935560cdf0759885","2020-03-22T20:00:00Z",2,NA,5443,5443,5443,42,0,0,1198,108,1306
"1835",20200322,"PR",23,183,69,NA,NA,NA,NA,NA,NA,NA,"0687c7ff3672264c3265a35d79b30261de725d94","2020-03-22T20:00:00Z",NA,NA,275,206,206,72,0,0,40,2,42
"1836",20200322,"RI",83,932,216,NA,NA,NA,NA,NA,NA,NA,"336ba62e784bf62845374085980f220843d7ec7a","2020-03-22T20:00:00Z",NA,NA,1231,1015,1015,44,0,0,70,17,87
"1837",20200322,"SC",195,1466,NA,NA,NA,NA,NA,NA,NA,NA,"f3e5741d5023be2ca84d4a5214e6358c0c04ceeb","2020-03-22T20:00:00Z",3,NA,1661,1661,1661,45,2,0,211,43,254
"1838",20200322,"SD",21,740,277,NA,NA,NA,NA,NA,NA,NA,"941d3d4dd057bb31c2e6d38e1b899825feffd220","2020-03-22T20:00:00Z",1,NA,1038,761,761,46,0,0,49,7,56
"1839",20200322,"TN",505,3272,NA,NA,NA,NA,NA,NA,NA,NA,"fd0f694ad2179b8cf66684537a9072b0649eed59","2020-03-22T20:00:00Z",NA,NA,3777,3777,3777,47,0,0,0,134,134
"1840",20200322,"TX",334,8422,NA,NA,NA,NA,NA,NA,NA,NA,"b4cdb42d93deee8dd849c6c76a750d6cf2bcc16d","2020-03-22T20:00:00Z",5,NA,8756,8756,8756,48,0,0,2204,30,2234
"1841",20200322,"UT",181,3508,NA,NA,NA,NA,NA,NA,NA,NA,"3de2bbed886da550ffa13c9dc65e5535094d41bc","2020-03-22T20:00:00Z",1,NA,3689,3689,3689,49,1,0,1084,45,1129
"1842",20200322,"VA",219,3118,NA,NA,32,NA,NA,NA,NA,NA,"47ee4fa81f1a7aa2fadcb7ad212b0f2a82b88b1f","2020-03-22T20:00:00Z",3,32,3337,3337,3337,51,1,7,480,67,547
"1843",20200322,"VI",6,NA,NA,NA,NA,NA,NA,NA,NA,NA,"f0d0049f24eea564dc84e057f5001fe4dfeb4701","2020-03-22T20:00:00Z",NA,NA,6,6,6,78,0,0,0,0,0
"1844",20200322,"VT",52,1106,NA,NA,NA,NA,NA,NA,NA,NA,"a0b8449a701d2d442dc5b5fadad80a005d26261b","2020-03-22T20:00:00Z",2,NA,1158,1158,1158,50,0,0,327,23,350
"1845",20200322,"WA",2278,25328,NA,NA,NA,NA,NA,NA,NA,NA,"b84925e08874cfd9c82c622e383bb7585854dcb5","2020-03-22T20:00:00Z",122,NA,27606,27606,27606,53,14,0,3609,240,3849
"1846",20200322,"WI",385,6230,NA,NA,NA,NA,NA,NA,NA,NA,"5c152a9b70d088a432901c770430f27845f16456","2020-03-22T20:00:00Z",4,NA,6615,6615,6615,55,0,0,1602,104,1706
"1847",20200322,"WV",12,385,1,NA,1,NA,NA,NA,NA,NA,"0d111a66e470107a431de577c6d88b5504353ada","2020-03-22T20:00:00Z",0,1,398,397,397,54,0,0,55,1,56
"1848",20200322,"WY",24,438,NA,NA,NA,NA,NA,NA,NA,NA,"750fd7dc66060691c7f4a95b90a3f9f941c5222b","2020-03-22T20:00:00Z",NA,NA,462,462,462,56,0,0,0,1,1
"1849",20200321,"AK",14,758,NA,NA,0,NA,NA,NA,NA,NA,"5c2c153aecba0fd7ce4d4fa3e861773b9e00cd7f","2020-03-21T20:00:00Z",0,0,772,772,772,2,0,0,72,2,74
"1850",20200321,"AL",124,28,NA,NA,NA,NA,NA,NA,NA,NA,"de15c7bdfb3b72e13399f1aaa8d69612f69f0837","2020-03-21T20:00:00Z",0,NA,152,152,152,1,0,0,0,43,43
"1851",20200321,"AR",118,567,154,NA,NA,NA,NA,NA,NA,NA,"be7b0d560d9725c09fd5b6c5c63b15bb489164e8","2020-03-21T20:00:00Z",NA,NA,839,685,685,5,0,0,216,22,238
"1852",20200321,"AS",NA,NA,NA,NA,NA,NA,NA,NA,NA,NA,"33990faa3753488ca4df5d2b72fd1f6afe43e9bf","2020-03-21T20:00:00Z",0,NA,0,0,0,60,0,0,0,0,0
"1853",20200321,"AZ",104,240,122,NA,NA,NA,NA,NA,NA,NA,"c4d69ffe430a0b9d8e0af64e25058aedfdcac703","2020-03-21T20:00:00Z",1,NA,466,344,344,4,1,0,29,39,68
"1854",20200321,"CA",1279,11249,NA,NA,NA,NA,NA,NA,NA,NA,"49c4e45a8661e84906ca87575ab8d30e7c494b6c","2020-03-21T20:00:00Z",24,NA,12528,12528,12528,6,4,0,825,216,1041
"1855",20200321,"CO",363,3317,NA,NA,44,NA,NA,NA,NA,NA,"167a0c3ceb00a06a5b8dc5ed629b4e1e38ec9ea1","2020-03-21T20:00:00Z",4,44,3680,3680,3680,8,1,44,642,86,728
"1856",20200321,"CT",194,2106,NA,NA,NA,NA,NA,NA,NA,NA,"7366c98d6eeab0fb8ef1f185d59d99cbd4c2a6b8","2020-03-21T20:00:00Z",4,NA,2300,2300,2300,9,1,0,1502,0,1502
"1857",20200321,"DC",77,506,0,NA,NA,NA,NA,NA,NA,NA,"aec17bd719975bbec3f0d91dd96a3eb1b1aaef3e","2020-03-21T20:00:00Z",1,NA,583,583,583,11,0,0,5,6,11
"1858",20200321,"DE",45,36,NA,NA,NA,NA,NA,NA,NA,NA,"9df04d2ff8e944c3501daa02149467845c6fad89","2020-03-21T20:00:00Z",0,NA,81,81,81,10,0,0,0,7,7
"1859",20200321,"FL",658,6579,1002,NA,158,NA,NA,NA,NA,NA,"9fcedaea4a2b5e2daad7c2ef3cae3d7c4a66d46c","2020-03-21T20:00:00Z",12,158,8239,7237,7237,12,2,158,4709,138,4847
"1860",20200321,"GA",507,2557,NA,NA,NA,NA,NA,NA,NA,NA,"fa63ec9c063c79b907568e755be9a52e3851b5e5","2020-03-21T20:00:00Z",14,NA,3064,3064,3064,13,1,0,591,87,678
"1861",20200321,"GU",15,108,NA,NA,NA,NA,NA,NA,NA,NA,"bcf4bfbdb666a8125546ac9fa1bde5a40314887c","2020-03-21T20:00:00Z",NA,NA,123,123,123,66,0,0,22,1,23
"1862",20200321,"HI",37,124,NA,NA,NA,NA,NA,NA,NA,NA,"5aef6714da1cfef8b0994bce03b3381f2988ed06","2020-03-21T20:00:00Z",NA,NA,161,161,161,15,0,0,0,11,11
"1863",20200321,"IA",68,1049,NA,NA,NA,NA,NA,NA,NA,NA,"b528ea4ecdc29227ff49d0ab40010fdb7bf04aea","2020-03-21T20:00:00Z",NA,NA,1117,1117,1117,19,0,0,407,23,430
"1864",20200321,"ID",31,880,NA,NA,NA,NA,NA,NA,NA,NA,"1268984bb40128971dfbbbdf403635e18e6f7435","2020-03-21T20:00:00Z",NA,NA,911,911,911,16,0,0,290,8,298
"1865",20200321,"IL",753,5488,NA,NA,NA,NA,NA,NA,NA,NA,"dfaf7e4b5931f46806fd364b0e61a3dbe2fe4550","2020-03-21T20:00:00Z",6,NA,6241,6241,6241,17,1,0,1792,168,1960
"1866",20200321,"IN",126,707,NA,NA,1,NA,NA,NA,NA,NA,"13d8880065d2c2f4c3379631774752a809f99330","2020-03-21T20:00:00Z",4,1,833,833,833,18,2,1,232,47,279
"1867",20200321,"KS",55,417,NA,NA,NA,NA,NA,NA,NA,NA,"0d27ae2aac0674330f6e9556a34def2a48ade762","2020-03-21T20:00:00Z",2,NA,472,472,472,20,1,0,0,11,11
"1868",20200321,"KY",54,714,NA,NA,NA,NA,NA,NA,NA,NA,"e6bdc1623c24ec023b4fea42690fb3d28619b944","2020-03-21T20:00:00Z",2,NA,768,768,768,21,1,0,122,7,129
"1869",20200321,"LA",585,2180,NA,NA,NA,NA,NA,NA,NA,NA,"f7c6c177e7b1f643227b1bc755f63bbb75468835","2020-03-21T20:00:00Z",16,NA,2765,2765,2765,22,4,0,1612,106,1718
"1870",20200321,"MA",525,4752,NA,NA,61,NA,NA,NA,NA,NA,"9434ecc82e2e7e8a85d8a027a082389be42e290a","2020-03-21T20:00:00Z",1,61,5277,5277,5277,25,0,61,1074,112,1186
"1871",20200321,"MD",190,94,NA,NA,NA,NA,NA,NA,NA,NA,"4cac298bc1adaf891591b29d4b8eb0cd3ffef248","2020-03-21T20:00:00Z",2,NA,284,284,284,24,1,0,0,41,41
"1872",20200321,"ME",73,2264,NA,NA,NA,NA,NA,NA,NA,NA,"dd280f45b75f2790185aabea6a93f1539dcd6c4a","2020-03-21T20:00:00Z",NA,NA,2337,2337,2337,23,0,0,0,16,16
"1873",20200321,"MI",4543,3696,NA,NA,NA,NA,NA,NA,NA,NA,"6691cb2bbe72d2abaf40892430dbb9edc0633e4f","2020-03-21T20:00:00Z",5,NA,8239,8239,8239,26,2,0,950,516,1466
"1874",20200321,"MN",138,3952,NA,NA,NA,NA,NA,NA,NA,NA,"c8e20e13bb45ac57df76285e119c0769f67c89ea","2020-03-21T20:00:00Z",1,NA,4090,4090,4090,27,1,0,211,23,234
"1875",20200321,"MO",73,369,NA,NA,NA,NA,NA,NA,NA,NA,"4c5ecaada5fac9b16c463e5e42cff715b3ad3efb","2020-03-21T20:00:00Z",3,NA,442,442,442,29,2,0,0,26,26
"1876",20200321,"MP",0,NA,NA,NA,NA,NA,NA,NA,NA,NA,"97c8946fa6d5bb252c7aa2f2ee65129cf5fd9dde","2020-03-21T20:00:00Z",0,NA,0,0,0,69,0,0,0,0,0
"1877",20200321,"MS",140,695,NA,NA,NA,NA,NA,NA,NA,NA,"05eb75b1e562b9e17f37c33e0678a91de01249c7","2020-03-21T20:00:00Z",1,NA,835,835,835,28,0,0,0,60,60
"1878",20200321,"MT",20,1146,NA,NA,NA,NA,NA,NA,NA,NA,"21bc115fe9533e51dfac6d8defee24a86919d9a3","2020-03-21T20:00:00Z",NA,NA,1166,1166,1166,30,0,0,215,4,219
"1879",20200321,"NC",184,5092,NA,NA,NA,NA,NA,NA,NA,NA,"bc8438b4be03c06d8b21bb306fa8bcade8848a98","2020-03-21T20:00:00Z",0,NA,5276,5276,5276,37,0,0,1996,47,2043
"1880",20200321,"ND",28,1141,NA,NA,3,NA,NA,NA,NA,NA,"e9d65a0e24737712855433e9427b090d5d58befa","2020-03-21T20:00:00Z",0,3,1169,1169,1169,38,0,3,341,8,349
"1881",20200321,"NE",38,356,NA,NA,NA,NA,NA,NA,NA,NA,"5ba9131cf10b134a34623b70bf8983dbc48c9272","2020-03-21T20:00:00Z",0,NA,394,394,394,31,0,0,116,6,122
"1882",20200321,"NH",55,973,942,NA,NA,NA,NA,NA,NA,NA,"71e8c55d1c62bedffae8403188aa39dedc642ba9","2020-03-21T20:00:00Z",NA,NA,1970,1028,1028,33,0,0,228,11,239
"1883",20200321,"NJ",1327,294,40,NA,NA,NA,NA,NA,NA,NA,"619c8150d5592b43e0b0c8a542f3ce57862c85b9","2020-03-21T20:00:00Z",16,NA,1661,1621,1621,34,5,0,30,437,467
"1884",20200321,"NM",57,3771,NA,NA,NA,NA,NA,NA,NA,NA,"5b0fa970db849e97ab1b9c07d675a9ac7ace9f7c","2020-03-21T20:00:00Z",NA,NA,3828,3828,3828,35,0,0,0,14,14
"1885",20200321,"NV",124,2384,NA,NA,NA,NA,NA,NA,NA,NA,"c0c98568c4165cc83bc5ee07b50589fdfb35f7e4","2020-03-21T20:00:00Z",2,NA,2508,2508,2508,32,1,0,392,15,407
"1886",20200321,"NY",10356,35081,NA,NA,1603,NA,NA,NA,NA,NA,"eb983c3fb4fc2d7f3c2c1250578379f502787c29","2020-03-21T20:00:00Z",44,1603,45437,45437,45437,36,9,1603,9756,3254,13010
"1887",20200321,"OH",247,140,NA,NA,58,NA,NA,NA,NA,NA,"dd1dfcf33ceacdd2502013ab34d3156f97223334","2020-03-21T20:00:00Z",3,58,387,387,387,39,2,58,0,78,78
"1888",20200321,"OK",53,560,144,NA,10,NA,NA,NA,NA,NA,"1503e792121ec9bc0aa951a7efe032de95f66efd","2020-03-21T20:00:00Z",1,10,757,613,613,40,0,10,22,4,26
"1889",20200321,"OR",114,2003,433,NA,NA,NA,NA,NA,NA,NA,"10b3171e833e613dedf31c1ac227cc4a45ef6ea0","2020-03-21T20:00:00Z",3,NA,2550,2117,2117,41,0,0,0,0,0
"1890",20200321,"PA",371,3766,NA,NA,NA,NA,NA,NA,NA,NA,"18df8e2622a5b9fc6b266124af168742b75d3bae","2020-03-21T20:00:00Z",2,NA,4137,4137,4137,42,1,0,1192,103,1295
"1891",20200321,"PR",21,143,71,NA,NA,NA,NA,NA,NA,NA,"da8e3b5ccde7f2d73b65a882224183f80e407fb8","2020-03-21T20:00:00Z",NA,NA,235,164,164,72,0,0,29,7,36
"1892",20200321,"RI",66,862,290,NA,NA,NA,NA,NA,NA,NA,"00d75088744e90ea4359ef44da37b2c1048d4897","2020-03-21T20:00:00Z",NA,NA,1218,928,928,44,0,0,62,12,74
"1893",20200321,"SC",152,1255,NA,NA,NA,NA,NA,NA,NA,NA,"4e3f5cbdfb98432f0e6cc8c36ace53a52b5fd93a","2020-03-21T20:00:00Z",1,NA,1407,1407,1407,45,0,0,422,71,493
"1894",20200321,"SD",14,691,268,NA,NA,NA,NA,NA,NA,NA,"faf893694ef24b3ff6f7e4f3332d1cf892dc1326","2020-03-21T20:00:00Z",1,NA,973,705,705,46,0,0,28,0,28
"1895",20200321,"TN",371,3272,NA,NA,NA,NA,NA,NA,NA,NA,"9944d4fad172ece09a78536be10dcc0a6baac09c","2020-03-21T20:00:00Z",NA,NA,3643,3643,3643,47,0,0,2709,143,2852
"1896",20200321,"TX",304,6218,NA,NA,NA,NA,NA,NA,NA,NA,"54267227a81424058326d8ead3199e15f96b8d75","2020-03-21T20:00:00Z",5,NA,6522,6522,6522,48,0,0,1135,110,1245
"1897",20200321,"UT",136,2424,NA,NA,NA,NA,NA,NA,NA,NA,"1612a05ae5f2350863da87addf0e11159a1c4d0c","2020-03-21T20:00:00Z",0,NA,2560,2560,2560,49,0,0,389,24,413
"1898",20200321,"VA",152,2638,NA,NA,25,NA,NA,NA,NA,NA,"d3642dd2689ddb450f271a5e4940f134feb53a28","2020-03-21T20:00:00Z",2,25,2790,2790,2790,51,0,25,427,38,465
"1899",20200321,"VI",6,NA,NA,NA,NA,NA,NA,NA,NA,NA,"8a702969528e608f86ccfa38aae03ce28d1ccb7a","2020-03-21T20:00:00Z",NA,NA,6,6,6,78,0,0,0,3,3
"1900",20200321,"VT",29,779,NA,NA,NA,NA,NA,NA,NA,NA,"3f90c35f316a9595018f2748e50ff309811694ef","2020-03-21T20:00:00Z",2,NA,808,808,808,50,0,0,0,0,0
"1901",20200321,"WA",2038,21719,NA,NA,NA,NA,NA,NA,NA,NA,"0abdda500ce9ae7890e73f643c3fee433befe9f5","2020-03-21T20:00:00Z",108,NA,23757,23757,23757,53,6,0,2383,237,2620
"1902",20200321,"WI",281,4628,NA,NA,NA,NA,NA,NA,NA,NA,"ba16b5db1cba4db66a6ee6542b106fe8c6241158","2020-03-21T20:00:00Z",4,NA,4909,4909,4909,55,1,0,1173,75,1248
"1903",20200321,"WV",11,330,2,NA,1,NA,NA,NA,NA,NA,"f3880f455a42ec088a063f9603e227fe8aa81d3f","2020-03-21T20:00:00Z",0,1,343,341,341,54,0,1,111,4,115
"1904",20200321,"WY",23,438,NA,NA,NA,NA,NA,NA,NA,NA,"063d5a2701dc617e21c78eacebf5071aca0390d6","2020-03-21T20:00:00Z",NA,NA,461,461,461,56,0,0,107,4,111
"1905",20200320,"AK",12,686,NA,NA,NA,NA,NA,NA,NA,NA,"f5e95e78ffb0a39f678cc41f7150889f11283e91","2020-03-20T20:00:00Z",0,NA,698,698,698,2,0,0,254,6,260
"1906",20200320,"AL",81,28,NA,NA,NA,NA,NA,NA,NA,NA,"6bbe154eecf958487c0256f6d6b95eae55c038d8","2020-03-20T20:00:00Z",0,NA,109,109,109,1,0,0,0,13,13
"1907",20200320,"AR",96,351,203,NA,NA,NA,NA,NA,NA,NA,"a85b5e8267c40317cdb4da0571e60d619c4f1275","2020-03-20T20:00:00Z",NA,NA,650,447,447,5,0,0,41,50,91
"1908",20200320,"AS",NA,NA,NA,NA,NA,NA,NA,NA,NA,NA,"07e460e49bf39e109c17495d88e1fde81b6984fd","2020-03-20T20:00:00Z",0,NA,0,0,0,60,0,0,0,0,0
"1909",20200320,"AZ",65,211,101,NA,NA,NA,NA,NA,NA,NA,"4727c3fdde576abf2bb11deceeacd79954e5fc0e","2020-03-20T20:00:00Z",0,NA,377,276,276,4,0,0,36,21,57
"1910",20200320,"CA",1063,10424,NA,NA,NA,NA,NA,NA,NA,NA,"22cfcbb820f66309386b4bdfdf47a806dd894a62","2020-03-20T20:00:00Z",20,NA,11487,11487,11487,6,2,0,1637,139,1776
"1911",20200320,"CO",277,2675,NA,NA,NA,NA,NA,NA,NA,NA,"3cc3cb3b8ada93585da9e20600cd49332188e95c","2020-03-20T20:00:00Z",3,NA,2952,2952,2952,8,1,0,563,61,624
"1912",20200320,"CT",194,604,NA,NA,NA,NA,NA,NA,NA,NA,"8844ec1c291f1730400384b6236407c5eec4e772","2020-03-20T20:00:00Z",3,NA,798,798,798,9,2,0,0,98,98
"1913",20200320,"DC",71,501,1,NA,NA,NA,NA,NA,NA,NA,"555b285ce297b0e04969515fe501ec133644cabc","2020-03-20T20:00:00Z",1,NA,573,572,572,11,1,0,348,32,380
"1914",20200320,"DE",38,36,NA,NA,NA,NA,NA,NA,NA,NA,"b846106acafb3617a2651cecc862737a4e0595b3","2020-03-20T20:00:00Z",0,NA,74,74,74,10,0,0,0,8,8
"1915",20200320,"FL",520,1870,1026,NA,NA,NA,NA,NA,NA,NA,"18f30f4aef61df1aa3a4a339482c5ad20ea478ed","2020-03-20T20:00:00Z",10,NA,3416,2390,2390,12,2,0,337,130,467
"1916",20200320,"GA",420,1966,NA,NA,NA,NA,NA,NA,NA,NA,"c1099b472676eb4813360be325975832eeeecc23","2020-03-20T20:00:00Z",13,NA,2386,2386,2386,13,3,0,422,133,555
"1917",20200320,"GU",14,86,NA,NA,NA,NA,NA,NA,NA,NA,"159284c0d374c774364f46fa9817010818ece653","2020-03-20T20:00:00Z",NA,NA,100,100,100,66,0,0,17,2,19
"1918",20200320,"HI",26,124,NA,NA,NA,NA,NA,NA,NA,NA,"4a3f036b5b06c690c544eb042eb277a4a9a4d964","2020-03-20T20:00:00Z",NA,NA,150,150,150,15,0,0,31,10,41
"1919",20200320,"IA",45,642,NA,NA,NA,NA,NA,NA,NA,NA,"8931d868707d9cfae19d1d0bec4836030df44395","2020-03-20T20:00:00Z",NA,NA,687,687,687,19,0,0,559,7,566
"1920",20200320,"ID",23,590,NA,NA,NA,NA,NA,NA,NA,NA,"427bcf104280535a976cf8932de54622b12d896d","2020-03-20T20:00:00Z",NA,NA,613,613,613,16,0,0,131,12,143
"1921",20200320,"IL",585,3696,NA,NA,NA,NA,NA,NA,NA,NA,"e61e30bd87a3af08bb2a5424cf6eaaca3cfc48ca","2020-03-20T20:00:00Z",5,NA,4281,4281,4281,17,1,0,971,163,1134
"1922",20200320,"IN",79,475,NA,NA,NA,NA,NA,NA,NA,NA,"69bc9f151729b2c730f70ef1ed38d7b9b733d1c1","2020-03-20T20:00:00Z",2,NA,554,554,554,18,0,0,151,23,174
"1923",20200320,"KS",44,417,NA,NA,NA,NA,NA,NA,NA,NA,"a57d1e044d0fa2a45332c1043bab418d82737990","2020-03-20T20:00:00Z",1,NA,461,461,461,20,0,0,0,10,10
"1924",20200320,"KY",47,592,NA,NA,NA,NA,NA,NA,NA,NA,"5132aa1c50a7fc4af7f8ea55558e133917653621","2020-03-20T20:00:00Z",1,NA,639,639,639,21,0,0,138,12,150
"1925",20200320,"LA",479,568,NA,NA,NA,NA,NA,NA,NA,NA,"e67536ea67b77d8ca65be412882b0f4d055238f5","2020-03-20T20:00:00Z",12,NA,1047,1047,1047,22,4,0,110,132,242
"1926",20200320,"MA",413,3678,NA,NA,NA,NA,NA,NA,NA,NA,"e4fa70dd5807dff8381750edb438c3d8fb03335d","2020-03-20T20:00:00Z",1,NA,4091,4091,4091,25,1,0,874,85,959
"1927",20200320,"MD",149,94,NA,NA,NA,NA,NA,NA,NA,NA,"9f5bf564b168c100be9bfa7869e3237c0307d9f2","2020-03-20T20:00:00Z",1,NA,243,243,243,24,0,0,0,42,42
"1928",20200320,"ME",57,2264,NA,NA,NA,NA,NA,NA,NA,NA,"0bbfa7a74e3391acd5aab61690ae8098d0a14554","2020-03-20T20:00:00Z",NA,NA,2321,2321,2321,23,0,0,260,4,264
"1929",20200320,"MI",4027,2746,NA,NA,NA,NA,NA,NA,NA,NA,"f1312c12fe7758511b43a9cc34b31b363ad9f7d8","2020-03-20T20:00:00Z",3,NA,6773,6773,6773,26,0,0,961,635,1596
"1930",20200320,"MN",115,3741,NA,NA,NA,NA,NA,NA,NA,NA,"4614bb4e80402ac12d217edcebc7fb8c0307722f","2020-03-20T20:00:00Z",NA,NA,3856,3856,3856,27,0,0,792,26,818
"1931",20200320,"MO",47,369,NA,NA,NA,NA,NA,NA,NA,NA,"4b0f45177c6372badaf3fc3cd21353d7cc037f86","2020-03-20T20:00:00Z",1,NA,416,416,416,29,0,0,61,23,84
"1932",20200320,"MP",0,NA,NA,NA,NA,NA,NA,NA,NA,NA,"082f47c47804486f21616c38aa13205a3fb6fbfb","2020-03-20T20:00:00Z",0,NA,0,0,0,69,0,0,0,0,0
"1933",20200320,"MS",80,695,NA,NA,NA,NA,NA,NA,NA,NA,"115279517e0a0ee05e43c6d5aed122d5b39b2670","2020-03-20T20:00:00Z",1,NA,775,775,775,28,1,0,143,30,173
"1934",20200320,"MT",16,931,NA,NA,NA,NA,NA,NA,NA,NA,"d05a98622d0fdf01680375131d34a96a6dabffe7","2020-03-20T20:00:00Z",NA,NA,947,947,947,30,0,0,170,4,174
"1935",20200320,"NC",137,3096,NA,NA,NA,NA,NA,NA,NA,NA,"7fb95d6505c8d7fe53b1f0b7dbe50120d88bb6c6","2020-03-20T20:00:00Z",0,NA,3233,3233,3233,37,0,0,688,40,728
"1936",20200320,"ND",20,800,NA,NA,NA,NA,NA,NA,NA,NA,"9163e5a9b67865ff295efd3f8a96912154727929","2020-03-20T20:00:00Z",0,NA,820,820,820,38,0,0,307,5,312
"1937",20200320,"NE",32,240,NA,NA,NA,NA,NA,NA,NA,NA,"4cda7034604f490921d79617c0010a5d350c0a41","2020-03-20T20:00:00Z",0,NA,272,272,272,31,0,0,0,5,5
"1938",20200320,"NH",44,745,631,NA,NA,NA,NA,NA,NA,NA,"17fa3bca875f292ca2284eb20eedeb139dfbfcdc","2020-03-20T20:00:00Z",NA,NA,1420,789,789,33,0,0,124,5,129
"1939",20200320,"NJ",890,264,86,NA,NA,NA,NA,NA,NA,NA,"42bf8537b56da3791417f26b573d6c19e37af697","2020-03-20T20:00:00Z",11,NA,1240,1154,1154,34,2,0,54,148,202
"1940",20200320,"NM",43,3771,NA,NA,NA,NA,NA,NA,NA,NA,"6d6b00ecb91b88b1a8eb243c140909f79393e03c","2020-03-20T20:00:00Z",NA,NA,3814,3814,3814,35,0,0,1009,8,1017
"1941",20200320,"NV",109,1992,NA,NA,NA,NA,NA,NA,NA,NA,"27448d6667cc2710aa2b41850b5f8993ef3f22da","2020-03-20T20:00:00Z",1,NA,2101,2101,2101,32,0,0,366,14,380
"1942",20200320,"NY",7102,25325,NA,NA,NA,NA,NA,NA,NA,NA,"5293b5c5920709d4f3cf66b901621a61a47d0d23","2020-03-20T20:00:00Z",35,NA,32427,32427,32427,36,23,0,7193,2950,10143
"1943",20200320,"OH",169,140,NA,NA,NA,NA,NA,NA,NA,NA,"def0867b0c16cbafd9afe098983af7d8e0badd4c","2020-03-20T20:00:00Z",1,NA,309,309,309,39,1,0,0,50,50
"1944",20200320,"OK",49,538,374,NA,NA,NA,NA,NA,NA,NA,"e7f3b58b28391e52c4ba63eebe765a8da88bce50","2020-03-20T20:00:00Z",1,NA,961,587,587,40,0,0,72,5,77
"1945",20200320,"OR",114,2003,433,NA,NA,NA,NA,NA,NA,NA,"ce87d86e6068b6b11bf179616acd49af43d92ab8","2020-03-20T20:00:00Z",3,NA,2550,2117,2117,41,0,0,674,26,700
"1946",20200320,"PA",268,2574,NA,NA,NA,NA,NA,NA,NA,NA,"d618791d5664fb84a0a633890bae484ad6390590","2020-03-20T20:00:00Z",1,NA,2842,2842,2842,42,0,0,966,83,1049
"1947",20200320,"PR",14,114,52,NA,NA,NA,NA,NA,NA,NA,"045b02a40ddf42ca4604f3d36ace4f27f9fa9dd8","2020-03-20T20:00:00Z",NA,NA,180,128,128,72,0,0,58,9,67
"1948",20200320,"RI",54,800,140,NA,NA,NA,NA,NA,NA,NA,"2df5918bc646fad45cb2c82a3ee409952106a7ca","2020-03-20T20:00:00Z",NA,NA,994,854,854,44,0,0,146,10,156
"1949",20200320,"SC",81,833,NA,NA,NA,NA,NA,NA,NA,NA,"2b41a9dadec8fa07045ea3a0d9c92834ba77094f","2020-03-20T20:00:00Z",1,NA,914,914,914,45,0,0,250,21,271
"1950",20200320,"SD",14,663,270,NA,NA,NA,NA,NA,NA,NA,"0ff86be98a82aa41e2d3c093dcb848a516d082ed","2020-03-20T20:00:00Z",1,NA,947,677,677,46,0,0,112,3,115
"1951",20200320,"TN",228,563,NA,NA,NA,NA,NA,NA,NA,NA,"c30ab203ca516277f9337100529cc875d2cae47a","2020-03-20T20:00:00Z",NA,NA,791,791,791,47,0,0,214,74,288
"1952",20200320,"TX",194,5083,NA,NA,NA,NA,NA,NA,NA,NA,"41c1f53ffba2657e7fbd2eee03f09bebab402ec5","2020-03-20T20:00:00Z",5,NA,5277,5277,5277,48,2,0,2871,51,2922
"1953",20200320,"UT",112,2035,NA,NA,NA,NA,NA,NA,NA,NA,"df33dd66d88c6b1eddc25ca3aa7321769032d783","2020-03-20T20:00:00Z",0,NA,2147,2147,2147,49,0,0,587,34,621
"1954",20200320,"VA",114,2211,NA,NA,NA,NA,NA,NA,NA,NA,"998c78195dd294b9150ccec8e02a47681cc444d2","2020-03-20T20:00:00Z",2,NA,2325,2325,2325,51,0,0,382,20,402
"1955",20200320,"VI",3,NA,NA,NA,NA,NA,NA,NA,NA,NA,"8b5693fe1ff341165461c7845162147f7a4867fb","2020-03-20T20:00:00Z",NA,NA,3,3,3,78,0,0,0,0,0
"1956",20200320,"VT",29,779,NA,NA,NA,NA,NA,NA,NA,NA,"d08680597184a748ed263fab7f7a6137668d5566","2020-03-20T20:00:00Z",2,NA,808,808,808,50,2,0,134,7,141
"1957",20200320,"WA",1801,19336,NA,NA,NA,NA,NA,NA,NA,NA,"9602ade970c922fabcdbc44c2cfdafbd76d3da46","2020-03-20T20:00:00Z",102,NA,21137,21137,21137,53,11,0,3418,240,3658
"1958",20200320,"WI",206,3455,NA,NA,NA,NA,NA,NA,NA,NA,"93fb2a48a14e3d7dc1b46f9735b75d4f211b378b","2020-03-20T20:00:00Z",3,NA,3661,3661,3661,55,3,0,1263,51,1314
"1959",20200320,"WV",7,219,13,NA,NA,NA,NA,NA,NA,NA,"c12a447783ded752c0d37b29337ca4aa055bafab","2020-03-20T20:00:00Z",0,NA,239,226,226,54,0,0,76,5,81
"1960",20200320,"WY",19,331,NA,NA,NA,NA,NA,NA,NA,NA,"d557b1046d1d80ef9d04b645dd96406c2a94a0e6","2020-03-20T20:00:00Z",NA,NA,350,350,350,56,0,0,60,1,61
"1961",20200319,"AK",6,432,NA,NA,NA,NA,NA,NA,NA,NA,"5afe7032a8188d0f82e989ad852fa5d1526f6a27","2020-03-19T20:00:00Z",0,NA,438,438,438,2,0,0,26,0,26
"1962",20200319,"AL",68,28,NA,NA,NA,NA,NA,NA,NA,NA,"cab25ff0e7f7b888b8cba2df5c54273cad43f3ca","2020-03-19T20:00:00Z",0,NA,96,96,96,1,0,0,0,22,22
"1963",20200319,"AR",46,310,113,NA,NA,NA,NA,NA,NA,NA,"6c34774d075752263526df4bbad724959f80931e","2020-03-19T20:00:00Z",NA,NA,469,356,356,5,0,0,74,13,87
"1964",20200319,"AS",NA,NA,NA,NA,NA,NA,NA,NA,NA,NA,"b6dafad2357e2f121a0ff6b617fa7643d7b4774f","2020-03-19T20:00:00Z",0,NA,0,0,0,60,0,0,0,0,0
"1965",20200319,"AZ",44,175,130,NA,NA,NA,NA,NA,NA,NA,"76b253966cb27ac180f2a1954c05be32f66ffd3b","2020-03-19T20:00:00Z",0,NA,349,219,219,4,0,0,27,16,43
"1966",20200319,"CA",924,8787,NA,NA,NA,NA,NA,NA,NA,NA,"b9c67f8fde621d5bb8895c6a6fcbdcf8440ccf2a","2020-03-19T20:00:00Z",18,NA,9711,9711,9711,6,5,0,806,313,1119
"1967",20200319,"CO",216,2112,NA,NA,NA,NA,NA,NA,NA,NA,"f2e6f5775814d9e0574abd2a0b622a4e7b5f5c03","2020-03-19T20:00:00Z",2,NA,2328,2328,2328,8,0,0,495,33,528
"1968",20200319,"CT",96,604,NA,NA,NA,NA,NA,NA,NA,NA,"f38c4a8409f0daf8ca7de49fdae935367da520a6","2020-03-19T20:00:00Z",1,NA,700,700,700,9,1,0,479,28,507
"1969",20200319,"DC",39,153,11,NA,NA,NA,NA,NA,NA,NA,"a98070bbd5e9860b07b7c604f0716edae507472f","2020-03-19T20:00:00Z",0,NA,203,192,192,11,0,0,15,8,23
"1970",20200319,"DE",30,36,NA,NA,NA,NA,NA,NA,NA,NA,"468ef62e496e36ade5e3e7adf7d1c73520a9e1ec","2020-03-19T20:00:00Z",0,NA,66,66,66,10,0,0,0,5,5
"1971",20200319,"FL",390,1533,1019,NA,NA,NA,NA,NA,NA,NA,"502282f690274385776692ae0cd2f7cbc7af763b","2020-03-19T20:00:00Z",8,NA,2942,1923,1923,12,1,0,308,76,384
"1972",20200319,"GA",287,1544,NA,NA,NA,NA,NA,NA,NA,NA,"5b54c8e2862e3541c6cb2a4a0a6d3fc93891f218","2020-03-19T20:00:00Z",10,NA,1831,1831,1831,13,9,0,233,90,323
"1973",20200319,"GU",12,69,NA,NA,NA,NA,NA,NA,NA,NA,"f6054fe44404e56150824cf1c3bdd5b0a499e142","2020-03-19T20:00:00Z",NA,NA,81,81,81,66,0,0,12,4,16
"1974",20200319,"HI",16,93,NA,NA,NA,NA,NA,NA,NA,NA,"37e209ff83cb4582d9bacfc535fa7c4922611b6c","2020-03-19T20:00:00Z",NA,NA,109,109,109,15,0,0,0,2,2
"1975",20200319,"IA",38,83,NA,NA,NA,NA,NA,NA,NA,NA,"8f211ef3f3731062fd68bfefd2a83a9813cb34d6","2020-03-19T20:00:00Z",NA,NA,121,121,121,19,0,0,0,9,9
"1976",20200319,"ID",11,459,NA,NA,NA,NA,NA,NA,NA,NA,"49ac4006bb26f6313fbd5e256a6dd005a599531a","2020-03-19T20:00:00Z",NA,NA,470,470,470,16,0,0,0,2,2
"1977",20200319,"IL",422,2725,NA,NA,NA,NA,NA,NA,NA,NA,"8d1c449e83525fc3b5de5d1f65ad5bca7b1a14a1","2020-03-19T20:00:00Z",4,NA,3147,3147,3147,17,3,0,962,134,1096
"1978",20200319,"IN",56,324,NA,NA,NA,NA,NA,NA,NA,NA,"549ee6ea79c57957f4fa53219e3c2d6a0c287f16","2020-03-19T20:00:00Z",2,NA,380,380,380,18,0,0,170,17,187
"1979",20200319,"KS",34,417,NA,NA,NA,NA,NA,NA,NA,NA,"5f85df8ea07968d65259f84d333fdaa370cd30da","2020-03-19T20:00:00Z",1,NA,451,451,451,20,0,0,0,18,18
"1980",20200319,"KY",35,454,NA,NA,NA,NA,NA,NA,NA,NA,"4177f3c5f93abf2fa17632e734de6f33ce50ffb8","2020-03-19T20:00:00Z",1,NA,489,489,489,21,0,0,100,9,109
"1981",20200319,"LA",347,458,NA,NA,NA,NA,NA,NA,NA,NA,"5027dafbbd45c690b0ccd4fab11851328b078d81","2020-03-19T20:00:00Z",8,NA,805,805,805,22,2,0,123,107,230
"1982",20200319,"MA",328,2804,NA,NA,NA,NA,NA,NA,NA,NA,"78f476ff93f6ab6ceea2e20dccb8478637895c94","2020-03-19T20:00:00Z",NA,NA,3132,3132,3132,25,0,0,789,72,861
"1983",20200319,"MD",107,94,NA,NA,NA,NA,NA,NA,NA,NA,"395ef22c4ab583e1674bf164aa38aa261b48edc8","2020-03-19T20:00:00Z",1,NA,201,201,201,24,1,0,0,22,22
"1984",20200319,"ME",53,2004,NA,NA,NA,NA,NA,NA,NA,NA,"dfcaae4b9738530fc8e4ddf0a4f04b7fa6615971","2020-03-19T20:00:00Z",NA,NA,2057,2057,2057,23,0,0,334,10,344
"1985",20200319,"MI",3392,1785,NA,NA,NA,NA,NA,NA,NA,NA,"98d5f90a47ca7b484f584e1b85134a043d8c28d0","2020-03-19T20:00:00Z",3,NA,5177,5177,5177,26,3,0,570,479,1049
"1986",20200319,"MN",89,2949,NA,NA,NA,NA,NA,NA,NA,NA,"15ba42c01ac18dca2b983dc834307fabf0ddee3d","2020-03-19T20:00:00Z",NA,NA,3038,3038,3038,27,0,0,264,12,276
"1987",20200319,"MO",24,308,NA,NA,NA,NA,NA,NA,NA,NA,"cfedb6ca7d4cf450995815dfbcb4faa2d8786564","2020-03-19T20:00:00Z",1,NA,332,332,332,29,1,0,55,11,66
"1988",20200319,"MP",0,NA,NA,NA,NA,NA,NA,NA,NA,NA,"961b453a4be423f3a4011ff1980a42db7a8340bd","2020-03-19T20:00:00Z",0,NA,0,0,0,69,0,0,0,0,0
"1989",20200319,"MS",50,552,NA,NA,NA,NA,NA,NA,NA,NA,"dae6b6c859147288aa564d8f7bc329019a566105","2020-03-19T20:00:00Z",NA,NA,602,602,602,28,0,0,73,16,89
"1990",20200319,"MT",12,761,NA,NA,NA,NA,NA,NA,NA,NA,"d9c5be53988efc31dec70e48b4659ef2d519c28e","2020-03-19T20:00:00Z",NA,NA,773,773,773,30,0,0,262,2,264
"1991",20200319,"NC",97,2408,NA,NA,NA,NA,NA,NA,NA,NA,"c38bf0911f7d0887fec0c237fd024b7c65965c1d","2020-03-19T20:00:00Z",0,NA,2505,2505,2505,37,0,0,621,34,655
"1992",20200319,"ND",15,493,NA,NA,NA,NA,NA,NA,NA,NA,"d3478e7e297de62112f0c14e326c630dd4f1a304","2020-03-19T20:00:00Z",0,NA,508,508,508,38,0,0,225,9,234
"1993",20200319,"NE",27,240,NA,NA,NA,NA,NA,NA,NA,NA,"4e4708969869d61b06e4fb88260cc8e193593984","2020-03-19T20:00:00Z",0,NA,267,267,267,31,0,0,34,3,37
"1994",20200319,"NH",39,621,231,NA,NA,NA,NA,NA,NA,NA,"6a5e7d979626aa494679faa93ea4660bdb959e56","2020-03-19T20:00:00Z",NA,NA,891,660,660,33,0,0,108,13,121
"1995",20200319,"NJ",742,210,74,NA,NA,NA,NA,NA,NA,NA,"15bfbbb8a65d6a6c68720f955ec0c0cbbc4e133f","2020-03-19T20:00:00Z",9,NA,1026,952,952,34,4,0,20,315,335
"1996",20200319,"NM",35,2762,NA,NA,NA,NA,NA,NA,NA,NA,"4de22e24a9577d6c8e4ded64bacfc2cab31257ea","2020-03-19T20:00:00Z",NA,NA,2797,2797,2797,35,0,0,436,7,443
"1997",20200319,"NV",95,1626,NA,NA,NA,NA,NA,NA,NA,NA,"2083071a1b29de96ebbd99cd42fc6d1393cdcd03","2020-03-19T20:00:00Z",1,NA,1721,1721,1721,32,0,0,1458,40,1498
"1998",20200319,"NY",4152,18132,NA,NA,NA,NA,NA,NA,NA,NA,"2eabc9b73139066e3613021b1e9c9deaf8af733c","2020-03-19T20:00:00Z",12,NA,22284,22284,22284,36,0,0,5917,1770,7687
"1999",20200319,"OH",119,140,NA,NA,NA,NA,NA,NA,NA,NA,"d5861e1be38df98f3ebf32584dad71eed414cc1a","2020-03-19T20:00:00Z",NA,NA,259,259,259,39,0,0,0,31,31
"2000",20200319,"OK",44,466,250,NA,NA,NA,NA,NA,NA,NA,"47631b0fa53981cf4d35fb5e03bc92da1d876375","2020-03-19T20:00:00Z",1,NA,760,510,510,40,1,0,88,15,103
"2001",20200319,"OR",88,1329,437,NA,NA,NA,NA,NA,NA,NA,"94d69640761fa3b2766f0ab482a1e62e4f77550e","2020-03-19T20:00:00Z",3,NA,1854,1417,1417,41,0,0,211,13,224
"2002",20200319,"PA",185,1608,NA,NA,NA,NA,NA,NA,NA,NA,"a87671ef28a0d908f73c46b699f698799347b071","2020-03-19T20:00:00Z",1,NA,1793,1793,1793,42,0,0,421,52,473
"2003",20200319,"PR",5,56,29,NA,NA,NA,NA,NA,NA,NA,"aa15323ebfa43315d7dbf51bcabc710f6b5beeeb","2020-03-19T20:00:00Z",NA,NA,90,61,61,72,0,0,25,0,25
"2004",20200319,"RI",44,654,334,NA,NA,NA,NA,NA,NA,NA,"73a0d7c823d278e0ae3e43cbd1ed84cde858ff90","2020-03-19T20:00:00Z",NA,NA,1032,698,698,44,0,0,114,11,125
"2005",20200319,"SC",60,583,NA,NA,NA,NA,NA,NA,NA,NA,"c77461930fa9d479778eb04f8d31984d2a83951e","2020-03-19T20:00:00Z",1,NA,643,643,643,45,0,0,0,0,0
"2006",20200319,"SD",11,551,385,NA,NA,NA,NA,NA,NA,NA,"528b99ca6d1a66773889f83a40c35991c7e8c8f7","2020-03-19T20:00:00Z",1,NA,947,562,562,46,0,0,0,0,0
"2007",20200319,"TN",154,349,NA,NA,NA,NA,NA,NA,NA,NA,"c2e339b7624135eb23a1174d4bd161349012b165","2020-03-19T20:00:00Z",NA,NA,503,503,503,47,0,0,0,56,56
"2008",20200319,"TX",143,2212,NA,NA,NA,NA,NA,NA,NA,NA,"cde417be86facde0b4cc168d73b067ee838a6131","2020-03-19T20:00:00Z",3,NA,2355,2355,2355,48,1,0,388,60,448
"2009",20200319,"UT",78,1448,NA,NA,NA,NA,NA,NA,NA,NA,"14c2a5b7bb32c8085b1e5f993e554fd89e37af52","2020-03-19T20:00:00Z",0,NA,1526,1526,1526,49,0,0,1317,15,1332
"2010",20200319,"VA",94,1829,NA,NA,NA,NA,NA,NA,NA,NA,"db038d6305387b5dff8657cfd63a0637f4ebeae4","2020-03-19T20:00:00Z",2,NA,1923,1923,1923,51,1,0,628,17,645
"2011",20200319,"VI",3,NA,NA,NA,NA,NA,NA,NA,NA,NA,"1835143ace8e569fbfcf4767b81d889b2ebde7fb","2020-03-19T20:00:00Z",NA,NA,3,3,3,78,0,0,0,1,1
"2012",20200319,"VT",22,645,NA,NA,NA,NA,NA,NA,NA,NA,"d34ef0b0b994165133a21fa0a4c2329b5131e162","2020-03-19T20:00:00Z",NA,NA,667,667,667,50,0,0,53,3,56
"2013",20200319,"WA",1561,15918,NA,NA,NA,NA,NA,NA,NA,NA,"54a8e02e313652a1c8e6552b81a5aa4b2fb678c2","2020-03-19T20:00:00Z",91,NA,17479,17479,17479,53,10,0,2801,149,2950
"2014",20200319,"WI",155,2192,NA,NA,NA,NA,NA,NA,NA,NA,"04cf4cb3009a0ce03e8c1a25c0fab069f3b6e5bc","2020-03-19T20:00:00Z",NA,NA,2347,2347,2347,55,0,0,615,49,664
"2015",20200319,"WV",2,143,3,NA,NA,NA,NA,NA,NA,NA,"c23463a2d10fb3bc76b7e446714b77ece8a03d77","2020-03-19T20:00:00Z",0,NA,148,145,145,54,0,0,21,1,22
"2016",20200319,"WY",18,271,NA,NA,NA,NA,NA,NA,NA,NA,"9a473d25d0a19ff6338eb5f0dde81887ec30bef5","2020-03-19T20:00:00Z",NA,NA,289,289,289,56,0,0,93,3,96
"2017",20200318,"AK",6,406,NA,NA,NA,NA,NA,NA,NA,NA,"3b2473258ab7d7b06177a9dfdfdd5755b97dde05","2020-03-18T20:00:00Z",0,NA,412,412,412,2,0,0,72,3,75
"2018",20200318,"AL",46,28,NA,NA,NA,NA,NA,NA,NA,NA,"45a12e7b90dfc3888e7a67b4f579327e80d6dee0","2020-03-18T20:00:00Z",0,NA,74,74,74,1,0,0,0,10,10
"2019",20200318,"AR",33,236,50,NA,NA,NA,NA,NA,NA,NA,"ded89e51af058017c83cf8859504494a02b8e23a","2020-03-18T20:00:00Z",NA,NA,319,269,269,5,0,0,39,11,50
"2020",20200318,"AS",NA,NA,NA,NA,NA,NA,NA,NA,NA,NA,"faffd79b60116d673decbba86b9c2c733ca84d32","2020-03-18T20:00:00Z",0,NA,0,0,0,60,0,0,0,0,0
"2021",20200318,"AZ",28,148,102,NA,NA,NA,NA,NA,NA,NA,"290a6fabe096478efca8ac5c81bbd38ac2d36bbe","2020-03-18T20:00:00Z",0,NA,278,176,176,4,0,0,6,8,14
"2022",20200318,"CA",611,7981,NA,NA,NA,NA,NA,NA,NA,NA,"646da42647f99037e2c2b31faf21a04c5b5ff197","2020-03-18T20:00:00Z",13,NA,8592,8592,8592,6,2,0,0,128,128
"2023",20200318,"CO",183,1617,NA,NA,NA,NA,NA,NA,NA,NA,"3f3bba2f3fd791c0e1d4324bc8ff2a6f62de7ec7","2020-03-18T20:00:00Z",2,NA,1800,1800,1800,8,1,0,561,23,584
"2024",20200318,"CT",68,125,NA,NA,NA,NA,NA,NA,NA,NA,"bad4eb54adc44121dd8d251113c0f8ba0473fec5","2020-03-18T20:00:00Z",NA,NA,193,193,193,9,0,0,0,27,27
"2025",20200318,"DC",31,138,1,NA,NA,NA,NA,NA,NA,NA,"c19840607398e049b6c94859e2e5488bb8fd65cc","2020-03-18T20:00:00Z",NA,NA,170,169,169,11,0,0,34,9,43
"2026",20200318,"DE",25,36,NA,NA,NA,NA,NA,NA,NA,NA,"200085798af7e505bcb7c4edfc0813a35aceaed6","2020-03-18T20:00:00Z",NA,NA,61,61,61,10,0,0,0,9,9
"2027",20200318,"FL",314,1225,954,NA,NA,NA,NA,NA,NA,NA,"780fc846fbf000c950f78cc64d78b6224aba330a","2020-03-18T20:00:00Z",7,NA,2493,1539,1539,12,1,0,285,128,413
"2028",20200318,"GA",197,1311,NA,NA,NA,NA,NA,NA,NA,NA,"7c4abc91d1b496bb4b6e90a2b568750290d62c25","2020-03-18T20:00:00Z",1,NA,1508,1508,1508,13,0,0,1311,51,1362
"2029",20200318,"GU",8,57,NA,NA,NA,NA,NA,NA,NA,NA,"488b4b65842850fef461324d0a98fcc0653805c8","2020-03-18T20:00:00Z",NA,NA,65,65,65,66,0,0,16,3,19
"2030",20200318,"HI",14,93,NA,NA,NA,NA,NA,NA,NA,NA,"1b7f39d7fd4e1c744f40516e4ee967f0d9424d86","2020-03-18T20:00:00Z",NA,NA,107,107,107,15,0,0,93,4,97
"2031",20200318,"IA",29,83,NA,NA,NA,NA,NA,NA,NA,NA,"744296249158ada7fe673054c1d488a847a13e78","2020-03-18T20:00:00Z",NA,NA,112,112,112,19,0,0,0,6,6
"2032",20200318,"ID",9,459,NA,NA,NA,NA,NA,NA,NA,NA,"b7e35d1fce1508552a80b1509dd6dc1789ecc16e","2020-03-18T20:00:00Z",NA,NA,468,468,468,16,0,0,113,2,115
"2033",20200318,"IL",288,1763,NA,NA,NA,NA,NA,NA,NA,NA,"5a530936a08eac49cd05347cded3d2e47e4e7bbf","2020-03-18T20:00:00Z",1,NA,2051,2051,2051,17,0,0,423,129,552
"2034",20200318,"IN",39,154,NA,NA,NA,NA,NA,NA,NA,NA,"df609a8d40db459b3c9d18cb5a964ff9b160c4f0","2020-03-18T20:00:00Z",2,NA,193,193,193,18,0,0,25,9,34
"2035",20200318,"KS",16,417,NA,NA,NA,NA,NA,NA,NA,NA,"45de05a2adf705367c4fdaff13311bb37da1073a","2020-03-18T20:00:00Z",1,NA,433,433,433,20,0,0,35,1,36
"2036",20200318,"KY",26,354,NA,NA,NA,NA,NA,NA,NA,NA,"4226afce757dadaf205f1611a61e21839adef8bf","2020-03-18T20:00:00Z",1,NA,380,380,380,21,0,0,59,4,63
"2037",20200318,"LA",240,335,NA,NA,NA,NA,NA,NA,NA,NA,"dad1c0a1eff89b6afadb6c2403054966c897f0e2","2020-03-18T20:00:00Z",6,NA,575,575,575,22,2,0,49,69,118
"2038",20200318,"MA",256,2015,NA,NA,NA,NA,NA,NA,NA,NA,"f33af005453944a9da0ca3a04bb26228e086da9e","2020-03-18T20:00:00Z",NA,NA,2271,2271,2271,25,0,0,474,38,512
"2039",20200318,"MD",85,94,NA,NA,NA,NA,NA,NA,NA,NA,"1f4768a9dad6648329e433e8ef1c1dfd4b40e53c","2020-03-18T20:00:00Z",NA,NA,179,179,179,24,0,0,0,28,28
"2040",20200318,"ME",43,1670,NA,NA,NA,NA,NA,NA,NA,NA,"6b89b002933569c5cdf827aed8b17d83a64131e4","2020-03-18T20:00:00Z",NA,NA,1713,1713,1713,23,0,0,367,11,378
"2041",20200318,"MI",2913,1215,NA,NA,NA,NA,NA,NA,NA,NA,"537719f8b2a5b289f0e7d4410bd55683c458df15","2020-03-18T20:00:00Z",NA,NA,4128,4128,4128,26,0,0,589,520,1109
"2042",20200318,"MN",77,2685,NA,NA,NA,NA,NA,NA,NA,NA,"2778d416bab07054feed2ec1321f3c1a9d3ccb19","2020-03-18T20:00:00Z",NA,NA,2762,2762,2762,27,0,0,409,17,426
"2043",20200318,"MO",13,253,NA,NA,NA,NA,NA,NA,NA,NA,"494c3a4a7f0b3d056f0796c5451a94a65db87f24","2020-03-18T20:00:00Z",0,NA,266,266,266,29,0,0,46,5,51
"2044",20200318,"MP",0,NA,NA,NA,NA,NA,NA,NA,NA,NA,"5473ea484274ea891441c085e860db0a828a9441","2020-03-18T20:00:00Z",0,NA,0,0,0,69,0,0,0,0,0
"2045",20200318,"MS",34,479,NA,NA,NA,NA,NA,NA,NA,NA,"d9aef306232106ab3338341222f0fc21ee44f555","2020-03-18T20:00:00Z",NA,NA,513,513,513,28,0,0,111,13,124
"2046",20200318,"MT",10,499,NA,NA,NA,NA,NA,NA,NA,NA,"31ded3437234cc23d5ddf95effe31b6bd14bf5d3","2020-03-18T20:00:00Z",NA,NA,509,509,509,30,0,0,196,2,198
"2047",20200318,"NC",63,1787,NA,NA,NA,NA,NA,NA,NA,NA,"bc1bbd225ef32227a7efee396646e6930f31637a","2020-03-18T20:00:00Z",0,NA,1850,1850,1850,37,0,0,1313,23,1336
"2048",20200318,"ND",6,268,NA,NA,NA,NA,NA,NA,NA,NA,"3fb86878e20e5d7952aa8b8e58e8f8e3db35e0f6","2020-03-18T20:00:00Z",0,NA,274,274,274,38,0,0,48,3,51
"2049",20200318,"NE",24,206,NA,NA,NA,NA,NA,NA,NA,NA,"fa4b37682bc4e4c9977832d28b6bee342ad73bfc","2020-03-18T20:00:00Z",NA,NA,230,230,230,31,0,0,0,3,3
"2050",20200318,"NH",26,513,208,NA,NA,NA,NA,NA,NA,NA,"379d9ffea7e7ca663fa8076e64b67a0abdff891c","2020-03-18T20:00:00Z",NA,NA,747,539,539,33,0,0,158,9,167
"2051",20200318,"NJ",427,190,21,NA,NA,NA,NA,NA,NA,NA,"cd982339aab35ead35248c6c7d3f97f69aedc106","2020-03-18T20:00:00Z",5,NA,638,617,617,34,2,0,27,160,187
"2052",20200318,"NM",28,2326,NA,NA,NA,NA,NA,NA,NA,NA,"9d7631bd34bff01009e3691eaf8a89a9020f1a60","2020-03-18T20:00:00Z",NA,NA,2354,2354,2354,35,0,0,1077,5,1082
"2053",20200318,"NV",55,168,NA,NA,NA,NA,NA,NA,NA,NA,"143e93252ed96f1da9e57b213aabbffc9a94e028","2020-03-18T20:00:00Z",1,NA,223,223,223,32,0,0,0,0,0
"2054",20200318,"NY",2382,12215,NA,NA,NA,NA,NA,NA,NA,NA,"65a08e6a0f81bd2c4bbc9988a17f0892d2ec4d35","2020-03-18T20:00:00Z",12,NA,14597,14597,14597,36,5,0,6709,682,7391
"2055",20200318,"OH",88,140,NA,NA,NA,NA,NA,NA,NA,NA,"9e018d5062cb6300ba638be07cb64b0e75faf66f","2020-03-18T20:00:00Z",NA,NA,228,228,228,39,0,0,0,21,21
"2056",20200318,"OK",29,378,110,NA,NA,NA,NA,NA,NA,NA,"0d0abb08b10d42019c2c2193f46d2fdc388fc740","2020-03-18T20:00:00Z",NA,NA,517,407,407,40,0,0,131,12,143
"2057",20200318,"OR",75,1118,361,NA,NA,NA,NA,NA,NA,NA,"417e054b02ae4a5d4a0a2a5870a419a30ae285db","2020-03-18T20:00:00Z",3,NA,1554,1193,1193,41,3,0,429,28,457
"2058",20200318,"PA",133,1187,NA,NA,NA,NA,NA,NA,NA,NA,"5ae5b594dffb150d8fa0ee38e56fa1cffab40bcf","2020-03-18T20:00:00Z",1,NA,1320,1320,1320,42,1,0,308,37,345
"2059",20200318,"PR",5,31,21,NA,NA,NA,NA,NA,NA,NA,"2d5405cfdbd83c8717f23b7ebc2f454316248e7c","2020-03-18T20:00:00Z",NA,NA,57,36,36,72,0,0,18,0,18
"2060",20200318,"RI",33,540,334,NA,NA,NA,NA,NA,NA,NA,"d30ec58cfb6debb199f0a3dab56dea6d8b658293","2020-03-18T20:00:00Z",NA,NA,907,573,573,44,0,0,137,10,147
"2061",20200318,"SC",60,583,NA,NA,NA,NA,NA,NA,NA,NA,"1b0a7b83efeb9ea6127ac5e0dbd268700c8b7ffd","2020-03-18T20:00:00Z",1,NA,643,643,643,45,0,0,272,27,299
"2062",20200318,"SD",11,551,350,NA,NA,NA,NA,NA,NA,NA,"517b7759b69709dc0bbfc3a4795c6257a3d8695a","2020-03-18T20:00:00Z",1,NA,912,562,562,46,1,0,0,0,0
"2063",20200318,"TN",98,349,NA,NA,NA,NA,NA,NA,NA,NA,"ef95fc12bc281034aad01fc4c18c9518ad68fc18","2020-03-18T20:00:00Z",NA,NA,447,447,447,47,0,0,19,25,44
"2064",20200318,"TX",83,1824,NA,NA,NA,NA,NA,NA,NA,NA,"2467c07184fc5405454f97f8f267669095674a74","2020-03-18T20:00:00Z",2,NA,1907,1907,1907,48,1,0,620,19,639
"2065",20200318,"UT",63,131,NA,NA,NA,NA,NA,NA,NA,NA,"9966240ca7479f6c30465b22f5b5250bc4e46f44","2020-03-18T20:00:00Z",0,NA,194,194,194,49,0,0,0,12,12
"2066",20200318,"VA",77,1201,NA,NA,NA,NA,NA,NA,NA,NA,"ce7119e82540f46da33ce3ad8566b387de75c4c2","2020-03-18T20:00:00Z",1,NA,1278,1278,1278,51,0,0,240,10,250
"2067",20200318,"VI",2,NA,NA,NA,NA,NA,NA,NA,NA,NA,"9c10ba6e96c6e228fefe05742b8102eedbc33b8b","2020-03-18T20:00:00Z",NA,NA,2,2,2,78,0,0,0,0,0
"2068",20200318,"VT",19,592,NA,NA,NA,NA,NA,NA,NA,NA,"adc018bdef2b12d859e026881ce104495a7a3736","2020-03-18T20:00:00Z",NA,NA,611,611,611,50,0,0,97,9,106
"2069",20200318,"WA",1412,13117,NA,NA,NA,NA,NA,NA,NA,NA,"ea33b111722b430a968d1c9f2aa1c56106b0c381","2020-03-18T20:00:00Z",81,NA,14529,14529,14529,53,4,0,1535,173,1708
"2070",20200318,"WI",106,1577,NA,NA,NA,NA,NA,NA,NA,NA,"c6687fa3edbbc8d56cf9953ddbf05a0988642570","2020-03-18T20:00:00Z",NA,NA,1683,1683,1683,55,0,0,539,34,573
"2071",20200318,"WV",1,122,14,NA,NA,NA,NA,NA,NA,NA,"59817e48b32e3f860eed291a8785c1af5c5fc047","2020-03-18T20:00:00Z",0,NA,137,123,123,54,0,0,42,1,43
"2072",20200318,"WY",15,178,NA,NA,NA,NA,NA,NA,NA,NA,"326e4562919b82e68eb5cf65710387eef18815f2","2020-03-18T20:00:00Z",NA,NA,193,193,193,56,0,0,83,5,88
"2073",20200317,"AK",3,334,NA,NA,NA,NA,NA,NA,NA,NA,"f783749da875f73ada5b29daa00edffb6e10ae11","2020-03-17T20:00:00Z",0,NA,337,337,337,2,0,0,191,2,193
"2074",20200317,"AL",36,28,NA,NA,NA,NA,NA,NA,NA,NA,"27d195514d6511642ecafb4148f51bd1cf06894d","2020-03-17T20:00:00Z",0,NA,64,64,64,1,0,0,0,8,8
"2075",20200317,"AR",22,197,41,NA,NA,NA,NA,NA,NA,NA,"411518ea767313995c4b1d3dcc31cdf917851e0e","2020-03-17T20:00:00Z",NA,NA,260,219,219,5,0,0,65,0,65
"2076",20200317,"AS",NA,NA,NA,NA,NA,NA,NA,NA,NA,NA,"e45f93e9d9d4d1f58980dacbb28ac3d97d9b9d94","2020-03-17T20:00:00Z",NA,NA,NA,NA,NA,60,0,0,0,0,0
"2077",20200317,"AZ",20,142,66,NA,NA,NA,NA,NA,NA,NA,"89437a1c0aef047c82cd8a566761763bae43c5bf","2020-03-17T20:00:00Z",0,NA,228,162,162,4,0,0,17,2,19
"2078",20200317,"CA",483,7981,NA,NA,NA,NA,NA,NA,NA,NA,"3a5a29b79b4583de68455525d065127db6a3e97b","2020-03-17T20:00:00Z",11,NA,8464,8464,8464,6,5,0,0,148,148
"2079",20200317,"CO",160,1056,NA,NA,NA,NA,NA,NA,NA,NA,"cd89a731d2b24e3f2b854af3811047aa4dc58515","2020-03-17T20:00:00Z",1,NA,1216,1216,1216,8,0,0,429,29,458
"2080",20200317,"CT",41,125,NA,NA,NA,NA,NA,NA,NA,NA,"6da5216bce6b0623b87352f8e83a1825342475e8","2020-03-17T20:00:00Z",NA,NA,166,166,166,9,0,0,0,15,15
"2081",20200317,"DC",22,104,0,NA,NA,NA,NA,NA,NA,NA,"920a77b7fb3c7caea23a46e351f576caf34d15d5","2020-03-17T20:00:00Z",NA,NA,126,126,126,11,0,0,8,5,13
"2082",20200317,"DE",16,36,NA,NA,NA,NA,NA,NA,NA,NA,"cda3d06e346fadcb4155d46e80ed29de996cb64b","2020-03-17T20:00:00Z",NA,NA,52,52,52,10,0,0,0,8,8
"2083",20200317,"FL",186,940,872,NA,NA,NA,NA,NA,NA,NA,"326863b36e37f814b53ae8a8ac35ff314dba227c","2020-03-17T20:00:00Z",6,NA,1998,1126,1126,12,2,0,256,45,301
"2084",20200317,"GA",146,NA,NA,NA,NA,NA,NA,NA,NA,NA,"6d29d5d7a269b24f93abacce353e78bdd6d779e5","2020-03-17T20:00:00Z",1,NA,146,146,146,13,0,0,0,25,25
"2085",20200317,"GU",5,41,NA,NA,NA,NA,NA,NA,NA,NA,"0e4694acd5fc6e905760489233fa2e4adb3fe162","2020-03-17T20:00:00Z",NA,NA,46,46,46,66,0,0,18,2,20
"2086",20200317,"HI",10,NA,NA,NA,NA,NA,NA,NA,NA,NA,"0fad73741929efc5016cc6898bf79a04f3b32541","2020-03-17T20:00:00Z",NA,NA,10,10,10,15,0,0,0,3,3
"2087",20200317,"IA",23,83,NA,NA,NA,NA,NA,NA,NA,NA,"39b42e43a67060a6680cc19a597e43f758ae9c4b","2020-03-17T20:00:00Z",NA,NA,106,106,106,19,0,0,0,1,1
"2088",20200317,"ID",7,346,NA,NA,NA,NA,NA,NA,NA,NA,"da76cc722dd92af48de842b866731dd5feecedf5","2020-03-17T20:00:00Z",NA,NA,353,353,353,16,0,0,81,2,83
"2089",20200317,"IL",159,1340,NA,NA,NA,NA,NA,NA,NA,NA,"ac5f0af8ee2b49bbec18da6a8780ae3e6fccbaa4","2020-03-17T20:00:00Z",1,NA,1499,1499,1499,17,1,0,408,66,474
"2090",20200317,"IN",30,129,NA,NA,NA,NA,NA,NA,NA,NA,"9116db98bc9050e3933e80a7afcf74ef82d7e826","2020-03-17T20:00:00Z",2,NA,159,159,159,18,1,0,14,6,20
"2091",20200317,"KS",15,382,NA,NA,NA,NA,NA,NA,NA,NA,"44e5c9df55fec7dfe79bcd4ecb086fe131bb3782","2020-03-17T20:00:00Z",1,NA,397,397,397,20,0,0,216,4,220
"2092",20200317,"KY",22,295,NA,NA,NA,NA,NA,NA,NA,NA,"15eb2cbe48fa8cbaa6eefad032de090f954964cd","2020-03-17T20:00:00Z",1,NA,317,317,317,21,0,0,61,1,62
"2093",20200317,"LA",171,286,NA,NA,NA,NA,NA,NA,NA,NA,"50610ebbdeaa7907b12726f42106e71733e456f5","2020-03-17T20:00:00Z",4,NA,457,457,457,22,2,0,98,57,155
"2094",20200317,"MA",218,1541,NA,NA,NA,NA,NA,NA,NA,NA,"f2b9d7f0d874da810bfb4b57fa42cb6ad8d320f9","2020-03-17T20:00:00Z",NA,NA,1759,1759,1759,25,0,0,1189,54,1243
"2095",20200317,"MD",57,94,NA,NA,NA,NA,NA,NA,NA,NA,"3b1218c8eb03fb526e4527aee06fb0fd45fb84d6","2020-03-17T20:00:00Z",NA,NA,151,151,151,24,0,0,0,20,20
"2096",20200317,"ME",32,1303,NA,NA,NA,NA,NA,NA,NA,NA,"a0e2d3e219d03ae226d39b22f6fb58f3a7962d68","2020-03-17T20:00:00Z",NA,NA,1335,1335,1335,23,0,0,539,15,554
"2097",20200317,"MI",2393,626,NA,NA,NA,NA,NA,NA,NA,NA,"f90248265cd8b3b66154b412adbf713eb53b7b2b","2020-03-17T20:00:00Z",NA,NA,3019,3019,3019,26,0,0,354,460,814
"2098",20200317,"MN",60,2276,NA,NA,NA,NA,NA,NA,NA,NA,"300095ac1a8a4816dc84236f74f9b294078551f2","2020-03-17T20:00:00Z",NA,NA,2336,2336,2336,27,0,0,437,6,443
"2099",20200317,"MO",8,207,NA,NA,NA,NA,NA,NA,NA,NA,"54626aca3649c044d3040c7e2016a1ad31c9785e","2020-03-17T20:00:00Z",0,NA,215,215,215,29,0,0,43,2,45
"2100",20200317,"MP",0,NA,NA,NA,NA,NA,NA,NA,NA,NA,"6adf0f2f9d5d342ee6f48691e7c933cfbb9ee4ab","2020-03-17T20:00:00Z",NA,NA,0,0,0,69,0,0,0,0,0
"2101",20200317,"MS",21,368,NA,NA,NA,NA,NA,NA,NA,NA,"6d8126cab2847762c6c6ae011f9e1a4490be20f6","2020-03-17T20:00:00Z",NA,NA,389,389,389,28,0,0,91,9,100
"2102",20200317,"MT",8,303,NA,NA,NA,NA,NA,NA,NA,NA,"5913952660eba91acbb7ea2118012f069237a417","2020-03-17T20:00:00Z",NA,NA,311,311,311,30,0,0,105,1,106
"2103",20200317,"NC",40,474,NA,NA,NA,NA,NA,NA,NA,NA,"68df9675138cd54797b057149f2b83186228ba6a","2020-03-17T20:00:00Z",0,NA,514,514,514,37,0,0,178,7,185
"2104",20200317,"ND",3,220,0,NA,NA,NA,NA,NA,NA,NA,"44da03edf8d7792eb57915c2b50406c83c0000f2","2020-03-17T20:00:00Z",0,NA,223,223,223,38,0,0,97,2,99
"2105",20200317,"NE",21,206,NA,NA,NA,NA,NA,NA,NA,NA,"8ee48fa5b23a524e017e3402f8a5ffcd74e18e7e","2020-03-17T20:00:00Z",NA,NA,227,227,227,31,0,0,36,3,39
"2106",20200317,"NH",17,355,195,NA,NA,NA,NA,NA,NA,NA,"3d90b42fa44eb1f26bc9dad858c0b267b6bb8320","2020-03-17T20:00:00Z",NA,NA,567,372,372,33,0,0,84,4,88
"2107",20200317,"NJ",267,163,55,NA,NA,NA,NA,NA,NA,NA,"245514c59d21a39ce3fcce7909de2f2aea8521fd","2020-03-17T20:00:00Z",3,NA,485,430,430,34,1,0,43,89,132
"2108",20200317,"NM",23,1249,NA,NA,NA,NA,NA,NA,NA,NA,"dc445586a909cec38c6b3ddd4d313d3933909382","2020-03-17T20:00:00Z",NA,NA,1272,1272,1272,35,0,0,683,6,689
"2109",20200317,"NV",55,168,NA,NA,NA,NA,NA,NA,NA,NA,"5b582da8f08144c39d99e58a22bd3542fa42bcfb","2020-03-17T20:00:00Z",1,NA,223,223,223,32,0,0,0,10,10
"2110",20200317,"NY",1700,5506,NA,NA,NA,NA,NA,NA,NA,NA,"a2d96e7a962926fa3165aef038360c097b6be4ce","2020-03-17T20:00:00Z",7,NA,7206,7206,7206,36,0,0,963,750,1713
"2111",20200317,"OH",67,140,NA,NA,NA,NA,NA,NA,NA,NA,"97daf301defc7356d1af9ba55e9397bb8155fe7c","2020-03-17T20:00:00Z",NA,NA,207,207,207,39,0,0,0,17,17
"2112",20200317,"OK",17,247,82,NA,NA,NA,NA,NA,NA,NA,"e1c323cb75eb122e2b034a5370eaad9e5a86d4fa","2020-03-17T20:00:00Z",NA,NA,346,264,264,40,0,0,73,7,80
"2113",20200317,"OR",47,689,184,NA,NA,NA,NA,NA,NA,NA,"898565e2b6b936a739713bd0e523449fdf478069","2020-03-17T20:00:00Z",NA,NA,920,736,736,41,0,0,110,8,118
"2114",20200317,"PA",96,879,NA,NA,NA,NA,NA,NA,NA,NA,"9a374eb05235860321c532550f87da84d649fcfd","2020-03-17T20:00:00Z",NA,NA,975,975,975,42,0,0,209,20,229
"2115",20200317,"PR",5,13,4,NA,NA,NA,NA,NA,NA,NA,"62bea2a6c0d3c6ef1d1578056f4e0bbc64ebf66a","2020-03-17T20:00:00Z",NA,NA,22,18,18,72,0,0,4,0,4
"2116",20200317,"RI",23,403,149,NA,NA,NA,NA,NA,NA,NA,"0af317dcf6c8e418367a5c24318e6f994d1fe826","2020-03-17T20:00:00Z",NA,NA,575,426,426,44,0,0,95,2,97
"2117",20200317,"SC",33,311,NA,NA,NA,NA,NA,NA,NA,NA,"b5f1adfc0baaf72f68c6ac1ac0ed09497346cca7","2020-03-17T20:00:00Z",1,NA,344,344,344,45,0,0,76,5,81
"2118",20200317,"SD",11,551,35,NA,NA,NA,NA,NA,NA,NA,"4f349aafd2814d07c34bcd70c3df3e11ebdce938","2020-03-17T20:00:00Z",NA,NA,597,562,562,46,0,0,57,1,58
"2119",20200317,"TN",73,330,NA,NA,NA,NA,NA,NA,NA,NA,"87b5c6f12a10d9e22646015aa7f6ff734f74a432","2020-03-17T20:00:00Z",NA,NA,403,403,403,47,0,0,60,21,81
"2120",20200317,"TX",64,1204,NA,NA,NA,NA,NA,NA,NA,NA,"70f6533b6999b27f73a6c5b316d3d22b8ef5519b","2020-03-17T20:00:00Z",1,NA,1268,1268,1268,48,1,0,1204,7,1211
"2121",20200317,"UT",51,131,NA,NA,NA,NA,NA,NA,NA,NA,"a54698d3d8c9e6d9e9d82f50535716a7107b8ab7","2020-03-17T20:00:00Z",0,NA,182,182,182,49,0,0,0,12,12
"2122",20200317,"VA",67,961,NA,NA,NA,NA,NA,NA,NA,NA,"fc691ef55223c03d5038f969b84154d360731887","2020-03-17T20:00:00Z",1,NA,1028,1028,1028,51,0,0,523,16,539
"2123",20200317,"VI",2,NA,NA,NA,NA,NA,NA,NA,NA,NA,"e1264b6e170d5381e6ba419101f02c93331ff4f3","2020-03-17T20:00:00Z",NA,NA,2,2,2,78,0,0,0,1,1
"2124",20200317,"VT",10,495,NA,NA,NA,NA,NA,NA,NA,NA,"7ed042b1658ff87b1bc58e97924f28365b3a934d","2020-03-17T20:00:00Z",NA,NA,505,505,505,50,0,0,74,2,76
"2125",20200317,"WA",1239,11582,NA,NA,NA,NA,NA,NA,NA,NA,"9cc8f71af118fe1edd2b4401ac57209eea2ef5ec","2020-03-17T20:00:00Z",77,NA,12821,12821,12821,53,9,0,2131,173,2304
"2126",20200317,"WI",72,1038,NA,NA,NA,NA,NA,NA,NA,NA,"8c430e85d8bacf4fcd9637ea1fc9d554eac52d2c","2020-03-17T20:00:00Z",NA,NA,1110,1110,1110,55,0,0,534,25,559
"2127",20200317,"WV",0,80,4,NA,NA,NA,NA,NA,NA,NA,"f2463136e4acc78a08320ea32d916ae7a9a305e8","2020-03-17T20:00:00Z",0,NA,84,80,80,54,0,0,0,0,0
"2128",20200317,"WY",10,95,NA,NA,NA,NA,NA,NA,NA,NA,"bc3cae6af97386e715211063c8994c0a9d1c031f","2020-03-17T20:00:00Z",NA,NA,105,105,105,56,0,0,95,7,102
"2129",20200316,"AK",1,143,NA,NA,NA,NA,NA,NA,NA,NA,"e46478b4ac464fb5c40587abd00b920b5f8e7c73","2020-03-16T20:00:00Z",0,NA,144,144,144,2,0,0,0,0,0
"2130",20200316,"AL",28,28,40,NA,NA,NA,NA,NA,NA,NA,"3efe0ea61bb6932f1d608f9e24d38fcafaa2c04c","2020-03-16T20:00:00Z",0,NA,96,56,56,1,0,0,0,16,16
"2131",20200316,"AR",22,132,14,NA,NA,NA,NA,NA,NA,NA,"78bd45495c24cce3ba85c7f24609a179c43478eb","2020-03-16T20:00:00Z",NA,NA,168,154,154,5,0,0,29,6,35
"2132",20200316,"AS",NA,NA,NA,NA,NA,NA,NA,NA,NA,NA,"40355f49a87c433dafdd8148cab5cd5fcb7327ab","2020-03-16T20:00:00Z",NA,NA,NA,NA,NA,60,NA,NA,NA,NA,NA
"2133",20200316,"AZ",18,125,63,NA,NA,NA,NA,NA,NA,NA,"a2961931f5c5f76a42773e7477d509b59b5cd133","2020-03-16T20:00:00Z",0,NA,206,143,143,4,0,0,4,6,10
"2134",20200316,"CA",335,7981,NA,NA,NA,NA,NA,NA,NA,NA,"ae22555d7ccc020a6fc6268f759c981a681af584","2020-03-16T20:00:00Z",6,NA,8316,8316,8316,6,1,0,7065,42,7107
"2135",20200316,"CO",131,627,NA,NA,NA,NA,NA,NA,NA,NA,"dda059810b70b49f0451aef63be8a4ae6d3af3f2","2020-03-16T20:00:00Z",1,NA,758,758,758,8,0,0,0,0,0
"2136",20200316,"CT",26,125,NA,NA,NA,NA,NA,NA,NA,NA,"4d722259eb940d98fdcc976b9bc97308a3e902c0","2020-03-16T20:00:00Z",NA,NA,151,151,151,9,0,0,0,6,6
"2137",20200316,"DC",17,96,7,NA,NA,NA,NA,NA,NA,NA,"8997b7eeb6bd9be4fb4ad8a4094301be4add08b0","2020-03-16T20:00:00Z",NA,NA,120,113,113,11,0,0,17,1,18
"2138",20200316,"DE",8,36,32,NA,NA,NA,NA,NA,NA,NA,"d04addb5ab1cce5bea6da60bd864abdaf9f40c33","2020-03-16T20:00:00Z",NA,NA,76,44,44,10,0,0,0,2,2
"2139",20200316,"FL",141,684,514,NA,NA,NA,NA,NA,NA,NA,"e53cf48d45ec818ea2d56d271277e6ec5a5b49bd","2020-03-16T20:00:00Z",4,NA,1339,825,825,12,0,0,6,25,31
"2140",20200316,"GA",121,NA,NA,NA,NA,NA,NA,NA,NA,NA,"c6fa2c88408c5bb21156b21e12fac3816f255ea9","2020-03-16T20:00:00Z",1,NA,121,121,121,13,0,0,0,22,22
"2141",20200316,"GU",3,23,NA,NA,NA,NA,NA,NA,NA,NA,"f7bbc72cc2925b0cf37ca0d2a707d2dd196619ba","2020-03-16T20:00:00Z",NA,NA,26,26,26,66,NA,NA,NA,NA,NA
"2142",20200316,"HI",7,NA,NA,NA,NA,NA,NA,NA,NA,NA,"6379c60c70b54b8df2bfed1f9beac3fbfe2117f5","2020-03-16T20:00:00Z",NA,NA,7,7,7,15,0,0,0,5,5
"2143",20200316,"IA",22,83,NA,NA,NA,NA,NA,NA,NA,NA,"abdd281192ae660bb7cf448cc358f37058a4e726","2020-03-16T20:00:00Z",NA,NA,105,105,105,19,0,0,0,4,4
"2144",20200316,"ID",5,265,NA,NA,NA,NA,NA,NA,NA,NA,"cbadc8d7244f7abc2f70ffd4efcbd3930be6c7c3","2020-03-16T20:00:00Z",NA,NA,270,270,270,16,0,0,91,0,91
"2145",20200316,"IL",93,932,NA,NA,NA,NA,NA,NA,NA,NA,"f03443451f7889148543ffce5c6fb97993c13d33","2020-03-16T20:00:00Z",NA,NA,1025,1025,1025,17,0,0,483,29,512
"2146",20200316,"IN",24,115,NA,NA,NA,NA,NA,NA,NA,NA,"5476decd48ecb1589f9d22a297cf69d1bc5e0355","2020-03-16T20:00:00Z",1,NA,139,139,139,18,1,0,13,5,18
"2147",20200316,"KS",11,166,NA,NA,NA,NA,NA,NA,NA,NA,"2871e7c581aba789a9a80042471dbd062cd8b05a","2020-03-16T20:00:00Z",1,NA,177,177,177,20,0,0,31,3,34
"2148",20200316,"KY",21,234,NA,NA,NA,NA,NA,NA,NA,NA,"9faf39847096593b80a7c2410e9e5bc7f8ae66f2","2020-03-16T20:00:00Z",1,NA,255,255,255,21,1,0,95,5,100
"2149",20200316,"LA",114,188,NA,NA,NA,NA,NA,NA,NA,NA,"3f35dae7522ba88d8e79d20093816c3614734dcb","2020-03-16T20:00:00Z",2,NA,302,302,302,22,0,0,32,23,55
"2150",20200316,"MA",164,352,NA,NA,NA,NA,NA,NA,NA,NA,"8b6244ab6b03eb42a217d3342377e82b0051ad3c","2020-03-16T20:00:00Z",NA,NA,516,516,516,25,0,0,0,26,26
"2151",20200316,"MD",37,94,NA,NA,NA,NA,NA,NA,NA,NA,"8148e20f78522f18bb64c3736befeed3747a96b2","2020-03-16T20:00:00Z",NA,NA,131,131,131,24,0,0,0,6,6
"2152",20200316,"ME",17,764,NA,NA,NA,NA,NA,NA,NA,NA,"a6b88539313f6c2cd8136b76c0c53475b3b0dd34","2020-03-16T20:00:00Z",NA,NA,781,781,781,23,0,0,673,14,687
"2153",20200316,"MI",1933,272,30,NA,NA,NA,NA,NA,NA,NA,"29319d0631530d88b2c0b404a6419788640b7381","2020-03-16T20:00:00Z",NA,NA,2235,2205,2205,26,0,0,67,453,520
"2154",20200316,"MN",54,1839,NA,NA,NA,NA,NA,NA,NA,NA,"3419334f30420a634b19a07442d629553af687b3","2020-03-16T20:00:00Z",NA,NA,1893,1893,1893,27,0,0,452,19,471
"2155",20200316,"MO",6,164,NA,NA,NA,NA,NA,NA,NA,NA,"ef353ee3f27c62c9da40b468889b6e5f7873daf2","2020-03-16T20:00:00Z",0,NA,170,170,170,29,0,0,42,1,43
"2156",20200316,"MP",0,NA,NA,NA,NA,NA,NA,NA,NA,NA,"645c528660cf04b553855f4e4d0ab78f35e60078","2020-03-16T20:00:00Z",NA,NA,0,0,0,69,NA,NA,NA,NA,NA
"2157",20200316,"MS",12,277,NA,NA,NA,NA,NA,NA,NA,NA,"68fb32e431d415106a70ff158d981d8bb680d5ab","2020-03-16T20:00:00Z",NA,NA,289,289,289,28,0,0,193,2,195
"2158",20200316,"MT",7,198,NA,NA,NA,NA,NA,NA,NA,NA,"dee9f30c86457abd5cb9c810f7f31a3af246e5e2","2020-03-16T20:00:00Z",NA,NA,205,205,205,30,0,0,95,0,95
"2159",20200316,"NC",33,296,151,NA,NA,NA,NA,NA,NA,NA,"db9b565837a4d41e965e15ccb7b4d5063ae76924","2020-03-16T20:00:00Z",0,NA,480,329,329,37,0,0,69,1,70
"2160",20200316,"ND",1,123,0,NA,NA,NA,NA,NA,NA,NA,"41479c4ca4bf1f2bbc321cbe00058d9ca9ed023c","2020-03-16T20:00:00Z",0,NA,124,124,124,38,0,0,28,0,28
"2161",20200316,"NE",18,170,NA,NA,NA,NA,NA,NA,NA,NA,"27f99533a3a45cdfe5408436300f1d84dc36ee38","2020-03-16T20:00:00Z",NA,NA,188,188,188,31,0,0,90,1,91
"2162",20200316,"NH",13,271,95,NA,NA,NA,NA,NA,NA,NA,"6324e7ef14adbe0db61808a796bbc0e9d9373431","2020-03-16T20:00:00Z",NA,NA,379,284,284,33,0,0,0,0,0
"2163",20200316,"NJ",178,120,20,NA,NA,NA,NA,NA,NA,NA,"e3047f52c8b8718510b744979fca9f7ac16351b3","2020-03-16T20:00:00Z",2,NA,318,298,298,34,0,0,0,80,80
"2164",20200316,"NM",17,566,NA,NA,NA,NA,NA,NA,NA,NA,"48d7bfddefd90fde1d6499cc0b200237e976e758","2020-03-16T20:00:00Z",NA,NA,583,583,583,35,0,0,84,4,88
"2165",20200316,"NV",45,168,NA,NA,NA,NA,NA,NA,NA,NA,"203840ffb87a4baf59f78144da9357ea01a27ac2","2020-03-16T20:00:00Z",1,NA,213,213,213,32,1,0,0,24,24
"2166",20200316,"NY",950,4543,NA,NA,NA,NA,NA,NA,NA,NA,"994a65ba75be3681f76ff4612eb8fde85cff81cd","2020-03-16T20:00:00Z",7,NA,5493,5493,5493,36,4,0,0,221,221
"2167",20200316,"OH",50,140,361,NA,NA,NA,NA,NA,NA,NA,"70ad02c336e95158080519cbea8b21e47de47958","2020-03-16T20:00:00Z",NA,NA,551,190,190,39,0,0,1,14,15
"2168",20200316,"OK",10,174,29,NA,NA,NA,NA,NA,NA,NA,"e0d2929770055843abe54cd9ac80c1f407fdfcd3","2020-03-16T20:00:00Z",NA,NA,213,184,184,40,0,0,56,1,57
"2169",20200316,"OR",39,579,182,NA,NA,NA,NA,NA,NA,NA,"962d85e67d8cf64e5ef102b345d18ae50baa0624","2020-03-16T20:00:00Z",NA,NA,800,618,618,41,0,0,159,3,162
"2170",20200316,"PA",76,670,NA,NA,NA,NA,NA,NA,NA,NA,"96a8a61c47aef3aefddcc68815b03b9de9e6ffa7","2020-03-16T20:00:00Z",NA,NA,746,746,746,42,0,0,465,13,478
"2171",20200316,"PR",5,9,NA,NA,NA,NA,NA,NA,NA,NA,"be5aca3aa4f7fa2a722127a99ec083fd3b982671","2020-03-16T20:00:00Z",NA,NA,14,14,14,72,NA,NA,NA,NA,NA
"2172",20200316,"RI",21,308,149,NA,NA,NA,NA,NA,NA,NA,"e0244de4eb603b25d36700707a95bdb8289a5928","2020-03-16T20:00:00Z",NA,NA,478,329,329,44,0,0,37,1,38
"2173",20200316,"SC",28,235,NA,NA,NA,NA,NA,NA,NA,NA,"825f415faf293db6c2a614650fd3d37c694e56e8","2020-03-16T20:00:00Z",1,NA,263,263,263,45,1,0,81,9,90
"2174",20200316,"SD",10,494,0,NA,NA,NA,NA,NA,NA,NA,"b2a38c6ba820cb1329f93d990e27a8100d7b2fb5","2020-03-16T20:00:00Z",NA,NA,504,504,504,46,0,0,167,1,168
"2175",20200316,"TN",52,270,NA,NA,NA,NA,NA,NA,NA,NA,"9feabfdc22803b2d1bc85122f421cfcaa6b45cb7","2020-03-16T20:00:00Z",NA,NA,322,322,322,47,0,0,113,13,126
"2176",20200316,"TX",57,NA,NA,NA,NA,NA,NA,NA,NA,NA,"1f4d7ef872f54f1f40fe0560f536c9baa94b1637","2020-03-16T20:00:00Z",NA,NA,57,57,57,48,0,0,0,1,1
"2177",20200316,"UT",39,131,NA,NA,NA,NA,NA,NA,NA,NA,"3cf1e0acd5d5d07d3c45fa784a7e6f11796c467b","2020-03-16T20:00:00Z",0,NA,170,170,170,49,0,0,0,11,11
"2178",20200316,"VA",51,438,NA,NA,NA,NA,NA,NA,NA,NA,"097556061009dcaa83f48a5fbc6b952b751300fe","2020-03-16T20:00:00Z",1,NA,489,489,489,51,0,0,75,6,81
"2179",20200316,"VI",1,NA,NA,NA,NA,NA,NA,NA,NA,NA,"5af3baba47f6d5e3e1b4090940bb299a160a1c9f","2020-03-16T20:00:00Z",NA,NA,1,1,1,78,NA,NA,NA,NA,NA
"2180",20200316,"VT",8,421,NA,NA,NA,NA,NA,NA,NA,NA,"0bfc2ddcde18514ed799a3832e1136ca8bc745dc","2020-03-16T20:00:00Z",NA,NA,429,429,429,50,0,0,73,4,77
"2181",20200316,"WA",1066,9451,NA,NA,NA,NA,NA,NA,NA,NA,"f439125b63bc6f1e616146f18dae3d856ddbcfe1","2020-03-16T20:00:00Z",68,NA,10517,10517,10517,53,12,0,2329,128,2457
"2182",20200316,"WI",47,504,NA,NA,NA,NA,NA,NA,NA,NA,"a2e7539f5f950647edc9fab483be3672a3ca189e","2020-03-16T20:00:00Z",NA,NA,551,551,551,55,0,0,191,14,205
"2183",20200316,"WV",0,80,4,NA,NA,NA,NA,NA,NA,NA,"24af6da70ac0da2f7126fe3a29931ee7d556ffe6","2020-03-16T20:00:00Z",0,NA,84,80,80,54,0,0,42,0,42
"2184",20200316,"WY",3,NA,NA,NA,NA,NA,NA,NA,NA,NA,"b67f6088687e03e5ed66f4f27410a2bf8e4032f9","2020-03-16T20:00:00Z",NA,NA,3,3,3,56,0,0,0,0,0
"2185",20200315,"AK",1,143,NA,NA,NA,NA,NA,NA,NA,NA,"5c3a16f75070d1643f1528b5e75fb7dac0171d13","2020-03-15T20:00:00Z",0,NA,144,144,144,2,0,0,0,0,0
"2186",20200315,"AL",12,28,46,NA,NA,NA,NA,NA,NA,NA,"bc792edfeb4365aed8c64e6ff682049380018d28","2020-03-15T20:00:00Z",0,NA,86,40,40,1,0,0,6,6,12
"2187",20200315,"AR",16,103,30,NA,NA,NA,NA,NA,NA,NA,"35929378624bc11a7dd1d28474862f8edfab3a18","2020-03-15T20:00:00Z",NA,NA,149,119,119,5,0,0,38,4,42
"2188",20200315,"AZ",12,121,50,NA,NA,NA,NA,NA,NA,NA,"7a4427cac62eb283ec726e86ffa9fb6f331bac4a","2020-03-15T20:00:00Z",0,NA,183,133,133,4,0,0,0,0,0
"2189",20200315,"CA",293,916,NA,NA,NA,NA,NA,NA,NA,NA,"5e5e85687553cddbfc767524eedc40d04efeb98a","2020-03-15T20:00:00Z",5,NA,1209,1209,1209,6,0,0,0,41,41
"2190",20200315,"CO",131,627,NA,NA,NA,NA,NA,NA,NA,NA,"0da7e45df3e95846c2ea7d169ec15485902fe3b5","2020-03-15T20:00:00Z",1,NA,758,758,758,8,0,0,17,30,47
"2191",20200315,"CT",20,125,NA,NA,NA,NA,NA,NA,NA,NA,"47afb6e02464043555eaf5e2053829e84eb805be","2020-03-15T20:00:00Z",NA,NA,145,145,145,9,0,0,0,9,9
"2192",20200315,"DC",16,79,20,NA,NA,NA,NA,NA,NA,NA,"46da8be5fe41851c0bb75f94651e557a2f0c6386","2020-03-15T20:00:00Z",NA,NA,115,95,95,11,0,0,30,6,36
"2193",20200315,"DE",6,36,32,NA,NA,NA,NA,NA,NA,NA,"f5b3a2976e58c2202cc5aded47704c39fa65e343","2020-03-15T20:00:00Z",NA,NA,74,42,42,10,0,0,0,0,0
"2194",20200315,"FL",116,678,454,NA,NA,NA,NA,NA,NA,NA,"fbbf82f88fa5a3c2bbdf7f937c2752c5ba3ce6df","2020-03-15T20:00:00Z",4,NA,1248,794,794,12,1,0,200,39,239
"2195",20200315,"GA",99,NA,NA,NA,NA,NA,NA,NA,NA,NA,"df40a5921f9dfc96b45398288e6075bd6b97fd81","2020-03-15T20:00:00Z",1,NA,99,99,99,13,0,0,0,33,33
"2196",20200315,"HI",2,NA,NA,NA,NA,NA,NA,NA,NA,NA,"0a69a6018c0bce8b9bfbe6b1dd88a8f031a0a025","2020-03-15T20:00:00Z",NA,NA,2,2,2,15,0,0,0,0,0
"2197",20200315,"IA",18,83,NA,NA,NA,NA,NA,NA,NA,NA,"fdf73baeeb8118faed38a3ad4be3449414432f07","2020-03-15T20:00:00Z",NA,NA,101,101,101,19,0,0,0,1,1
"2198",20200315,"ID",5,174,NA,NA,NA,NA,NA,NA,NA,NA,"4472c728ff3ae897133063dc6b945fc03c35c382","2020-03-15T20:00:00Z",NA,NA,179,179,179,16,0,0,0,3,3
"2199",20200315,"IL",64,449,195,NA,NA,NA,NA,NA,NA,NA,"f6c2094de686cbf02f6bb9ac79925336ade7255e","2020-03-15T20:00:00Z",NA,NA,708,513,513,17,0,0,133,18,151
"2200",20200315,"IN",19,102,NA,NA,NA,NA,NA,NA,NA,NA,"d4516efe0a7e4050cd6326b64b549f9cb1923a61","2020-03-15T20:00:00Z",0,NA,121,121,121,18,0,0,28,4,32
"2201",20200315,"KS",8,135,NA,NA,NA,NA,NA,NA,NA,NA,"868c75937b225e6321886b68d3a125642646a48a","2020-03-15T20:00:00Z",1,NA,143,143,143,20,0,0,42,2,44
"2202",20200315,"KY",16,139,NA,NA,NA,NA,NA,NA,NA,NA,"d0dfc75f33be8db126e19af366618eaa6af0055b","2020-03-15T20:00:00Z",NA,NA,155,155,155,21,0,0,0,2,2
"2203",20200315,"LA",91,156,NA,NA,NA,NA,NA,NA,NA,NA,"e12d7af383c2482c7845ba7e6403df009076bfde","2020-03-15T20:00:00Z",2,NA,247,247,247,22,2,0,47,22,69
"2204",20200315,"MA",138,352,NA,NA,NA,NA,NA,NA,NA,NA,"c8c2486f9a55549e537cfa05abc2e5e2fe749397","2020-03-15T20:00:00Z",NA,NA,490,490,490,25,0,0,0,0,0
"2205",20200315,"MD",31,94,NA,NA,NA,NA,NA,NA,NA,NA,"12fc1449714a30e3dece18babc0d6f18a249ec11","2020-03-15T20:00:00Z",NA,NA,125,125,125,24,0,0,0,5,5
"2206",20200315,"ME",3,91,17,NA,NA,NA,NA,NA,NA,NA,"b9373f5ff8eecc4882df5e99ca65029c7ab54a5e","2020-03-15T20:00:00Z",NA,NA,111,94,94,23,0,0,0,0,0
"2207",20200315,"MI",1480,205,26,NA,NA,NA,NA,NA,NA,NA,"09fc24831d1175112329f54087d0a933591da80e","2020-03-15T20:00:00Z",NA,NA,1711,1685,1685,26,0,0,0,284,284
"2208",20200315,"MN",35,1387,NA,NA,NA,NA,NA,NA,NA,NA,"00afbc28ae28d28e85eb0ca606fac9847ee7eec5","2020-03-15T20:00:00Z",NA,NA,1422,1422,1422,27,0,0,540,14,554
"2209",20200315,"MO",5,122,NA,NA,NA,NA,NA,NA,NA,NA,"5ad3d82f98f7d9f284ef9895cb6f8e76d23c7f34","2020-03-15T20:00:00Z",0,NA,127,127,127,29,0,0,32,1,33
"2210",20200315,"MS",10,84,NA,NA,NA,NA,NA,NA,NA,NA,"5442e46cc16cedbeeb93a0f0ff9a04740dc62690","2020-03-15T20:00:00Z",NA,NA,94,94,94,28,0,0,0,4,4
"2211",20200315,"MT",7,103,57,NA,NA,NA,NA,NA,NA,NA,"d5c7b708dac192fb53a5453064d7c4fa04726b5d","2020-03-15T20:00:00Z",NA,NA,167,110,110,30,0,0,0,2,2
"2212",20200315,"NC",32,227,151,NA,NA,NA,NA,NA,NA,NA,"403dec9507ef0b9ac81864a597d016782cc2527b","2020-03-15T20:00:00Z",NA,NA,410,259,259,37,0,0,90,9,99
"2213",20200315,"ND",1,95,4,NA,NA,NA,NA,NA,NA,NA,"2745e3ea870fcafa773e34d392d65a6d79da5002","2020-03-15T20:00:00Z",0,NA,100,96,96,38,0,0,41,0,41
"2214",20200315,"NE",17,80,33,NA,NA,NA,NA,NA,NA,NA,"558bc35b9327ee76d681d0b1357e4c4f73ef8039","2020-03-15T20:00:00Z",NA,NA,130,97,97,31,0,0,0,3,3
"2215",20200315,"NH",13,271,95,NA,NA,NA,NA,NA,NA,NA,"803b79b258e66f237ca1ebf9a8fcde18477cac13","2020-03-15T20:00:00Z",NA,NA,379,284,284,33,0,0,59,6,65
"2216",20200315,"NJ",98,120,34,NA,NA,NA,NA,NA,NA,NA,"cb6357bcd5b00b85173d23a8bd8f41fdb1b098f0","2020-03-15T20:00:00Z",2,NA,252,218,218,34,1,0,23,48,71
"2217",20200315,"NM",13,482,NA,NA,NA,NA,NA,NA,NA,NA,"b95e350ae2b5693dcb353e7c00b01f855a971762","2020-03-15T20:00:00Z",NA,NA,495,495,495,35,0,0,245,3,248
"2218",20200315,"NV",21,168,164,NA,NA,NA,NA,NA,NA,NA,"5c87854db60a5e7331ad07237ca83ba7ebcf7af0","2020-03-15T20:00:00Z",NA,NA,353,189,189,32,0,0,0,1,1
"2219",20200315,"NY",729,4543,NA,NA,NA,NA,NA,NA,NA,NA,"963f632b5d1577cd5cf9b6c332a912c2fdebea16","2020-03-15T20:00:00Z",3,NA,5272,5272,5272,36,3,0,1764,205,1969
"2220",20200315,"OH",36,139,350,NA,NA,NA,NA,NA,NA,NA,"0f9665fdbfb9c2db97a7b8cca0dd02a8dd3fcd41","2020-03-15T20:00:00Z",NA,NA,525,175,175,39,0,0,89,23,112
"2221",20200315,"OK",9,118,12,NA,NA,NA,NA,NA,NA,NA,"c94b4a8b7a6943e47f2b18b0830094b3b5b847aa","2020-03-15T20:00:00Z",NA,NA,139,127,127,40,0,0,82,5,87
"2222",20200315,"OR",36,420,225,NA,NA,NA,NA,NA,NA,NA,"ee34e334d60acd6c6786608eaf502ef3469b027a","2020-03-15T20:00:00Z",NA,NA,681,456,456,41,0,0,83,6,89
"2223",20200315,"PA",63,205,183,NA,NA,NA,NA,NA,NA,NA,"b456aca3dcfc156e659cf9d83c9b906acb7c5ae5","2020-03-15T20:00:00Z",NA,NA,451,268,268,42,0,0,0,16,16
"2224",20200315,"RI",20,271,57,NA,NA,NA,NA,NA,NA,NA,"84f802e7560c1a892f234e2cb31b236fb075f6f5","2020-03-15T20:00:00Z",NA,NA,348,291,291,44,0,0,73,0,73
"2225",20200315,"SC",19,154,NA,NA,NA,NA,NA,NA,NA,NA,"75ba73b3bb3053eb03805d2812d5c2e4395f1b6f","2020-03-15T20:00:00Z",NA,NA,173,173,173,45,0,0,44,6,50
"2226",20200315,"SD",9,327,6,NA,NA,NA,NA,NA,NA,NA,"fa88e329d335599e26ea9fd7b6eea1fb83b0c06a","2020-03-15T20:00:00Z",NA,NA,342,336,336,46,0,0,145,0,145
"2227",20200315,"TN",39,157,NA,NA,NA,NA,NA,NA,NA,NA,"0d4cfb67c9ea0c68b1210ef9b0a90d12b748672f","2020-03-15T20:00:00Z",NA,NA,196,196,196,47,0,0,27,7,34
"2228",20200315,"TX",56,NA,NA,NA,NA,NA,NA,NA,NA,NA,"5703287c6d3b6d2f1e4e3de43cc125edafaa598a","2020-03-15T20:00:00Z",NA,NA,56,56,56,48,0,0,0,5,5
"2229",20200315,"UT",28,131,NA,NA,NA,NA,NA,NA,NA,NA,"557e214eba87dfaba62c598c539e3a281022e741","2020-03-15T20:00:00Z",0,NA,159,159,159,49,0,0,0,22,22
"2230",20200315,"VA",45,363,NA,NA,NA,NA,NA,NA,NA,NA,"8cb2bceeeb5e766ece4e5e0141e5c46174a1c784","2020-03-15T20:00:00Z",1,NA,408,408,408,51,1,0,246,15,261
"2231",20200315,"VT",4,348,NA,NA,NA,NA,NA,NA,NA,NA,"c240b0b7e625d08e14362a93fac37a9cb859d539","2020-03-15T20:00:00Z",NA,NA,352,352,352,50,0,0,121,0,121
"2232",20200315,"WA",938,7122,NA,NA,NA,NA,NA,NA,NA,NA,"811391c064aaf7be3d94b4dd41d13f12a7b199e0","2020-03-15T20:00:00Z",56,NA,8060,8060,8060,53,5,0,1121,133,1254
"2233",20200315,"WI",33,313,NA,NA,NA,NA,NA,NA,NA,NA,"76f9cefe3cbfb28b81648f15bcc59d6507801772","2020-03-15T20:00:00Z",NA,NA,346,346,346,55,0,0,144,14,158
"2234",20200315,"WV",0,38,1,NA,NA,NA,NA,NA,NA,NA,"36d80d812a5ba34def01d46af9f6a7760b182f43","2020-03-15T20:00:00Z",0,NA,39,38,38,54,0,0,12,0,12
"2235",20200315,"WY",3,NA,NA,NA,NA,NA,NA,NA,NA,NA,"74566767a2c99e0bdfd11a6e545fd9ed02e9e716","2020-03-15T20:00:00Z",NA,NA,3,3,3,56,0,0,0,1,1
"2236",20200314,"AK",1,143,NA,NA,NA,NA,NA,NA,NA,NA,"51927c4e4dbfbb223d7918b147e2506f73550900","2020-03-14T20:00:00Z",0,NA,144,144,144,2,0,0,84,0,84
"2237",20200314,"AL",6,22,46,NA,NA,NA,NA,NA,NA,NA,"5c89c1e4d5be4e39281e7629e2d8969f9d54bb00","2020-03-14T20:00:00Z",NA,NA,74,28,28,1,0,0,11,5,16
"2238",20200314,"AR",12,65,26,NA,NA,NA,NA,NA,NA,NA,"551428a90628981e98f1a49df229dc8e2a8a6bfe","2020-03-14T20:00:00Z",NA,NA,103,77,77,5,0,0,35,3,38
"2239",20200314,"AZ",12,121,50,NA,NA,NA,NA,NA,NA,NA,"c40ab8d2dcf6deaeecfa0bab73a691ec90124122","2020-03-14T20:00:00Z",0,NA,183,133,133,4,0,0,27,3,30
"2240",20200314,"CA",252,916,NA,NA,NA,NA,NA,NA,NA,NA,"bfe38009fc5e230d310f823f106a0947b1a2bce3","2020-03-14T20:00:00Z",5,NA,1168,1168,1168,6,1,0,0,50,50
"2241",20200314,"CO",101,610,NA,NA,NA,NA,NA,NA,NA,NA,"8247505b13764c1e92a341ef32b62d362e995ca1","2020-03-14T20:00:00Z",1,NA,711,711,711,8,1,0,86,29,115
"2242",20200314,"CT",11,125,NA,NA,NA,NA,NA,NA,NA,NA,"149bffa1dda5d74304599eb67e85167eb9cc7940","2020-03-14T20:00:00Z",NA,NA,136,136,136,9,0,0,26,5,31
"2243",20200314,"DC",10,49,10,NA,NA,NA,NA,NA,NA,NA,"8da2326fcb3ada2f8eb58b168fa3cfd71a21ad34","2020-03-14T20:00:00Z",NA,NA,69,59,59,11,0,0,29,0,29
"2244",20200314,"DE",6,36,32,NA,NA,NA,NA,NA,NA,NA,"ddc0cc501e0b9f023ee1294fe142fcf25fd092b9","2020-03-14T20:00:00Z",NA,NA,74,42,42,10,0,0,6,2,8
"2245",20200314,"FL",77,478,221,NA,NA,NA,NA,NA,NA,NA,"96d30f3427bff70e4f87d99ae5c42be36a0034ac","2020-03-14T20:00:00Z",3,NA,776,555,555,12,1,0,0,27,27
"2246",20200314,"GA",66,NA,NA,NA,NA,NA,NA,NA,NA,NA,"97be6babd64500d6ebd30859d68fc26fff2e4848","2020-03-14T20:00:00Z",1,NA,66,66,66,13,0,0,0,24,24
"2247",20200314,"HI",2,NA,NA,NA,NA,NA,NA,NA,NA,NA,"b958c9810a3946b62408f0111a12c70f54049101","2020-03-14T20:00:00Z",NA,NA,2,2,2,15,0,0,0,0,0
"2248",20200314,"IA",17,83,NA,NA,NA,NA,NA,NA,NA,NA,"e4c108405861a595205e19c9154417a48c5aae91","2020-03-14T20:00:00Z",NA,NA,100,100,100,19,0,0,0,1,1
"2249",20200314,"ID",2,174,NA,NA,NA,NA,NA,NA,NA,NA,"952932b75b80cd3991df8a8c7db4f64acce89d58","2020-03-14T20:00:00Z",NA,NA,176,176,176,16,0,0,43,2,45
"2250",20200314,"IL",46,316,82,NA,NA,NA,NA,NA,NA,NA,"9ce71ff3b9101f5ced145411c578a9b370c032a8","2020-03-14T20:00:00Z",NA,NA,444,362,362,17,0,0,22,14,36
"2251",20200314,"IN",15,74,NA,NA,NA,NA,NA,NA,NA,NA,"14f3f66fde7e3e752f7f5e81e40cb946e7bca3af","2020-03-14T20:00:00Z",0,NA,89,89,89,18,0,0,13,3,16
"2252",20200314,"KS",6,93,NA,NA,NA,NA,NA,NA,NA,NA,"278e3c9e3e9f10641ced32dcb4caaa1d4a3b141d","2020-03-14T20:00:00Z",1,NA,99,99,99,20,1,0,0,0,0
"2253",20200314,"KY",14,139,NA,NA,NA,NA,NA,NA,NA,NA,"53ea76cd7050bee2da9a57fca2b4538d1926af6d","2020-03-14T20:00:00Z",NA,NA,153,153,153,21,0,0,32,3,35
"2254",20200314,"LA",69,109,NA,NA,NA,NA,NA,NA,NA,NA,"c80c2be31c70d2b05d47fb0b55f9297f827690f7","2020-03-14T20:00:00Z",NA,NA,178,178,178,22,0,0,72,33,105
"2255",20200314,"MA",138,352,NA,NA,NA,NA,NA,NA,NA,NA,"bdba6fc0046699f5419368f4eb93e84eb0f025c5","2020-03-14T20:00:00Z",NA,NA,490,490,490,25,0,0,260,15,275
"2256",20200314,"MD",26,94,NA,NA,NA,NA,NA,NA,NA,NA,"8fefdbf242c49256c9711173cc7a195bdfeaf897","2020-03-14T20:00:00Z",NA,NA,120,120,120,24,0,0,0,9,9
"2257",20200314,"ME",3,91,17,NA,NA,NA,NA,NA,NA,NA,"f8e0701ef750fd7833940e085f356967698a709e","2020-03-14T20:00:00Z",NA,NA,111,94,94,23,0,0,0,0,0
"2258",20200314,"MI",1196,205,26,NA,NA,NA,NA,NA,NA,NA,"3d48e2414257cbaf0f316c284d283c7c64c15194","2020-03-14T20:00:00Z",NA,NA,1427,1401,1401,26,0,0,72,251,323
"2259",20200314,"MN",21,847,NA,NA,NA,NA,NA,NA,NA,NA,"43db9c125581cdb0eaed4688c2bcc3692d524ccd","2020-03-14T20:00:00Z",NA,NA,868,868,868,27,0,0,306,7,313
"2260",20200314,"MO",4,90,NA,NA,NA,NA,NA,NA,NA,NA,"5220c08925c1338bbc1ababb24afaf6558a68b9c","2020-03-14T20:00:00Z",0,NA,94,94,94,29,0,0,19,2,21
"2261",20200314,"MS",6,84,NA,NA,NA,NA,NA,NA,NA,NA,"262146bdcf966d7bd2b95df77b8c19d904242248","2020-03-14T20:00:00Z",NA,NA,90,90,90,28,0,0,43,2,45
"2262",20200314,"MT",5,103,NA,NA,NA,NA,NA,NA,NA,NA,"3b3767d29a7f2c8246d957b64ab51b460e66230c","2020-03-14T20:00:00Z",NA,NA,108,108,108,30,0,0,48,4,52
"2263",20200314,"NC",23,137,NA,NA,NA,NA,NA,NA,NA,NA,"1097b4e88ff28fd47bd79effc50736bcc4f98d4d","2020-03-14T20:00:00Z",NA,NA,160,160,160,37,0,0,51,8,59
"2264",20200314,"ND",1,54,14,NA,NA,NA,NA,NA,NA,NA,"a52a443da4b61469c6be7d12ad2fe848c421dd0f","2020-03-14T20:00:00Z",0,NA,69,55,55,38,0,0,15,0,15
"2265",20200314,"NE",14,80,33,NA,NA,NA,NA,NA,NA,NA,"936f44463ab4c62d7cf30fc400ef265c45f8b3f5","2020-03-14T20:00:00Z",NA,NA,127,94,94,31,0,0,0,1,1
"2266",20200314,"NH",7,212,31,NA,NA,NA,NA,NA,NA,NA,"8df5e37a5d8dabbb6fb2821a99d3d0d90b27fc85","2020-03-14T20:00:00Z",NA,NA,250,219,219,33,0,0,118,1,119
"2267",20200314,"NJ",50,97,80,NA,NA,NA,NA,NA,NA,NA,"0b8634c5fd4e1160dde841c792bf7c6fc9315232","2020-03-14T20:00:00Z",1,NA,227,147,147,34,0,0,0,0,0
"2268",20200314,"NM",10,237,NA,NA,NA,NA,NA,NA,NA,NA,"0085a52176e881bb6ad037e0c30af4f74d9489f9","2020-03-14T20:00:00Z",NA,NA,247,247,247,35,0,0,47,0,47
"2269",20200314,"NV",20,168,NA,NA,NA,NA,NA,NA,NA,NA,"2e60e44122a1faf4a4351249cef4569aeb6b4a89","2020-03-14T20:00:00Z",NA,NA,188,188,188,32,0,0,0,9,9
"2270",20200314,"NY",524,2779,NA,NA,NA,NA,NA,NA,NA,NA,"f28c39ca671c26d022ff2556494ad8767765eb93","2020-03-14T20:00:00Z",NA,NA,3303,3303,3303,36,0,0,0,103,103
"2271",20200314,"OH",13,50,159,NA,NA,NA,NA,NA,NA,NA,"fc63d6218734893ad458fb97af8018f3a1ec1ad5","2020-03-14T20:00:00Z",NA,NA,222,63,63,39,0,0,0,0,0
"2272",20200314,"OK",4,36,37,NA,NA,NA,NA,NA,NA,NA,"c73b103132566a7e2d3c71510adc6def73b88940","2020-03-14T20:00:00Z",NA,NA,77,40,40,40,0,0,0,1,1
"2273",20200314,"OR",30,337,157,NA,NA,NA,NA,NA,NA,NA,"1400911ca9d80be2f8e342c113a1df4d70338602","2020-03-14T20:00:00Z",NA,NA,524,367,367,41,0,0,0,0,0
"2274",20200314,"PA",47,205,150,NA,NA,NA,NA,NA,NA,NA,"d18f94522023cea299270dcc1602530f2ddc0dc4","2020-03-14T20:00:00Z",NA,NA,402,252,252,42,0,0,65,6,71
"2275",20200314,"RI",20,198,57,NA,NA,NA,NA,NA,NA,NA,"398dbebda7a13f625f8978b5e493f80fa0c06bc4","2020-03-14T20:00:00Z",NA,NA,275,218,218,44,0,0,56,6,62
"2276",20200314,"SC",13,110,NA,NA,NA,NA,NA,NA,NA,NA,"f59023a910249b3d8b3511ae10d8f11517a1c519","2020-03-14T20:00:00Z",NA,NA,123,123,123,45,0,0,35,1,36
"2277",20200314,"SD",9,182,3,NA,NA,NA,NA,NA,NA,NA,"df4f632f3d3f47fd86232363e123ffd6096af646","2020-03-14T20:00:00Z",NA,NA,194,191,191,46,0,0,109,0,109
"2278",20200314,"TN",32,130,NA,NA,NA,NA,NA,NA,NA,NA,"6becf2091344bee8d3a7f0a0a437ccf76ed9dd53","2020-03-14T20:00:00Z",NA,NA,162,162,162,47,0,0,14,6,20
"2279",20200314,"TX",51,NA,NA,NA,NA,NA,NA,NA,NA,NA,"8a47a6e610ae58718993de453b89aa3908c67fbd","2020-03-14T20:00:00Z",NA,NA,51,51,51,48,0,0,0,12,12
"2280",20200314,"UT",6,131,NA,NA,NA,NA,NA,NA,NA,NA,"577b43eb324c0ae69322cc15f477ca37d5daf36b","2020-03-14T20:00:00Z",NA,NA,137,137,137,49,0,0,0,0,0
"2281",20200314,"VA",30,117,NA,NA,NA,NA,NA,NA,NA,NA,"33f505467e5a143bd0ecda4d5622091a48ad3d2e","2020-03-14T20:00:00Z",NA,NA,147,147,147,51,0,0,0,0,0
"2282",20200314,"VT",4,227,NA,NA,NA,NA,NA,NA,NA,NA,"570d73d25152c4e93987f89a83b40ff5480a7682","2020-03-14T20:00:00Z",NA,NA,231,231,231,50,0,0,85,2,87
"2283",20200314,"WA",805,6001,NA,NA,NA,NA,NA,NA,NA,NA,"45120a7b2a4b15e85fd1aae8c703f01db9b5fba7","2020-03-14T20:00:00Z",51,NA,6806,6806,6806,53,4,0,1651,104,1755
"2284",20200314,"WI",19,169,NA,NA,NA,NA,NA,NA,NA,NA,"8f1ed69b1d5723cbd5b18d1ec332fa4f83bde08a","2020-03-14T20:00:00Z",NA,NA,188,188,188,55,0,0,0,0,0
"2285",20200314,"WV",0,26,5,NA,NA,NA,NA,NA,NA,NA,"7e27957cf04398b64db2982ccd580fd5455ffebb","2020-03-14T20:00:00Z",NA,NA,31,26,26,54,0,0,9,0,9
"2286",20200314,"WY",2,NA,NA,NA,NA,NA,NA,NA,NA,NA,"00d1959cf22a0162be10edb9d849b320e1db37e7","2020-03-14T20:00:00Z",NA,NA,2,2,2,56,0,0,0,1,1
"2287",20200313,"AK",1,59,NA,NA,NA,NA,NA,NA,NA,NA,"96bc2169cdd09b20fceb23dd67dc70a956094851","2020-03-13T20:00:00Z",0,NA,60,60,60,2,0,0,13,1,14
"2288",20200313,"AL",1,11,NA,NA,NA,NA,NA,NA,NA,NA,"b9e856f0b5f6b1893dbe080ee99cbebd5723f4f8","2020-03-13T20:00:00Z",NA,NA,12,12,12,1,0,0,1,1,2
"2289",20200313,"AR",9,30,22,NA,NA,NA,NA,NA,NA,NA,"a6aff5e9908d4f1a167655d035338e838ba8cdba","2020-03-13T20:00:00Z",NA,NA,61,39,39,5,0,0,6,3,9
"2290",20200313,"AZ",9,94,40,NA,NA,NA,NA,NA,NA,NA,"68c52c41afcca5a93045251c1a7e05b086b85767","2020-03-13T20:00:00Z",0,NA,143,103,103,4,0,0,12,0,12
"2291",20200313,"CA",202,916,NA,NA,NA,NA,NA,NA,NA,NA,"bb817225b0e56a4c1051b2e6550b5ae85e06487c","2020-03-13T20:00:00Z",4,NA,1118,1118,1118,6,0,0,0,0,0
"2292",20200313,"CO",72,524,NA,NA,NA,NA,NA,NA,NA,NA,"f081206fdd232801c4719c7b15f928e95e16c0a4","2020-03-13T20:00:00Z",NA,NA,596,596,596,8,0,0,226,27,253
"2293",20200313,"CT",6,99,NA,NA,NA,NA,NA,NA,NA,NA,"682c544537c9fb686f945084a154361a3c8a386f","2020-03-13T20:00:00Z",NA,NA,105,105,105,9,0,0,10,0,10
"2294",20200313,"DC",10,20,NA,NA,NA,NA,NA,NA,NA,NA,"47405f5c12651491f7aaeeadcf98a21f5290298e","2020-03-13T20:00:00Z",NA,NA,30,30,30,11,0,0,0,0,0
"2295",20200313,"DE",4,30,10,NA,NA,NA,NA,NA,NA,NA,"01a39bf98baae6616556fc98432b0eab5ec19d21","2020-03-13T20:00:00Z",NA,NA,44,34,34,10,0,0,7,0,7
"2296",20200313,"FL",50,478,221,NA,NA,NA,NA,NA,NA,NA,"e2f015841b99a9056a83e88b541e2f27fe57bdea","2020-03-13T20:00:00Z",2,NA,749,528,528,12,0,0,177,18,195
"2297",20200313,"GA",42,NA,NA,NA,NA,NA,NA,NA,NA,NA,"a1b71ddadb4a8d03aab0ae5ee76889c2cdefe5bf","2020-03-13T20:00:00Z",1,NA,42,42,42,13,1,0,0,11,11
"2298",20200313,"HI",2,NA,NA,NA,NA,NA,NA,NA,NA,NA,"d517fed5e44222b8e9ec35423adff6841571d310","2020-03-13T20:00:00Z",NA,NA,2,2,2,15,0,0,0,0,0
"2299",20200313,"IA",16,83,29,NA,NA,NA,NA,NA,NA,NA,"9a4dc657b7cf736b9c1a23162cb7bd246891b602","2020-03-13T20:00:00Z",NA,NA,128,99,99,19,0,0,16,2,18
"2300",20200313,"ID",0,131,NA,NA,NA,NA,NA,NA,NA,NA,"b1671d598b98d1510491784f4c280a368ba8c39e","2020-03-13T20:00:00Z",NA,NA,131,131,131,16,0,0,38,0,38
"2301",20200313,"IL",32,294,92,NA,NA,NA,NA,NA,NA,NA,"3a4c6b2710e412f845b0c387c44def3dba4d011b","2020-03-13T20:00:00Z",NA,NA,418,326,326,17,0,0,28,7,35
"2302",20200313,"IN",12,61,NA,NA,NA,NA,NA,NA,NA,NA,"6a95bce7fff18ca959c83513dc8e4b4b8458d719","2020-03-13T20:00:00Z",NA,NA,73,73,73,18,0,0,9,0,9
"2303",20200313,"KS",6,93,NA,NA,NA,NA,NA,NA,NA,NA,"8633a26e1f484f8d6832c17efdb6e638ffb3515e","2020-03-13T20:00:00Z",NA,NA,99,99,99,20,0,0,52,2,54
"2304",20200313,"KY",11,107,NA,NA,NA,NA,NA,NA,NA,NA,"4d515c6fe8ed706c415382ef87cfa9236ac4e09c","2020-03-13T20:00:00Z",NA,NA,118,118,118,21,0,0,51,3,54
"2305",20200313,"LA",36,37,NA,NA,NA,NA,NA,NA,NA,NA,"78393fa814aa0caf1ae4f6056e80e21adf672bf2","2020-03-13T20:00:00Z",NA,NA,73,73,73,22,0,0,0,22,22
"2306",20200313,"MA",123,92,NA,NA,NA,NA,NA,NA,NA,NA,"020263557685d33ade8e1849eeb35c2a8a12843a","2020-03-13T20:00:00Z",NA,NA,215,215,215,25,0,0,92,28,120
"2307",20200313,"MD",17,94,NA,NA,NA,NA,NA,NA,NA,NA,"32d329849128913476d4a0773fea76a4b3e2b083","2020-03-13T20:00:00Z",NA,NA,111,111,111,24,0,0,0,5,5
"2308",20200313,"ME",3,91,17,NA,NA,NA,NA,NA,NA,NA,"8ecdd4f1eb3ad0874071c97b48e3bc8ae16edf37","2020-03-13T20:00:00Z",NA,NA,111,94,94,23,0,0,26,2,28
"2309",20200313,"MI",945,133,26,NA,NA,NA,NA,NA,NA,NA,"f532160c7cd2aba3ca450b21c2c4a81099342d44","2020-03-13T20:00:00Z",NA,NA,1104,1078,1078,26,0,0,42,243,285
"2310",20200313,"MN",14,541,NA,NA,NA,NA,NA,NA,NA,NA,"094cc2b8f1b021d450e7d7fa08596000fc7f4e05","2020-03-13T20:00:00Z",NA,NA,555,555,555,27,0,0,234,5,239
"2311",20200313,"MO",2,71,NA,NA,NA,NA,NA,NA,NA,NA,"4d53392cae812d4039af40a07e38bc5fe77212fb","2020-03-13T20:00:00Z",NA,NA,73,73,73,29,0,0,7,1,8
"2312",20200313,"MS",4,41,NA,NA,NA,NA,NA,NA,NA,NA,"9fc8f265d6c9e8b4883399e23c0b0190c2686599","2020-03-13T20:00:00Z",NA,NA,45,45,45,28,0,0,0,3,3
"2313",20200313,"MT",1,55,NA,NA,NA,NA,NA,NA,NA,NA,"3190b3a30f1124eebbb4e9bccd677cf22f2ae6c0","2020-03-13T20:00:00Z",NA,NA,56,56,56,30,0,0,21,0,21
"2314",20200313,"NC",15,86,NA,NA,NA,NA,NA,NA,NA,NA,"9b22973bdb1a321a3b9cc273f6250675bf95124b","2020-03-13T20:00:00Z",NA,NA,101,101,101,37,0,0,26,3,29
"2315",20200313,"ND",1,39,12,NA,NA,NA,NA,NA,NA,NA,"16823997d9c4db1ae19dccaba18481746cfe85cf","2020-03-13T20:00:00Z",0,NA,52,40,40,38,0,0,27,0,27
"2316",20200313,"NE",13,80,33,NA,NA,NA,NA,NA,NA,NA,"72bf9214dd1c1c24ce38fd46893604d18cc124f7","2020-03-13T20:00:00Z",NA,NA,126,93,93,31,0,0,0,3,3
"2317",20200313,"NH",6,94,21,NA,NA,NA,NA,NA,NA,NA,"ce083d3bb0b226ff0599d533768ad2b62f892b40","2020-03-13T20:00:00Z",NA,NA,121,100,100,33,0,0,0,0,0
"2318",20200313,"NJ",50,97,80,NA,NA,NA,NA,NA,NA,NA,"dd9375b158d3020716fe7e1d759d510332c818e3","2020-03-13T20:00:00Z",1,NA,227,147,147,34,0,0,23,20,43
"2319",20200313,"NM",10,190,NA,NA,NA,NA,NA,NA,NA,NA,"5e21e22aacd1a08b396a2c457c553776e3c8bedf","2020-03-13T20:00:00Z",NA,NA,200,200,200,35,0,0,35,5,40
"2320",20200313,"NV",11,168,NA,NA,NA,NA,NA,NA,NA,NA,"5c86c34f504be7bf2a593223447a7f2d5f18877a","2020-03-13T20:00:00Z",NA,NA,179,179,179,32,0,0,0,4,4
"2321",20200313,"NY",421,2779,NA,NA,NA,NA,NA,NA,NA,NA,"a0a0e2997c411014ef2cd98b9502387730f585c7","2020-03-13T20:00:00Z",NA,NA,3200,3200,3200,36,0,0,2687,205,2892
"2322",20200313,"OH",13,50,159,NA,NA,NA,NA,NA,NA,NA,"fe5ed1e40f012163a6510cabdea90e044e5e56ab","2020-03-13T20:00:00Z",NA,NA,222,63,63,39,0,0,20,8,28
"2323",20200313,"OK",3,36,37,NA,NA,NA,NA,NA,NA,NA,"41b22c1ee50041708e574581687a0c4155caa8aa","2020-03-13T20:00:00Z",NA,NA,76,39,39,40,0,0,0,0,0
"2324",20200313,"OR",30,337,157,NA,NA,NA,NA,NA,NA,NA,"ee29420a1ee3ce2e33cdf966ecbdfc575d26206b","2020-03-13T20:00:00Z",NA,NA,524,367,367,41,0,0,51,11,62
"2325",20200313,"PA",41,140,130,NA,NA,NA,NA,NA,NA,NA,"1b1cf720a3254db83abcb451d397a731f9fdf38a","2020-03-13T20:00:00Z",NA,NA,311,181,181,42,0,0,24,19,43
"2326",20200313,"RI",14,142,29,NA,NA,NA,NA,NA,NA,NA,"3b21b07952531010abf6628fe837a9f97fd33797","2020-03-13T20:00:00Z",NA,NA,185,156,156,44,0,0,48,9,57
"2327",20200313,"SC",12,75,NA,NA,NA,NA,NA,NA,NA,NA,"89ac68f7349872023eb4ba7e8d49e17e3221b4cc","2020-03-13T20:00:00Z",NA,NA,87,87,87,45,0,0,27,2,29
"2328",20200313,"SD",9,73,11,NA,NA,NA,NA,NA,NA,NA,"9a7c944cb0774212146d5eecb0aa11b12de52eb6","2020-03-13T20:00:00Z",NA,NA,93,82,82,46,0,0,46,1,47
"2329",20200313,"TN",26,116,NA,NA,NA,NA,NA,NA,NA,NA,"5dd412ea26ef8d20d55a6410d59726087883cd99","2020-03-13T20:00:00Z",NA,NA,142,142,142,47,0,0,37,8,45
"2330",20200313,"TX",39,NA,NA,NA,NA,NA,NA,NA,NA,NA,"3964195c15cc0e37c244f112bcbae5789a5c6489","2020-03-13T20:00:00Z",NA,NA,39,39,39,48,0,0,0,16,16
"2331",20200313,"UT",6,131,NA,NA,NA,NA,NA,NA,NA,NA,"610050cffa209508ec65a9bf756ef16d617d69c5","2020-03-13T20:00:00Z",NA,NA,137,137,137,49,0,0,0,2,2
"2332",20200313,"VA",30,117,NA,NA,NA,NA,NA,NA,NA,NA,"d2ecd673874966076229036999033a3993ffed2b","2020-03-13T20:00:00Z",NA,NA,147,147,147,51,0,0,0,13,13
"2333",20200313,"VT",2,142,NA,NA,NA,NA,NA,NA,NA,NA,"a02dcfb55e5f9ed028f6328c61b41408533038c1","2020-03-13T20:00:00Z",NA,NA,144,144,144,50,0,0,45,0,45
"2334",20200313,"WA",701,4350,NA,NA,NA,NA,NA,NA,NA,NA,"e18d5f2015cd595bad1892b3463118dc15e98af0","2020-03-13T20:00:00Z",47,NA,5051,5051,5051,53,3,0,1313,151,1464
"2335",20200313,"WI",19,169,NA,NA,NA,NA,NA,NA,NA,NA,"3936ef13cd65e7b15ac22d0d981357b9f6dcce8d","2020-03-13T20:00:00Z",NA,NA,188,188,188,55,0,0,85,11,96
"2336",20200313,"WV",0,17,4,NA,NA,NA,NA,NA,NA,NA,"10eb8c5e07049f2c299d03ef30ceb60a49142335","2020-03-13T20:00:00Z",NA,NA,21,17,17,54,0,0,10,0,10
"2337",20200313,"WY",1,NA,NA,NA,NA,NA,NA,NA,NA,NA,"610cc4a0b9c9015f6214bfe928f0acf116f8b75c","2020-03-13T20:00:00Z",NA,NA,1,1,1,56,0,0,0,0,0
"2338",20200312,"AK",0,46,14,NA,NA,NA,NA,NA,NA,NA,"89cc53e36928b9f7a247981e3f6540630bbf521e","2020-03-12T20:00:00Z",0,NA,60,46,46,2,0,0,0,0,0
"2339",20200312,"AL",0,10,NA,NA,NA,NA,NA,NA,NA,NA,"34204c36040e342af491e5329aca50e88f2cbaba","2020-03-12T20:00:00Z",NA,NA,10,10,10,1,0,0,0,0,0
"2340",20200312,"AR",6,24,20,NA,NA,NA,NA,NA,NA,NA,"fe5ece5453dac3d08b87f1ab7a10e00bf7cfdfc9","2020-03-12T20:00:00Z",NA,NA,50,30,30,5,0,0,12,6,18
"2341",20200312,"AZ",9,82,24,NA,NA,NA,NA,NA,NA,NA,"542a30820399e2d4ec7a2787e6760577326f402d","2020-03-12T20:00:00Z",NA,NA,115,91,91,4,0,0,23,0,23
"2342",20200312,"CA",202,916,NA,NA,NA,NA,NA,NA,NA,NA,"8dd3541eb41a6171cc6bbf05632f8d9bb4570490","2020-03-12T20:00:00Z",4,NA,1118,1118,1118,6,4,0,0,45,45
"2343",20200312,"CO",45,298,NA,NA,NA,NA,NA,NA,NA,NA,"fef01602b9d42355347ffd39fc33776f6d251c7e","2020-03-12T20:00:00Z",NA,NA,343,343,343,8,0,0,47,17,64
"2344",20200312,"CT",6,89,NA,NA,NA,NA,NA,NA,NA,NA,"438f9707c60dbf6c5042c0686dfa479170d3471a","2020-03-12T20:00:00Z",NA,NA,95,95,95,9,0,0,18,3,21
"2345",20200312,"DC",10,20,NA,NA,NA,NA,NA,NA,NA,NA,"2afd9cde94fa8693b5eb2da4552eecf9452ad2c0","2020-03-12T20:00:00Z",NA,NA,30,30,30,11,0,0,0,5,5
"2346",20200312,"DE",4,23,14,NA,NA,NA,NA,NA,NA,NA,"0cfca14a0bd4e74cc01ef2a9030f65643237496d","2020-03-12T20:00:00Z",NA,NA,41,27,27,10,0,0,6,3,9
"2347",20200312,"FL",32,301,147,NA,NA,NA,NA,NA,NA,NA,"e30f5e735d56d705f8ed9768797ed07fc2d8173a","2020-03-12T20:00:00Z",2,NA,480,333,333,12,0,0,0,4,4
"2348",20200312,"GA",31,NA,NA,NA,NA,NA,NA,NA,NA,NA,"b54e3a842da88ee7e2685e1625d6b47466982662","2020-03-12T20:00:00Z",NA,NA,31,31,31,13,0,0,0,9,9
"2349",20200312,"HI",2,NA,NA,NA,NA,NA,NA,NA,NA,NA,"448f4f6242f8f4d56b53911f8f41f857fea624ad","2020-03-12T20:00:00Z",NA,NA,2,2,2,15,0,0,0,0,0
"2350",20200312,"IA",14,67,24,NA,NA,NA,NA,NA,NA,NA,"c66bca36e23ed4238801da6edce433a068219c83","2020-03-12T20:00:00Z",NA,NA,105,81,81,19,0,0,21,1,22
"2351",20200312,"ID",0,93,NA,NA,NA,NA,NA,NA,NA,NA,"ea688b0e32219776fd27b38e03bee45e42111379","2020-03-12T20:00:00Z",NA,NA,93,93,93,16,0,0,26,0,26
"2352",20200312,"IL",25,266,76,NA,NA,NA,NA,NA,NA,NA,"f521fa0222b25b297e082e1285cb6efc89a5b552","2020-03-12T20:00:00Z",NA,NA,367,291,291,17,0,0,22,6,28
"2353",20200312,"IN",12,52,NA,NA,NA,NA,NA,NA,NA,NA,"dcfcf297a028962a948869e94197bbe14be0bd93","2020-03-12T20:00:00Z",NA,NA,64,64,64,18,0,0,19,2,21
"2354",20200312,"KS",4,41,NA,NA,NA,NA,NA,NA,NA,NA,"332ee3bb9b5f431704d8cd139631096cf6e7551b","2020-03-12T20:00:00Z",NA,NA,45,45,45,20,0,0,0,3,3
"2355",20200312,"KY",8,56,NA,NA,NA,NA,NA,NA,NA,NA,"cebe01b90cd5896a2bdea84cba4ee4b563f24ee9","2020-03-12T20:00:00Z",NA,NA,64,64,64,21,0,0,10,0,10
"2356",20200312,"LA",14,37,NA,NA,NA,NA,NA,NA,NA,NA,"90d5fc83d9f4c831c653f38b96e49251057d9cb7","2020-03-12T20:00:00Z",NA,NA,51,51,51,22,0,0,0,8,8
"2357",20200312,"MA",95,NA,NA,NA,NA,NA,NA,NA,NA,NA,"2b11362fc52b477bca21e635eb9f2b88e8a5d61f","2020-03-12T20:00:00Z",NA,NA,95,95,95,25,0,0,0,3,3
"2358",20200312,"MD",12,94,NA,NA,NA,NA,NA,NA,NA,NA,"08b84f6b613a011507c9190271ec545191ee68bb","2020-03-12T20:00:00Z",NA,NA,106,106,106,24,0,0,0,3,3
"2359",20200312,"ME",1,65,20,NA,NA,NA,NA,NA,NA,NA,"b39c56076bac0a4ddd2e88d3f04d0c785d75732d","2020-03-12T20:00:00Z",NA,NA,86,66,66,23,0,0,23,1,24
"2360",20200312,"MI",702,91,27,NA,NA,NA,NA,NA,NA,NA,"74155341404d09da59405465245832fca16f954b","2020-03-12T20:00:00Z",NA,NA,820,793,793,26,0,0,34,205,239
"2361",20200312,"MN",9,307,NA,NA,NA,NA,NA,NA,NA,NA,"523bdda158c8db3de757d18a38756ffe1ce9b21b","2020-03-12T20:00:00Z",NA,NA,316,316,316,27,0,0,90,4,94
"2362",20200312,"MO",1,64,NA,NA,NA,NA,NA,NA,NA,NA,"5b415b8bf401db354d5f6a778e699e7eb170976d","2020-03-12T20:00:00Z",NA,NA,65,65,65,29,0,0,64,0,64
"2363",20200312,"MS",1,41,NA,NA,NA,NA,NA,NA,NA,NA,"6aad8ec86cdaa93329eeda6aa46670dd6ca609b1","2020-03-12T20:00:00Z",NA,NA,42,42,42,28,0,0,21,1,22
"2364",20200312,"MT",1,34,NA,NA,NA,NA,NA,NA,NA,NA,"4b8bef9b3d9fa1079cbd7be5288076fb401598c1","2020-03-12T20:00:00Z",NA,NA,35,35,35,30,0,0,13,1,14
"2365",20200312,"NC",12,60,NA,NA,NA,NA,NA,NA,NA,NA,"7442624a12322777c7110f0101d61d097da12ade","2020-03-12T20:00:00Z",NA,NA,72,72,72,37,0,0,60,5,65
"2366",20200312,"ND",1,12,14,NA,NA,NA,NA,NA,NA,NA,"101ef2bb022ea0209aaa020d3e2852b8964d9134","2020-03-12T20:00:00Z",NA,NA,27,13,13,38,0,0,5,1,6
"2367",20200312,"NE",10,80,33,NA,NA,NA,NA,NA,NA,NA,"a4238a2a6795e1cd4e971a336c36e526d59e25d7","2020-03-12T20:00:00Z",NA,NA,123,90,90,31,0,0,33,5,38
"2368",20200312,"NH",6,94,21,NA,NA,NA,NA,NA,NA,NA,"7e575bc7e2ffdb783ca744e42ac10956980b5aba","2020-03-12T20:00:00Z",NA,NA,121,100,100,33,0,0,56,2,58
"2369",20200312,"NJ",30,74,20,NA,NA,NA,NA,NA,NA,NA,"5f40e6cdda7648d658eedd3a5e5bf0f027c9b374","2020-03-12T20:00:00Z",1,NA,124,104,104,34,0,0,17,6,23
"2370",20200312,"NM",5,155,NA,NA,NA,NA,NA,NA,NA,NA,"d358c1f38d0d81a3f4719e9a593a533ccee69a30","2020-03-12T20:00:00Z",NA,NA,160,160,160,35,0,0,68,2,70
"2371",20200312,"NV",7,168,NA,NA,NA,NA,NA,NA,NA,NA,"8328b62027a10326d300d9fbe07f651846ae2f52","2020-03-12T20:00:00Z",NA,NA,175,175,175,32,0,0,0,2,2
"2372",20200312,"NY",216,92,NA,NA,NA,NA,NA,NA,NA,NA,"78ea2217b81c0eba25ec04b1196199ad81793ead","2020-03-12T20:00:00Z",NA,NA,308,308,308,36,0,0,0,0,0
"2373",20200312,"OH",5,30,52,NA,NA,NA,NA,NA,NA,NA,"e53fb02834680a20508e2d3bf535470016d3407a","2020-03-12T20:00:00Z",NA,NA,87,35,35,39,0,0,9,1,10
"2374",20200312,"OK",3,36,4,NA,NA,NA,NA,NA,NA,NA,"0695ce1aed2deb9062e4a75ce05c7d5fbb2b3975","2020-03-12T20:00:00Z",NA,NA,43,39,39,40,0,0,21,1,22
"2375",20200312,"OR",19,286,62,NA,NA,NA,NA,NA,NA,NA,"842079fddc7a5740cd7252af4ef8f126bb9784d9","2020-03-12T20:00:00Z",NA,NA,367,305,305,41,0,0,0,0,0
"2376",20200312,"PA",22,116,81,NA,NA,NA,NA,NA,NA,NA,"bb985e06b75f251244341704b20d6b0c3daa27c1","2020-03-12T20:00:00Z",NA,NA,219,138,138,42,0,0,28,6,34
"2377",20200312,"RI",5,94,8,NA,NA,NA,NA,NA,NA,NA,"ddc07b8ec93f55583d98d5fff9c8d922808f6f98","2020-03-12T20:00:00Z",NA,NA,107,99,99,44,0,0,0,0,0
"2378",20200312,"SC",10,48,NA,NA,NA,NA,NA,NA,NA,NA,"691f174c432862e793e830327356b4d500cea11b","2020-03-12T20:00:00Z",NA,NA,58,58,58,45,0,0,16,1,17
"2379",20200312,"SD",8,27,11,NA,NA,NA,NA,NA,NA,NA,"47b6b8df0ade463177dd058de543bf80295b9b74","2020-03-12T20:00:00Z",NA,NA,46,35,35,46,0,0,14,3,17
"2380",20200312,"TN",18,79,NA,NA,NA,NA,NA,NA,NA,NA,"6e03cc4e5261258b7a5b8901327389775888ec5f","2020-03-12T20:00:00Z",NA,NA,97,97,97,47,0,0,29,11,40
"2381",20200312,"TX",23,NA,NA,NA,NA,NA,NA,NA,NA,NA,"35761868039ccd3294dc3e7e548781c129b39185","2020-03-12T20:00:00Z",NA,NA,23,23,23,48,0,0,0,2,2
"2382",20200312,"UT",4,131,NA,NA,NA,NA,NA,NA,NA,NA,"f2f3cbbd89fcfd9045a7ece563a5d84bc969009a","2020-03-12T20:00:00Z",NA,NA,135,135,135,49,0,0,131,2,133
"2383",20200312,"VA",17,117,NA,NA,NA,NA,NA,NA,NA,NA,"4d7e98639658d0746cb09b19b3fe2285f875af3b","2020-03-12T20:00:00Z",NA,NA,134,134,134,51,0,0,57,8,65
"2384",20200312,"VT",2,97,NA,NA,NA,NA,NA,NA,NA,NA,"7279c174377b4d61c1a6e3f40530ad2505b9a9a8","2020-03-12T20:00:00Z",NA,NA,99,99,99,50,0,0,35,1,36
"2385",20200312,"WA",550,3037,NA,NA,NA,NA,NA,NA,NA,NA,"4f31e57b60c3aa011ea1f10b60e1617bf39ad454","2020-03-12T20:00:00Z",44,NA,3587,3587,3587,53,4,0,862,69,931
"2386",20200312,"WI",8,84,NA,NA,NA,NA,NA,NA,NA,NA,"95e71f1997094b8460d58d94f2899a4b774e8a1d","2020-03-12T20:00:00Z",NA,NA,92,92,92,55,0,0,41,5,46
"2387",20200312,"WV",0,7,1,NA,NA,NA,NA,NA,NA,NA,"f0363560bc99a7f3bb66a17c11ced07c055ec423","2020-03-12T20:00:00Z",NA,NA,8,7,7,54,0,0,4,0,4
"2388",20200312,"WY",1,NA,NA,NA,NA,NA,NA,NA,NA,NA,"c8b2e0e377fc5c379d3775630a3ae430fb21861b","2020-03-12T20:00:00Z",NA,NA,1,1,1,56,0,0,0,1,1
"2389",20200311,"AK",0,46,14,NA,NA,NA,NA,NA,NA,NA,"38875040d04adb926bb80da9c4eeed89e944d306","2020-03-11T20:00:00Z",0,NA,60,46,46,2,0,0,23,0,23
"2390",20200311,"AL",0,10,NA,NA,NA,NA,NA,NA,NA,NA,"e4593577708b6182b9126434908df283def67838","2020-03-11T20:00:00Z",NA,NA,10,10,10,1,0,0,10,0,10
"2391",20200311,"AR",0,12,14,NA,NA,NA,NA,NA,NA,NA,"655d51e087ae7e668a3932904fd2764bc1fe3a9a","2020-03-11T20:00:00Z",NA,NA,26,12,12,5,0,0,0,0,0
"2392",20200311,"AZ",9,59,32,NA,NA,NA,NA,NA,NA,NA,"fc3cab43e403773ab7bee5f42d8dd1ccc405c3d5","2020-03-11T20:00:00Z",NA,NA,100,68,68,4,0,0,8,3,11
"2393",20200311,"CA",157,916,NA,NA,NA,NA,NA,NA,NA,NA,"5b964b8b4ae1c9c7ef6daba3357363e3abc15fc2","2020-03-11T20:00:00Z",NA,NA,1073,1073,1073,6,0,0,226,24,250
"2394",20200311,"CO",28,251,NA,NA,NA,NA,NA,NA,NA,NA,"9b7a26b306bf3d4ed340b3decc9409cfd98c94a7","2020-03-11T20:00:00Z",NA,NA,279,279,279,8,0,0,109,16,125
"2395",20200311,"CT",3,71,NA,NA,NA,NA,NA,NA,NA,NA,"c99636f2a99205c741fd1f78c991a31f4b2c23d5","2020-03-11T20:00:00Z",NA,NA,74,74,74,9,0,0,17,1,18
"2396",20200311,"DC",5,20,15,NA,NA,NA,NA,NA,NA,NA,"71b585cf49baefd551d06676e7954dc71f2a64e8","2020-03-11T20:00:00Z",NA,NA,40,25,25,11,0,0,3,0,3
"2397",20200311,"DE",1,17,2,NA,NA,NA,NA,NA,NA,NA,"9bc125877399e695097bfde306db2dc3cf015ec3","2020-03-11T20:00:00Z",NA,NA,20,18,18,10,0,0,0,1,1
"2398",20200311,"FL",28,301,147,NA,NA,NA,NA,NA,NA,NA,"3fdf9b7b837d64d12ac78cb3c27b3e075e5b91d0","2020-03-11T20:00:00Z",2,NA,476,329,329,12,2,0,79,9,88
"2399",20200311,"GA",22,NA,NA,NA,NA,NA,NA,NA,NA,NA,"11817b5a695d27b1ffda2ebe492653bca8075308","2020-03-11T20:00:00Z",NA,NA,22,22,22,13,0,0,0,5,5
"2400",20200311,"HI",2,NA,NA,NA,NA,NA,NA,NA,NA,NA,"ff1bcb7f451b4534cf4cb3660cd288cb0aecd55e","2020-03-11T20:00:00Z",NA,NA,2,2,2,15,0,0,0,0,0
"2401",20200311,"IA",13,46,27,NA,NA,NA,NA,NA,NA,NA,"77b0abb25053b84dfa901e4bc749840c4d626415","2020-03-11T20:00:00Z",NA,NA,86,59,59,19,0,0,14,5,19
"2402",20200311,"ID",0,67,NA,NA,NA,NA,NA,NA,NA,NA,"25d42d5a1f05b6d80d04134977322867c07531b1","2020-03-11T20:00:00Z",NA,NA,67,67,67,16,0,0,26,0,26
"2403",20200311,"IL",19,244,63,NA,NA,NA,NA,NA,NA,NA,"1f62279f30c95b7b5b306bd94b9172a3f9a3b94c","2020-03-11T20:00:00Z",NA,NA,326,263,263,17,0,0,0,0,0
"2404",20200311,"IN",10,33,NA,NA,NA,NA,NA,NA,NA,NA,"5733cad52da8fd692ae6386e05e95fa3faf2c337","2020-03-11T20:00:00Z",NA,NA,43,43,43,18,0,0,3,4,7
"2405",20200311,"KS",1,41,NA,NA,NA,NA,NA,NA,NA,NA,"1b65c26cb311dbfa7aa49f1aab7df29d4100afd6","2020-03-11T20:00:00Z",NA,NA,42,42,42,20,0,0,24,0,24
"2406",20200311,"KY",8,46,NA,NA,NA,NA,NA,NA,NA,NA,"fc0fc1ddfd9df01dee163a7f07ef68f158f1dcc7","2020-03-11T20:00:00Z",NA,NA,54,54,54,21,0,0,18,2,20
"2407",20200311,"LA",6,37,NA,NA,NA,NA,NA,NA,NA,NA,"4923914a2b53558e2c4f3c3e417339a9c725cee5","2020-03-11T20:00:00Z",NA,NA,43,43,43,22,0,0,26,5,31
"2408",20200311,"MA",92,NA,NA,NA,NA,NA,NA,NA,NA,NA,"cd9166102dba61e473c3f2e49f4ad84e9876c8ad","2020-03-11T20:00:00Z",NA,NA,92,92,92,25,0,0,0,0,0
"2409",20200311,"MD",9,94,NA,NA,NA,NA,NA,NA,NA,NA,"d63a695f033bd1727a5d48dc63cfc733e465f19f","2020-03-11T20:00:00Z",NA,NA,103,103,103,24,0,0,5,3,8
"2410",20200311,"ME",0,42,5,NA,NA,NA,NA,NA,NA,NA,"56ac39adce93990d2bea6abfff4e3e0c2fac2886","2020-03-11T20:00:00Z",NA,NA,47,42,42,23,0,0,22,0,22
"2411",20200311,"MI",497,57,18,NA,NA,NA,NA,NA,NA,NA,"4606279a91801f7b0fea463939eda7643d7aa752","2020-03-11T20:00:00Z",NA,NA,572,554,554,26,0,0,18,139,157
"2412",20200311,"MN",5,217,NA,NA,NA,NA,NA,NA,NA,NA,"6ffc74c710267d31359ae6c99715670db75e09e5","2020-03-11T20:00:00Z",NA,NA,222,222,222,27,0,0,85,2,87
"2413",20200311,"MO",1,NA,NA,NA,NA,NA,NA,NA,NA,NA,"f38403847cc3922fa5b7b5f616f4398deb2e6827","2020-03-11T20:00:00Z",NA,NA,1,1,1,29,0,0,0,0,0
"2414",20200311,"MS",0,20,NA,NA,NA,NA,NA,NA,NA,NA,"74f4ed2b75d893f6f2e2a8c45254056db6fe2eec","2020-03-11T20:00:00Z",NA,NA,20,20,20,28,0,0,20,0,20
"2415",20200311,"MT",0,21,NA,NA,NA,NA,NA,NA,NA,NA,"7f8109a13dd2e5346e22790e352899f32ce51387","2020-03-11T20:00:00Z",NA,NA,21,21,21,30,0,0,6,0,6
"2416",20200311,"NC",7,NA,NA,NA,NA,NA,NA,NA,NA,NA,"a47c27a5eb23e60bf9953697c72ea9eea9bf12fc","2020-03-11T20:00:00Z",NA,NA,7,7,7,37,0,0,0,0,0
"2417",20200311,"ND",0,7,6,NA,NA,NA,NA,NA,NA,NA,"f611bed2dbd16399f91bc8000106ae8aaf8cebe3","2020-03-11T20:00:00Z",NA,NA,13,7,7,38,0,0,1,0,1
"2418",20200311,"NE",5,47,16,NA,NA,NA,NA,NA,NA,NA,"fe99e1327ca6570995bfa945ae61ff53a32b57c1","2020-03-11T20:00:00Z",NA,NA,68,52,52,31,0,0,0,2,2
"2419",20200311,"NH",4,38,5,NA,NA,NA,NA,NA,NA,NA,"04ca9fceda7e94b04987880c53564cf1816ad713","2020-03-11T20:00:00Z",NA,NA,47,42,42,33,0,0,0,0,0
"2420",20200311,"NJ",24,57,20,NA,NA,NA,NA,NA,NA,NA,"22b493a9273eb0fcbef1d9438567b97aca475b07","2020-03-11T20:00:00Z",1,NA,101,81,81,34,1,0,13,9,22
"2421",20200311,"NM",3,87,NA,NA,NA,NA,NA,NA,NA,NA,"31d78422b55f96cea7974b12f74b206caea012fc","2020-03-11T20:00:00Z",NA,NA,90,90,90,35,0,0,18,3,21
"2422",20200311,"NV",5,168,NA,NA,NA,NA,NA,NA,NA,NA,"2cf372124199b53471bb78cd3c8b32fa8b2c89c6","2020-03-11T20:00:00Z",NA,NA,173,173,173,32,0,0,154,4,158
"2423",20200311,"NY",216,92,NA,NA,NA,NA,NA,NA,NA,NA,"6fbded3854324c39522ab7fdb01d2087f60e2d2b","2020-03-11T20:00:00Z",NA,NA,308,308,308,36,0,0,0,43,43
"2424",20200311,"OH",4,21,24,NA,NA,NA,NA,NA,NA,NA,"7def7afdab71c143358b5a2f7e6043abe2b1a58c","2020-03-11T20:00:00Z",NA,NA,49,25,25,39,0,0,7,1,8
"2425",20200311,"OK",2,15,11,NA,NA,NA,NA,NA,NA,NA,"5ec52c041a7fed2461a75cd7d7b69c16408ed016","2020-03-11T20:00:00Z",NA,NA,28,17,17,40,0,0,0,0,0
"2426",20200311,"OR",19,286,62,NA,NA,NA,NA,NA,NA,NA,"a0862d7ffbd817d0c1174d1060d000628f3e2d56","2020-03-11T20:00:00Z",NA,NA,367,305,305,41,0,0,73,4,77
"2427",20200311,"PA",16,88,54,NA,NA,NA,NA,NA,NA,NA,"a091f3d8c6f3ea5bfda8fc4fe1ac96d182dcb110","2020-03-11T20:00:00Z",NA,NA,158,104,104,42,0,0,88,4,92
"2428",20200311,"RI",5,94,24,NA,NA,NA,NA,NA,NA,NA,"2a70fe659d1a0d6b02523db6b2a5f49859afc8b9","2020-03-11T20:00:00Z",NA,NA,123,99,99,44,0,0,36,2,38
"2429",20200311,"SC",9,32,NA,NA,NA,NA,NA,NA,NA,NA,"9f0ba59beda560436e4c7086a310d705a164a73f","2020-03-11T20:00:00Z",NA,NA,41,41,41,45,0,0,8,2,10
"2430",20200311,"SD",5,13,2,NA,NA,NA,NA,NA,NA,NA,"e7ff0dfa7e6bd84d5f7633f98e650bd9fef932b6","2020-03-11T20:00:00Z",NA,NA,20,18,18,46,0,0,2,5,7
"2431",20200311,"TN",7,50,NA,NA,NA,NA,NA,NA,NA,NA,"0531f9d13df3db8ea79200191ddd853777674c53","2020-03-11T20:00:00Z",NA,NA,57,57,57,47,0,0,50,0,50
"2432",20200311,"TX",21,NA,NA,NA,NA,NA,NA,NA,NA,NA,"091b385894d0ae05bb6ea5bb6a7272ba6340a7c9","2020-03-11T20:00:00Z",NA,NA,21,21,21,48,0,0,0,8,8
"2433",20200311,"UT",2,NA,NA,NA,NA,NA,NA,NA,NA,NA,"76c94894d50c365d4846731e5cecb0f05021007f","2020-03-11T20:00:00Z",NA,NA,2,2,2,49,0,0,0,0,0
"2434",20200311,"VA",9,60,NA,NA,NA,NA,NA,NA,NA,NA,"a815f0d7942b6f1baa509e533e21d81829a3028d","2020-03-11T20:00:00Z",NA,NA,69,69,69,51,0,0,7,1,8
"2435",20200311,"VT",1,62,NA,NA,NA,NA,NA,NA,NA,NA,"c8f0f13f72669b1a4b6bde7505772ae78d229919","2020-03-11T20:00:00Z",NA,NA,63,63,63,50,0,0,22,0,22
"2436",20200311,"WA",481,2175,NA,NA,NA,NA,NA,NA,NA,NA,"6771cbf5d594bc70e1f3e54aa20706178d95c0af","2020-03-11T20:00:00Z",40,NA,2656,2656,2656,53,3,0,1065,84,1149
"2437",20200311,"WI",3,43,NA,NA,NA,NA,NA,NA,NA,NA,"cd76c7d7754176cb52177b3b9327eeeb6752d492","2020-03-11T20:00:00Z",NA,NA,46,46,46,55,0,0,7,1,8
"2438",20200311,"WV",0,3,2,NA,NA,NA,NA,NA,NA,NA,"d4710e9f30d17c17211938eeec385ecf4bc5b2f0","2020-03-11T20:00:00Z",NA,NA,5,3,3,54,0,0,1,0,1
"2439",20200311,"WY",0,NA,NA,NA,NA,NA,NA,NA,NA,NA,"b2a970a45b39b2c7ec078c35757610c22241c0f6","2020-03-11T20:00:00Z",NA,NA,0,0,0,56,0,0,0,0,0
"2440",20200310,"AK",0,23,9,NA,NA,NA,NA,NA,NA,NA,"d6e4bd2740be5e71db68c77d0f3030577cd25c19","2020-03-10T20:00:00Z",0,NA,32,23,23,2,0,0,0,0,0
"2441",20200310,"AL",0,0,0,NA,NA,NA,NA,NA,NA,NA,"d77d1bec988a8d98086652dbe2ec43647b585934","2020-03-10T20:00:00Z",NA,NA,0,0,0,1,0,0,0,0,0
"2442",20200310,"AR",0,12,3,NA,NA,NA,NA,NA,NA,NA,"76ed6d1dfa326d78b8fc7277b42229fbfb98b6a8","2020-03-10T20:00:00Z",NA,NA,15,12,12,5,0,0,0,0,0
"2443",20200310,"AZ",6,51,27,NA,NA,NA,NA,NA,NA,NA,"5dcc8301933ff5a560e3f87228a47f11150d6833","2020-03-10T20:00:00Z",NA,NA,84,57,57,4,0,0,7,1,8
"2444",20200310,"CA",133,690,NA,NA,NA,NA,NA,NA,NA,NA,"0d0ac26ba210e002c4cef8b50e8305df0d25daea","2020-03-10T20:00:00Z",NA,NA,823,823,823,6,0,0,0,19,19
"2445",20200310,"CO",12,142,1,NA,NA,NA,NA,NA,NA,NA,"69761082125ab448f7ae1bd685e412afa79151b6","2020-03-10T20:00:00Z",NA,NA,155,154,154,8,0,0,9,3,12
"2446",20200310,"CT",2,54,NA,NA,NA,NA,NA,NA,NA,NA,"75db1306a0c3b31835dc1c30f84f59c0a1029937","2020-03-10T20:00:00Z",NA,NA,56,56,56,9,0,0,8,1,9
"2447",20200310,"DC",5,17,2,NA,NA,NA,NA,NA,NA,NA,"5ba08a29ba9ee29378b41ef76d6d3d0c369f679c","2020-03-10T20:00:00Z",NA,NA,24,22,22,11,0,0,3,4,7
"2448",20200310,"DE",0,17,3,NA,NA,NA,NA,NA,NA,NA,"a31ea8cf78fa49489859b210157dc22e5260bb01","2020-03-10T20:00:00Z",NA,NA,20,17,17,10,0,0,2,0,2
"2449",20200310,"FL",19,222,155,NA,NA,NA,NA,NA,NA,NA,"28a9eb3913e7fc74070cec1d31d47aaac19e37fe","2020-03-10T20:00:00Z",NA,NA,396,241,241,12,0,0,82,1,83
"2450",20200310,"GA",17,NA,NA,NA,NA,NA,NA,NA,NA,NA,"a132882a6ceb7fe633651eb8a444d54b2abf057d","2020-03-10T20:00:00Z",NA,NA,17,17,17,13,0,0,0,5,5
"2451",20200310,"HI",2,NA,NA,NA,NA,NA,NA,NA,NA,NA,"2200379e92b872f68070789c24b448f9e633a242","2020-03-10T20:00:00Z",NA,NA,2,2,2,15,0,0,0,0,0
"2452",20200310,"IA",8,32,11,NA,NA,NA,NA,NA,NA,NA,"0339432703c45d77e65b4663ab034cdef1ba1231","2020-03-10T20:00:00Z",NA,NA,51,40,40,19,0,0,6,5,11
"2453",20200310,"ID",0,41,NA,NA,NA,NA,NA,NA,NA,NA,"3398df61adeea88796c0151991e91767f23fc23b","2020-03-10T20:00:00Z",NA,NA,41,41,41,16,0,0,0,0,0
"2454",20200310,"IL",19,244,63,NA,NA,NA,NA,NA,NA,NA,"61d4b2c48b0bcc01290ae69bcaf6239f7addecee","2020-03-10T20:00:00Z",NA,NA,326,263,263,17,0,0,53,12,65
"2455",20200310,"IN",6,30,NA,NA,NA,NA,NA,NA,NA,NA,"4fbecba581f9cdd1d759e98a8d4bc184c0f49b18","2020-03-10T20:00:00Z",NA,NA,36,36,36,18,0,0,30,4,34
"2456",20200310,"KS",1,17,21,NA,NA,NA,NA,NA,NA,NA,"d0b4ac6984434e6749c3bb46fc10b7693b8078df","2020-03-10T20:00:00Z",NA,NA,39,18,18,20,0,0,6,0,6
"2457",20200310,"KY",6,28,NA,NA,NA,NA,NA,NA,NA,NA,"fb7dfcd14029c819e924cd14118e37cc9ea2a536","2020-03-10T20:00:00Z",NA,NA,34,34,34,21,0,0,11,2,13
"2458",20200310,"LA",1,11,NA,NA,NA,NA,NA,NA,NA,NA,"0cbd4af0d2d6d254ceee5f1d76f6f82e4a2c11d4","2020-03-10T20:00:00Z",NA,NA,12,12,12,22,0,0,6,0,6
"2459",20200310,"MA",92,NA,NA,NA,NA,NA,NA,NA,NA,NA,"5b2241741b78dcad0513de205c9dba09feae3b20","2020-03-10T20:00:00Z",NA,NA,92,92,92,25,0,0,0,51,51
"2460",20200310,"MD",6,89,NA,NA,NA,NA,NA,NA,NA,NA,"8f118d594d196858544dc7c24bc999d3c9843b04","2020-03-10T20:00:00Z",NA,NA,95,95,95,24,0,0,16,1,17
"2461",20200310,"ME",0,20,5,NA,NA,NA,NA,NA,NA,NA,"6d6c02b7fd92ae263c4abcb613d6f26636decd1f","2020-03-10T20:00:00Z",NA,NA,25,20,20,23,0,0,19,0,19
"2462",20200310,"MI",358,39,24,NA,NA,NA,NA,NA,NA,NA,"3e4a39aed98cca92c58aec0c948bd34e7c057f4b","2020-03-10T20:00:00Z",NA,NA,421,397,397,26,0,0,3,104,107
"2463",20200310,"MN",3,132,NA,NA,NA,NA,NA,NA,NA,NA,"a8bd7312aff6c319969c4284aea579180470d47b","2020-03-10T20:00:00Z",NA,NA,135,135,135,27,0,0,52,1,53
"2464",20200310,"MO",1,NA,NA,NA,NA,NA,NA,NA,NA,NA,"1c34a0d3912ffb4d44146d0a8411b013fe7248fc","2020-03-10T20:00:00Z",NA,NA,1,1,1,29,0,0,0,0,0
"2465",20200310,"MS",0,NA,NA,NA,NA,NA,NA,NA,NA,NA,"32252d133f8ee8b943fd708c3090d079ce45f7f2","2020-03-10T20:00:00Z",NA,NA,0,0,0,28,0,0,0,0,0
"2466",20200310,"MT",0,15,NA,NA,NA,NA,NA,NA,NA,NA,"f250ac19e94bd81dd095fe875f429e4570af3286","2020-03-10T20:00:00Z",NA,NA,15,15,15,30,0,0,4,0,4
"2467",20200310,"NC",7,NA,NA,NA,NA,NA,NA,NA,NA,NA,"7820bb5206372383942ee45994aaac2274420d5f","2020-03-10T20:00:00Z",NA,NA,7,7,7,37,0,0,0,5,5
"2468",20200310,"ND",0,6,2,NA,NA,NA,NA,NA,NA,NA,"e0805fa5b5182659ea70ca569733d8ba876ad01d","2020-03-10T20:00:00Z",NA,NA,8,6,6,38,0,0,6,0,6
"2469",20200310,"NE",3,47,16,NA,NA,NA,NA,NA,NA,NA,"2eceb89898abf1c18dc8d4e151aa6a9b7f24bd44","2020-03-10T20:00:00Z",NA,NA,66,50,50,31,0,0,11,0,11
"2470",20200310,"NH",4,38,5,NA,NA,NA,NA,NA,NA,NA,"db5511251d15682916c0b2c7d18c8e042946c86c","2020-03-10T20:00:00Z",NA,NA,47,42,42,33,0,0,0,0,0
"2471",20200310,"NJ",15,44,20,NA,NA,NA,NA,NA,NA,NA,"894e37aeac26176f2ecbaeae4a2a73ec49d66177","2020-03-10T20:00:00Z",NA,NA,79,59,59,34,0,0,9,4,13
"2472",20200310,"NM",0,69,NA,NA,NA,NA,NA,NA,NA,NA,"9c36987288c350a2183bb8af37efa35702813c0d","2020-03-10T20:00:00Z",NA,NA,69,69,69,35,0,0,12,0,12
"2473",20200310,"NV",1,14,NA,NA,NA,NA,NA,NA,NA,NA,"2652231f26f2a40d4b1d719fee236b966c061283","2020-03-10T20:00:00Z",NA,NA,15,15,15,32,0,0,0,0,0
"2474",20200310,"NY",173,92,NA,NA,NA,NA,NA,NA,NA,NA,"193f85893cecb99d063a03060bc4802d2d6458f1","2020-03-10T20:00:00Z",NA,NA,265,265,265,36,0,0,0,31,31
"2475",20200310,"OH",3,14,15,NA,NA,NA,NA,NA,NA,NA,"c226bdb43a781003d1620baf6ee7b55ad00c8b50","2020-03-10T20:00:00Z",NA,NA,32,17,17,39,0,0,3,0,3
"2476",20200310,"OK",2,15,11,NA,NA,NA,NA,NA,NA,NA,"fe6cb3ee7ed6b8df044b4274f1235f2c35195542","2020-03-10T20:00:00Z",NA,NA,28,17,17,40,0,0,7,1,8
"2477",20200310,"OR",15,213,67,NA,NA,NA,NA,NA,NA,NA,"b124f2b2f232984d5c0185a54ad7f85bb988a90a","2020-03-10T20:00:00Z",NA,NA,295,228,228,41,0,0,48,1,49
"2478",20200310,"PA",12,NA,NA,NA,NA,NA,NA,NA,NA,NA,"7dd8e8b438f07cd82021188efd5b91468b8ce15e","2020-03-10T20:00:00Z",NA,NA,12,12,12,42,0,0,0,2,2
"2479",20200310,"RI",3,58,6,NA,NA,NA,NA,NA,NA,NA,"36e67adb05ce8d558f0aefe09b0c328e5a79e54f","2020-03-10T20:00:00Z",NA,NA,67,61,61,44,0,0,28,0,28
"2480",20200310,"SC",7,24,NA,NA,NA,NA,NA,NA,NA,NA,"dd5f3a1e885292f8e8c6d3160128a1c49b84da8c","2020-03-10T20:00:00Z",NA,NA,31,31,31,45,0,0,0,0,0
"2481",20200310,"SD",0,11,0,NA,NA,NA,NA,NA,NA,NA,"f2608368ec96bfd0baf5e23ac0640cb2cb6fba1c","2020-03-10T20:00:00Z",NA,NA,11,11,11,46,0,0,6,0,6
"2482",20200310,"TN",7,NA,NA,NA,NA,NA,NA,NA,NA,NA,"51d7454f0a63341e7d33e9bc17ec4203c1d7b5eb","2020-03-10T20:00:00Z",NA,NA,7,7,7,47,0,0,0,4,4
"2483",20200310,"TX",13,NA,NA,NA,NA,NA,NA,NA,NA,NA,"eea92c2654f734808ae61461bd187a8ae737ede5","2020-03-10T20:00:00Z",NA,NA,13,13,13,48,0,0,0,1,1
"2484",20200310,"UT",2,NA,NA,NA,NA,NA,NA,NA,NA,NA,"466b66d0cbac6da0ff5069cee893a6e5774b3809","2020-03-10T20:00:00Z",NA,NA,2,2,2,49,0,0,0,1,1
"2485",20200310,"VA",8,53,NA,NA,NA,NA,NA,NA,NA,NA,"50c5f90ad518306f2aa6cfa2d4aa8f9c6b89f6eb","2020-03-10T20:00:00Z",NA,NA,61,61,61,51,0,0,15,5,20
"2486",20200310,"VT",1,40,NA,NA,NA,NA,NA,NA,NA,NA,"1ef4d4eeca815cb3358eed86bfdd2b22a7faacc9","2020-03-10T20:00:00Z",NA,NA,41,41,41,50,0,0,6,0,6
"2487",20200310,"WA",397,1110,NA,NA,NA,NA,NA,NA,NA,NA,"e0d92b0951759fda566c9a9cde02e0b0c5462d09","2020-03-10T20:00:00Z",37,NA,1507,1507,1507,53,2,0,0,48,48
"2488",20200310,"WI",2,36,NA,NA,NA,NA,NA,NA,NA,NA,"6547fab519037da58609fee7229c4673423a5614","2020-03-10T20:00:00Z",NA,NA,38,38,38,55,0,0,0,1,1
"2489",20200310,"WV",0,2,3,NA,NA,NA,NA,NA,NA,NA,"a0f64043e0dbb8a0390316af34e6ae60a7913160","2020-03-10T20:00:00Z",NA,NA,5,2,2,54,0,0,0,0,0
"2490",20200310,"WY",0,0,0,NA,NA,NA,NA,NA,NA,NA,"7386ca913797703a8f0738ff599605f36db6d06b","2020-03-10T20:00:00Z",NA,NA,0,0,0,56,0,0,0,0,0
"2491",20200309,"AK",0,23,9,NA,NA,NA,NA,NA,NA,NA,"cb85c1929806141b01e896a52de54771863ed0e4","2020-03-09T20:00:00Z",0,NA,32,23,23,2,0,0,9,0,9
"2492",20200309,"AL",0,NA,NA,NA,NA,NA,NA,NA,NA,NA,"3c15dbef6838aa05f46554b8f49c5d96677df531","2020-03-09T20:00:00Z",NA,NA,0,0,0,1,0,0,0,0,0
"2493",20200309,"AR",0,12,0,NA,NA,NA,NA,NA,NA,NA,"5ef70cfa2d033bc17949f85ed40a9a63e9ea95df","2020-03-09T20:00:00Z",NA,NA,12,12,12,5,0,0,6,0,6
"2494",20200309,"AZ",5,44,7,NA,NA,NA,NA,NA,NA,NA,"34a29bfcfa1a71c92fe460039d78f6bb8bf65e60","2020-03-09T20:00:00Z",NA,NA,56,49,49,4,0,0,0,0,0
"2495",20200309,"CA",114,690,NA,NA,NA,NA,NA,NA,NA,NA,"6af63e3581f76d44b6446c5c221d5a2dd96f5a24","2020-03-09T20:00:00Z",NA,NA,804,804,804,6,0,0,228,26,254
"2496",20200309,"CO",9,133,NA,NA,NA,NA,NA,NA,NA,NA,"b23d501869c0a98edd0eedb4d3393fa413a2532b","2020-03-09T20:00:00Z",NA,NA,142,142,142,8,0,0,29,1,30
"2497",20200309,"CT",1,46,NA,NA,NA,NA,NA,NA,NA,NA,"77af98908db8db59c3733c28b2b979a5dfbd11d7","2020-03-09T20:00:00Z",NA,NA,47,47,47,9,0,0,17,0,17
"2498",20200309,"DC",1,14,3,NA,NA,NA,NA,NA,NA,NA,"01c063fd1289fc23b3b7be3d4aea3307b50f5040","2020-03-09T20:00:00Z",NA,NA,18,15,15,11,0,0,4,0,4
"2499",20200309,"DE",0,15,3,NA,NA,NA,NA,NA,NA,NA,"966cd7a363b1718847965e750f4e76527e4f3d3f","2020-03-09T20:00:00Z",NA,NA,18,15,15,10,0,0,5,0,5
"2500",20200309,"FL",18,140,115,NA,NA,NA,NA,NA,NA,NA,"318b0f35925b3b172b90b2faa9823d23882636b6","2020-03-09T20:00:00Z",NA,NA,273,158,158,12,0,0,22,1,23
"2501",20200309,"GA",12,NA,NA,NA,NA,NA,NA,NA,NA,NA,"279f6e8110f21f2cb9b2d1ff1e6841afa1c0af40","2020-03-09T20:00:00Z",NA,NA,12,12,12,13,0,0,0,5,5
"2502",20200309,"HI",2,NA,NA,NA,NA,NA,NA,NA,NA,NA,"e8c71d4ebcb3a9aed28d52d363088faa8aa067e2","2020-03-09T20:00:00Z",NA,NA,2,2,2,15,0,0,0,1,1
"2503",20200309,"IA",3,26,8,NA,NA,NA,NA,NA,NA,NA,"2d4f00730c4f5721f4da3d4ba82eebff77c5e4e2","2020-03-09T20:00:00Z",NA,NA,37,29,29,19,0,0,11,3,14
"2504",20200309,"ID",0,41,NA,NA,NA,NA,NA,NA,NA,NA,"cebad76e979c6b393b559632dcfef8e1cb9ccd0c","2020-03-09T20:00:00Z",NA,NA,41,41,41,16,0,0,14,0,14
"2505",20200309,"IL",7,191,44,NA,NA,NA,NA,NA,NA,NA,"3fe26606e274da04428ec1f3e932c98cf64e5b49","2020-03-09T20:00:00Z",NA,NA,242,198,198,17,0,0,0,1,1
"2506",20200309,"IN",2,NA,NA,NA,NA,NA,NA,NA,NA,NA,"d82e74b7662ac9fc6dcad52693089393fd73c192","2020-03-09T20:00:00Z",NA,NA,2,2,2,18,0,0,0,0,0
"2507",20200309,"KS",1,11,0,NA,NA,NA,NA,NA,NA,NA,"ce8f496b64774484ba055b88fe463cfea2c4ecaf","2020-03-09T20:00:00Z",NA,NA,12,12,12,20,0,0,0,0,0
"2508",20200309,"KY",4,17,NA,NA,NA,NA,NA,NA,NA,NA,"ea273e790c71c42e501ffeb854c765c4ed3d91e0","2020-03-09T20:00:00Z",NA,NA,21,21,21,21,0,0,4,3,7
"2509",20200309,"LA",1,5,NA,NA,NA,NA,NA,NA,NA,NA,"34ed705a6d35331063fd0d6d7867baca1fefe36c","2020-03-09T20:00:00Z",NA,NA,6,6,6,22,0,0,0,1,1
"2510",20200309,"MA",41,NA,NA,NA,NA,NA,NA,NA,NA,NA,"bcf1ffcd7a8be3ab88adca44ae7ca0012a0b6cb7","2020-03-09T20:00:00Z",NA,NA,41,41,41,25,0,0,0,28,28
"2511",20200309,"MD",5,73,NA,NA,NA,NA,NA,NA,NA,NA,"21d797080b2facbf18276350a712ba702c1db616","2020-03-09T20:00:00Z",NA,NA,78,78,78,24,0,0,21,2,23
"2512",20200309,"ME",0,1,NA,NA,NA,NA,NA,NA,NA,NA,"fc7ef15fa0bc2846fd0a361a454006c43ff5a50c","2020-03-09T20:00:00Z",NA,NA,1,1,1,23,0,0,0,0,0
"2513",20200309,"MI",254,36,11,NA,NA,NA,NA,NA,NA,NA,"12439b1570bf0a2f43b1aa54c5664fc47bc56172","2020-03-09T20:00:00Z",NA,NA,301,290,290,26,0,0,10,86,96
"2514",20200309,"MN",2,80,NA,NA,NA,NA,NA,NA,NA,NA,"2fe8a8c39e6d7656c053b0ddc487d11d014d7968","2020-03-09T20:00:00Z",NA,NA,82,82,82,27,0,0,32,1,33
"2515",20200309,"MO",1,NA,NA,NA,NA,NA,NA,NA,NA,NA,"2ae8fc33a8f32d0393f6509589e5aa2db017a1a7","2020-03-09T20:00:00Z",NA,NA,1,1,1,29,0,0,0,0,0
"2516",20200309,"MS",0,NA,NA,NA,NA,NA,NA,NA,NA,NA,"2b1e959c40e1d97cbd4fdb3af6d146176cb72a7a","2020-03-09T20:00:00Z",NA,NA,0,0,0,28,0,0,0,0,0
"2517",20200309,"MT",0,11,NA,NA,NA,NA,NA,NA,NA,NA,"f94a2e3b32545cbd6e401cfc4e8094305bd8e6ac","2020-03-09T20:00:00Z",NA,NA,11,11,11,30,0,0,0,0,0
"2518",20200309,"NC",2,NA,NA,NA,NA,NA,NA,NA,NA,NA,"36a7efc53186e6278555d0eb1f7f7780868cfc03","2020-03-09T20:00:00Z",NA,NA,2,2,2,37,0,0,0,0,0
"2519",20200309,"ND",0,0,NA,NA,NA,NA,NA,NA,NA,NA,"59a9fe03c914e9211dd5546b982a478f5b7e46d8","2020-03-09T20:00:00Z",NA,NA,0,0,0,38,0,0,0,0,0
"2520",20200309,"NE",3,36,9,NA,NA,NA,NA,NA,NA,NA,"aacea49d265183a389da9f54170298fc8d6a486e","2020-03-09T20:00:00Z",NA,NA,48,39,39,31,0,0,19,2,21
"2521",20200309,"NH",4,38,5,NA,NA,NA,NA,NA,NA,NA,"95d9f3370e5979350a25379b65c7f98b077c7213","2020-03-09T20:00:00Z",NA,NA,47,42,42,33,0,0,0,0,0
"2522",20200309,"NJ",11,35,14,NA,NA,NA,NA,NA,NA,NA,"e0df6d08dc91c5afd18e9f35f22aa322b4b0f0ce","2020-03-09T20:00:00Z",NA,NA,60,46,46,34,0,0,4,5,9
"2523",20200309,"NM",0,57,0,NA,NA,NA,NA,NA,NA,NA,"a766e1775bcbafa6817f7b2f15a9292652caba5c","2020-03-09T20:00:00Z",NA,NA,57,57,57,35,0,0,9,0,9
"2524",20200309,"NV",1,14,NA,NA,NA,NA,NA,NA,NA,NA,"83d025cf17543e497cd5063608e45dc9cfa44fb8","2020-03-09T20:00:00Z",NA,NA,15,15,15,32,0,0,0,0,0
"2525",20200309,"NY",142,92,NA,NA,NA,NA,NA,NA,NA,NA,"260a070d28ed40a35e8b31aca5f4ab3352dc9ba8","2020-03-09T20:00:00Z",NA,NA,234,234,234,36,0,0,0,37,37
"2526",20200309,"OH",3,11,5,NA,NA,NA,NA,NA,NA,NA,"40edb3ac44427394a2fb18a1b4cd4064b7e67672","2020-03-09T20:00:00Z",NA,NA,19,14,14,39,0,0,1,3,4
"2527",20200309,"OK",1,8,10,NA,NA,NA,NA,NA,NA,NA,"8b689e9e2ad67a6b028c2431bedd2cec040154e0","2020-03-09T20:00:00Z",NA,NA,19,9,9,40,0,0,0,0,0
"2528",20200309,"OR",14,165,52,NA,NA,NA,NA,NA,NA,NA,"f5a1974166b2872d9568b45083f043611e5c5652","2020-03-09T20:00:00Z",NA,NA,231,179,179,41,0,0,65,0,65
"2529",20200309,"PA",10,NA,NA,NA,NA,NA,NA,NA,NA,NA,"4554632818538c57d0520a7bfb83132dd6c055d9","2020-03-09T20:00:00Z",NA,NA,10,10,10,42,0,0,0,4,4
"2530",20200309,"RI",3,30,6,NA,NA,NA,NA,NA,NA,NA,"c95620757ddb4993da77d7d25126c990fa386efe","2020-03-09T20:00:00Z",NA,NA,39,33,33,44,0,0,0,0,0
"2531",20200309,"SC",7,24,NA,NA,NA,NA,NA,NA,NA,NA,"230947ecf1cd935a64d923210a6ffb285ea513bd","2020-03-09T20:00:00Z",NA,NA,31,31,31,45,0,0,16,5,21
"2532",20200309,"SD",0,5,0,NA,NA,NA,NA,NA,NA,NA,"207d9a28c6c82c49caa4472678725e844f8a1836","2020-03-09T20:00:00Z",NA,NA,5,5,5,46,0,0,0,0,0
"2533",20200309,"TN",3,NA,NA,NA,NA,NA,NA,NA,NA,NA,"2ca1b9768f605daaa7c62ae41b8b6f94c63d1a80","2020-03-09T20:00:00Z",NA,NA,3,3,3,47,0,0,0,0,0
"2534",20200309,"TX",12,NA,NA,NA,NA,NA,NA,NA,NA,NA,"c3bedfa0a6b278f333e5bdb9fde59e674715bfb1","2020-03-09T20:00:00Z",NA,NA,12,12,12,48,0,0,0,4,4
"2535",20200309,"UT",1,NA,NA,NA,NA,NA,NA,NA,NA,NA,"fa208666968a4489a5cde79e40c08bdddece1361","2020-03-09T20:00:00Z",NA,NA,1,1,1,49,0,0,0,0,0
"2536",20200309,"VA",3,38,9,NA,NA,NA,NA,NA,NA,NA,"de39b29dd1a1a173788fc7a0f22b44ccb7899f1c","2020-03-09T20:00:00Z",NA,NA,50,41,41,51,0,0,2,1,3
"2537",20200309,"VT",1,34,NA,NA,NA,NA,NA,NA,NA,NA,"26c656cc1971e9a2bde7f9614ffe7ef51900c432","2020-03-09T20:00:00Z",NA,NA,35,35,35,50,0,0,6,0,6
"2538",20200309,"WA",349,1110,NA,NA,NA,NA,NA,NA,NA,NA,"03e4be03d4f86d6810bda3dd27a0007a3efd94d9","2020-03-09T20:00:00Z",35,NA,1459,1459,1459,53,4,0,470,100,570
"2539",20200309,"WI",1,36,NA,NA,NA,NA,NA,NA,NA,NA,"e29cff75f4e2deeb5547eee65bcb33cdc75c2fd8","2020-03-09T20:00:00Z",NA,NA,37,37,37,55,0,0,5,0,5
"2540",20200309,"WV",0,2,3,NA,NA,NA,NA,NA,NA,NA,"8e4b9a84bdbba65581c2287854f03105e8e97149","2020-03-09T20:00:00Z",NA,NA,5,2,2,54,0,0,0,0,0
"2541",20200309,"WY",0,NA,NA,NA,NA,NA,NA,NA,NA,NA,"c052da9af9257ed5150197a38c4d1cf9cb5992b0","2020-03-09T20:00:00Z",NA,NA,0,0,0,56,0,0,0,0,0
"2542",20200308,"AK",0,14,6,NA,NA,NA,NA,NA,NA,NA,"c4287ed1763571e32d9c109b0e8d38d1c66dfb98","2020-03-08T20:00:00Z",0,NA,20,14,14,2,0,0,2,0,2
"2543",20200308,"AL",0,NA,NA,NA,NA,NA,NA,NA,NA,NA,"dc8486565b986e301a3cb52dda7d6014007253e4","2020-03-08T20:00:00Z",NA,NA,0,0,0,1,0,0,0,0,0
"2544",20200308,"AR",0,6,0,NA,NA,NA,NA,NA,NA,NA,"6263c0cd4836c8418421de9e16b86212a90ea53f","2020-03-08T20:00:00Z",NA,NA,6,6,6,5,0,0,0,0,0
"2545",20200308,"AZ",5,44,7,NA,NA,NA,NA,NA,NA,NA,"7fab3faf304af2d21cf805b897dbe16c6cf1a5c6","2020-03-08T20:00:00Z",NA,NA,56,49,49,4,0,0,0,0,0
"2546",20200308,"CA",88,462,NA,NA,NA,NA,NA,NA,NA,NA,"39ba303e6c33d759f657dfaa835f2714a49ecc37","2020-03-08T20:00:00Z",NA,NA,550,550,550,6,0,0,0,19,19
"2547",20200308,"CO",8,104,NA,NA,NA,NA,NA,NA,NA,NA,"999728a960c0e35c7bfce426d19eef24c7fd3e64","2020-03-08T20:00:00Z",NA,NA,112,112,112,8,0,0,49,0,49
"2548",20200308,"CT",1,29,8,NA,NA,NA,NA,NA,NA,NA,"9af238ecf88478ebbe90c92437c721d9fd8e6d17","2020-03-08T20:00:00Z",NA,NA,38,30,30,9,0,0,29,1,30
"2549",20200308,"DC",1,10,0,NA,NA,NA,NA,NA,NA,NA,"49cc05969337862100d6dac922ca02efcccd9c37","2020-03-08T20:00:00Z",NA,NA,11,11,11,11,0,0,2,1,3
"2550",20200308,"DE",0,10,0,NA,NA,NA,NA,NA,NA,NA,"55e0c22b683f94999c6a852f5432d86ffe73ebae","2020-03-08T20:00:00Z",NA,NA,10,10,10,10,0,0,0,0,0
"2551",20200308,"FL",17,118,108,NA,NA,NA,NA,NA,NA,NA,"58118fa0e29d8d1a2b018270736aa4e15f658ed0","2020-03-08T20:00:00Z",NA,NA,243,135,135,12,0,0,18,3,21
"2552",20200308,"GA",7,NA,NA,NA,NA,NA,NA,NA,NA,NA,"e234f04216762da88bc69c82ae358ca0e126a20e","2020-03-08T20:00:00Z",NA,NA,7,7,7,13,0,0,0,1,1
"2553",20200308,"HI",1,NA,NA,NA,NA,NA,NA,NA,NA,NA,"94350220775a3b6e5fda814910579f1b46265ab8","2020-03-08T20:00:00Z",NA,NA,1,1,1,15,0,0,0,0,0
"2554",20200308,"IA",0,15,2,NA,NA,NA,NA,NA,NA,NA,"ed9e73a744bebf0b1f7f5bda0383d3fe3134e20c","2020-03-08T20:00:00Z",NA,NA,17,15,15,19,0,0,0,0,0
"2555",20200308,"ID",0,27,NA,NA,NA,NA,NA,NA,NA,NA,"9445d66db16882680e8502f339ebcea0f5762ccd","2020-03-08T20:00:00Z",NA,NA,27,27,27,16,0,0,0,0,0
"2556",20200308,"IL",6,191,44,NA,NA,NA,NA,NA,NA,NA,"6c7bf5170846973ebb63a9ac680596f733cf5a5d","2020-03-08T20:00:00Z",NA,NA,241,197,197,17,0,0,0,0,0
"2557",20200308,"IN",2,NA,NA,NA,NA,NA,NA,NA,NA,NA,"ba3578ffa6ce7f594b1afdeb97b4e26c421cf59f","2020-03-08T20:00:00Z",NA,NA,2,2,2,18,0,0,0,1,1
"2558",20200308,"KS",1,11,0,NA,NA,NA,NA,NA,NA,NA,"d7a2adf7af3c56e40d1a75f02da8878c2e934ccd","2020-03-08T20:00:00Z",NA,NA,12,12,12,20,0,0,0,1,1
"2559",20200308,"KY",1,13,NA,NA,NA,NA,NA,NA,NA,NA,"1930ced9af77c060162cc04abf6f9d53d28c39ac","2020-03-08T20:00:00Z",NA,NA,14,14,14,21,0,0,4,0,4
"2560",20200308,"LA",0,5,NA,NA,NA,NA,NA,NA,NA,NA,"f0cd89bf8cfc3f22372a64bbf45ae165e5845bb1","2020-03-08T20:00:00Z",NA,NA,5,5,5,22,0,0,5,0,5
"2561",20200308,"MA",13,NA,NA,NA,NA,NA,NA,NA,NA,NA,"db7ba78165b69c05b53151fbdc1d322c2e5a1688","2020-03-08T20:00:00Z",NA,NA,13,13,13,25,0,0,0,0,0
"2562",20200308,"MD",3,52,NA,NA,NA,NA,NA,NA,NA,NA,"cbac8d376b30d5d5e04172efbb77aa9f9d49942b","2020-03-08T20:00:00Z",NA,NA,55,55,55,24,0,0,11,0,11
"2563",20200308,"ME",0,1,NA,NA,NA,NA,NA,NA,NA,NA,"a44c270bd2fd674f7bf3ffcf3b9042baa0c7d8b2","2020-03-08T20:00:00Z",NA,NA,1,1,1,23,0,0,0,0,0
"2564",20200308,"MI",168,26,10,NA,NA,NA,NA,NA,NA,NA,"8955bea8f7edc16d43081e5b969c48c3f1e3050e","2020-03-08T20:00:00Z",NA,NA,204,194,194,26,0,0,8,40,48
"2565",20200308,"MN",1,48,NA,NA,NA,NA,NA,NA,NA,NA,"3bb2cdf04d3b3fa3eaea091fd099d444818650e2","2020-03-08T20:00:00Z",NA,NA,49,49,49,27,0,0,0,0,0
"2566",20200308,"MO",1,NA,NA,NA,NA,NA,NA,NA,NA,NA,"61c8364771bfe55687a47ce4650d8614e697d7ca","2020-03-08T20:00:00Z",NA,NA,1,1,1,29,0,0,0,1,1
"2567",20200308,"MS",0,NA,NA,NA,NA,NA,NA,NA,NA,NA,"2d0d4688d015247af02eab6b55ae72e221d8ac7c","2020-03-08T20:00:00Z",NA,NA,0,0,0,28,0,0,0,0,0
"2568",20200308,"MT",0,11,NA,NA,NA,NA,NA,NA,NA,NA,"cdb6980828a9f676bf55fdd84394dfd3d2619c80","2020-03-08T20:00:00Z",NA,NA,11,11,11,30,0,0,0,0,0
"2569",20200308,"NC",2,NA,NA,NA,NA,NA,NA,NA,NA,NA,"550aef8aafb9d182e2c2db40483a3c4030f9fa27","2020-03-08T20:00:00Z",NA,NA,2,2,2,37,0,0,0,0,0
"2570",20200308,"ND",0,0,NA,NA,NA,NA,NA,NA,NA,NA,"e1b82af26658ba59e5450a632559324dab21d186","2020-03-08T20:00:00Z",NA,NA,0,0,0,38,0,0,0,0,0
"2571",20200308,"NE",1,17,5,NA,NA,NA,NA,NA,NA,NA,"0a814283723e80c081ea9aced87caae627354a77","2020-03-08T20:00:00Z",NA,NA,23,18,18,31,0,0,0,0,0
"2572",20200308,"NH",4,38,5,NA,NA,NA,NA,NA,NA,NA,"ecfe42d37126f9471a8c8176b24545e96c32c1d5","2020-03-08T20:00:00Z",NA,NA,47,42,42,33,0,0,18,2,20
"2573",20200308,"NJ",6,31,0,NA,NA,NA,NA,NA,NA,NA,"1e8aab109a7c26892276d26946a56c0163edcd84","2020-03-08T20:00:00Z",NA,NA,37,37,37,34,0,0,31,2,33
"2574",20200308,"NM",0,48,0,NA,NA,NA,NA,NA,NA,NA,"3ae3b323e6fccff2c838538447fffa389d9e5f4a","2020-03-08T20:00:00Z",NA,NA,48,48,48,35,0,0,0,0,0
"2575",20200308,"NV",1,14,NA,NA,NA,NA,NA,NA,NA,NA,"def0cb8fc381af9358ec1023f361e556ab9f9ded","2020-03-08T20:00:00Z",NA,NA,15,15,15,32,0,0,0,0,0
"2576",20200308,"NY",105,92,NA,NA,NA,NA,NA,NA,NA,NA,"f6d3b78f41cadeaf08e72f35692a9619d70aad07","2020-03-08T20:00:00Z",NA,NA,197,197,197,36,0,0,0,29,29
"2577",20200308,"OH",0,10,4,NA,NA,NA,NA,NA,NA,NA,"7e8d292bba63ea4513c06f2051dea6861b470916","2020-03-08T20:00:00Z",NA,NA,14,10,10,39,0,0,1,0,1
"2578",20200308,"OK",1,8,2,NA,NA,NA,NA,NA,NA,NA,"b6018ab69b18e7cd1a1cdabcf009e65d0f07e5ee","2020-03-08T20:00:00Z",NA,NA,11,9,9,40,0,0,8,0,8
"2579",20200308,"OR",14,100,53,NA,NA,NA,NA,NA,NA,NA,"882f37383b337cc29b83d8317156e4a4311f6627","2020-03-08T20:00:00Z",NA,NA,167,114,114,41,0,0,23,7,30
"2580",20200308,"PA",6,NA,NA,NA,NA,NA,NA,NA,NA,NA,"f2288aed4a67fb77f86fc35e3988a70e0db037ac","2020-03-08T20:00:00Z",NA,NA,6,6,6,42,0,0,0,2,2
"2581",20200308,"RI",3,30,12,NA,NA,NA,NA,NA,NA,NA,"1f2994a89f2153e8cbf70397cf042a16351be821","2020-03-08T20:00:00Z",NA,NA,45,33,33,44,0,0,0,1,1
"2582",20200308,"SC",2,8,NA,NA,NA,NA,NA,NA,NA,NA,"db7aefd437c9ae1600b9c0b62d4f9344d3a99dc7","2020-03-08T20:00:00Z",NA,NA,10,10,10,45,0,0,0,0,0
"2583",20200308,"SD",0,5,0,NA,NA,NA,NA,NA,NA,NA,"a54f67d9f8d3c7647c20085e8d59e40c6290250b","2020-03-08T20:00:00Z",NA,NA,5,5,5,46,0,0,0,0,0
"2584",20200308,"TN",3,NA,NA,NA,NA,NA,NA,NA,NA,NA,"55ca27b24b97bbb5f61d3c7d3db93ad7f41f6240","2020-03-08T20:00:00Z",NA,NA,3,3,3,47,0,0,0,2,2
"2585",20200308,"TX",8,NA,NA,NA,NA,NA,NA,NA,NA,NA,"be48d5d3143d163568736568b389b7bcae8fe816","2020-03-08T20:00:00Z",NA,NA,8,8,8,48,0,0,0,0,0
"2586",20200308,"UT",1,NA,NA,NA,NA,NA,NA,NA,NA,NA,"3687612a6d76e15f8a889cdb629d2dda034d897b","2020-03-08T20:00:00Z",NA,NA,1,1,1,49,0,0,0,0,0
"2587",20200308,"VA",2,36,6,NA,NA,NA,NA,NA,NA,NA,"3e12d0328ad20d41eb4f57a4fd4143d65e263a97","2020-03-08T20:00:00Z",NA,NA,44,38,38,51,0,0,5,2,7
"2588",20200308,"VT",1,28,NA,NA,NA,NA,NA,NA,NA,NA,"2393fda9fc64b4825ff4d3456139404c6fdeffaa","2020-03-08T20:00:00Z",NA,NA,29,29,29,50,0,0,12,1,13
"2589",20200308,"WA",249,640,60,NA,NA,NA,NA,NA,NA,NA,"4d74ee68fae327c5e1ae6151cca130b80537fa70","2020-03-08T20:00:00Z",31,NA,949,889,889,53,4,0,270,67,337
"2590",20200308,"WI",1,31,12,NA,NA,NA,NA,NA,NA,NA,"b834c9b5c7a55a60692aace16160db4e77576973","2020-03-08T20:00:00Z",NA,NA,44,32,32,55,0,0,0,0,0
"2591",20200308,"WV",0,2,3,NA,NA,NA,NA,NA,NA,NA,"4baf5efaa3462e45c3a086d03ba4bf9376b10202","2020-03-08T20:00:00Z",NA,NA,5,2,2,54,0,0,0,0,0
"2592",20200308,"WY",0,NA,NA,NA,NA,NA,NA,NA,NA,NA,"04b812c8dbb7bd7a7c1c24bb7e3b1116fb1cfa96","2020-03-08T20:00:00Z",NA,NA,0,0,0,56,0,0,0,0,0
"2593",20200307,"AK",0,12,2,NA,NA,NA,NA,NA,NA,NA,"909b7d55ced8b1311528d716923608f030dc8226","2020-03-07T21:00:00Z",0,NA,14,12,12,2,0,0,4,0,4
"2594",20200307,"AL",0,NA,NA,NA,NA,NA,NA,NA,NA,NA,"1d94a3b00af81e57b35a00c0eeaa339ec76d962a","2020-03-07T21:00:00Z",NA,NA,0,0,0,1,NA,NA,NA,NA,NA
"2595",20200307,"AR",0,6,0,NA,NA,NA,NA,NA,NA,NA,"bdba8d05662d7b38e7309c5baa49cd20b63a536b","2020-03-07T21:00:00Z",NA,NA,6,6,6,5,0,0,0,0,0
"2596",20200307,"AZ",5,44,7,NA,NA,NA,NA,NA,NA,NA,"0c334b56af3108711bb907f46599a84bd536ac1d","2020-03-07T21:00:00Z",NA,NA,56,49,49,4,0,0,11,2,13
"2597",20200307,"CA",69,462,NA,NA,NA,NA,NA,NA,NA,NA,"311a213f5744c6b33147c107519218e8d9f55d23","2020-03-07T21:00:00Z",NA,NA,531,531,531,6,0,0,0,9,9
"2598",20200307,"CO",8,55,69,NA,NA,NA,NA,NA,NA,NA,"b3e767a79aa144a708ff8d26dd77311725722068","2020-03-07T21:00:00Z",NA,NA,132,63,63,8,0,0,9,6,15
"2599",20200307,"CT",0,NA,NA,NA,NA,NA,NA,NA,NA,NA,"d9e680a00789072a49cb76e097d4229667366ed7","2020-03-07T21:00:00Z",NA,NA,0,0,0,9,NA,NA,NA,NA,NA
"2600",20200307,"DC",0,8,1,NA,NA,NA,NA,NA,NA,NA,"e11c537902c2e50281d5f0474f9627885a7d2687","2020-03-07T21:00:00Z",NA,NA,9,8,8,11,0,0,0,0,0
"2601",20200307,"DE",0,10,0,NA,NA,NA,NA,NA,NA,NA,"7eadaaa0b57573c2bdbc9a8e6cb4491819bdebe3","2020-03-07T21:00:00Z",NA,NA,10,10,10,10,0,0,0,0,0
"2602",20200307,"FL",14,100,88,NA,NA,NA,NA,NA,NA,NA,"8e5302ac32c92ff9ad0d33eac5dbb7fadb2633fc","2020-03-07T21:00:00Z",NA,NA,202,114,114,12,0,0,45,5,50
"2603",20200307,"GA",6,NA,NA,NA,NA,NA,NA,NA,NA,NA,"300c65424c0683e4fe3b738ffa83c73e6e166987","2020-03-07T21:00:00Z",NA,NA,6,6,6,13,0,0,0,4,4
"2604",20200307,"HI",1,NA,NA,NA,NA,NA,NA,NA,NA,NA,"fdf9b14d1375f62ec31807e17621275a28a68e35","2020-03-07T21:00:00Z",NA,NA,1,1,1,15,NA,NA,NA,NA,NA
"2605",20200307,"IA",0,15,2,NA,NA,NA,NA,NA,NA,NA,"57014c410bdcf67c766c3bde093c62bf971bf561","2020-03-07T21:00:00Z",NA,NA,17,15,15,19,0,0,0,0,0
"2606",20200307,"ID",0,27,NA,NA,NA,NA,NA,NA,NA,NA,"4f4e0071fd17623d671266cb5b4d8f4a998e7635","2020-03-07T21:00:00Z",NA,NA,27,27,27,16,NA,NA,NA,NA,NA
"2607",20200307,"IL",6,191,44,NA,NA,NA,NA,NA,NA,NA,"0617c3d41d4b13ac629144876a75a2d391036742","2020-03-07T21:00:00Z",NA,NA,241,197,197,17,0,0,11,1,12
"2608",20200307,"IN",1,NA,NA,NA,NA,NA,NA,NA,NA,NA,"341ab30a48c34775d1b7fb9b4a82dea3d4bdff65","2020-03-07T21:00:00Z",NA,NA,1,1,1,18,0,0,0,0,0
"2609",20200307,"KS",0,11,2,NA,NA,NA,NA,NA,NA,NA,"3423d332e782b75c00baf7159c3aa95ea8927439","2020-03-07T21:00:00Z",NA,NA,13,11,11,20,0,0,7,0,7
"2610",20200307,"KY",1,9,NA,NA,NA,NA,NA,NA,NA,NA,"48c3d48fed83cfd2f32e9dbf06e7e1410d3e0fe6","2020-03-07T21:00:00Z",NA,NA,10,10,10,21,0,0,2,1,3
"2611",20200307,"LA",0,NA,NA,NA,NA,NA,NA,NA,NA,NA,"b7526761c843e52a6bd2a5e89719a7ed71cc0b5e","2020-03-07T21:00:00Z",NA,NA,0,0,0,22,NA,NA,NA,NA,NA
"2612",20200307,"MA",13,NA,NA,NA,NA,NA,NA,NA,NA,NA,"b919208fee55fb337773b232ea6298e5465a717d","2020-03-07T21:00:00Z",NA,NA,13,13,13,25,0,0,0,5,5
"2613",20200307,"MD",3,41,NA,NA,NA,NA,NA,NA,NA,NA,"b2d7275372012956019c1ac4675a486072ad50c0","2020-03-07T21:00:00Z",NA,NA,44,44,44,24,0,0,15,0,15
"2614",20200307,"ME",0,1,NA,NA,NA,NA,NA,NA,NA,NA,"78aa7cd66f9ed0076403ca7ace6b9725577d669a","2020-03-07T21:00:00Z",NA,NA,1,1,1,23,NA,NA,NA,NA,NA
"2615",20200307,"MI",128,18,9,NA,NA,NA,NA,NA,NA,NA,"03a5d353203118cadc5b2e6c3848c40f506ac849","2020-03-07T21:00:00Z",NA,NA,155,146,146,26,0,0,10,30,40
"2616",20200307,"MN",1,48,NA,NA,NA,NA,NA,NA,NA,NA,"dff67d839a61d912b7f7b0aa8a8eee5450a0add1","2020-03-07T21:00:00Z",NA,NA,49,49,49,27,0,0,12,1,13
"2617",20200307,"MO",0,NA,NA,NA,NA,NA,NA,NA,NA,NA,"9a6811180ce7cb71ab44738976d76cc4d0c0367c","2020-03-07T21:00:00Z",NA,NA,0,0,0,29,NA,NA,NA,NA,NA
"2618",20200307,"MS",0,NA,NA,NA,NA,NA,NA,NA,NA,NA,"8fd30f9053208bfd268115213ef81816a8d68513","2020-03-07T21:00:00Z",NA,NA,0,0,0,28,NA,NA,NA,NA,NA
"2619",20200307,"MT",0,11,NA,NA,NA,NA,NA,NA,NA,NA,"c798a10143524f3b801c3c12385d46f0d5445c45","2020-03-07T21:00:00Z",NA,NA,11,11,11,30,NA,NA,NA,NA,NA
"2620",20200307,"NC",2,NA,NA,NA,NA,NA,NA,NA,NA,NA,"430c5790ef495a5f85b57fec34083672077f2925","2020-03-07T21:00:00Z",NA,NA,2,2,2,37,0,0,0,0,0
"2621",20200307,"ND",0,0,NA,NA,NA,NA,NA,NA,NA,NA,"fd7ee9e623951efec04cf75ce2f3bcadec68ab35","2020-03-07T21:00:00Z",NA,NA,0,0,0,38,NA,NA,NA,NA,NA
"2622",20200307,"NE",1,17,5,NA,NA,NA,NA,NA,NA,NA,"f005dd04ec69b52d21ffd219b42d10b897d2ddf8","2020-03-07T21:00:00Z",NA,NA,23,18,18,31,0,0,0,1,1
"2623",20200307,"NH",2,20,3,NA,NA,NA,NA,NA,NA,NA,"c3cf83675171ed0cb3ea76ec42d8087ed0549f2a","2020-03-07T21:00:00Z",NA,NA,25,22,22,33,0,0,0,0,0
"2624",20200307,"NJ",4,NA,1,NA,NA,NA,NA,NA,NA,NA,"baa3a70b588e2de1d71ef9323e1fd51c2ddd7bf2","2020-03-07T21:00:00Z",NA,NA,5,4,4,34,0,0,0,3,3
"2625",20200307,"NM",0,48,0,NA,NA,NA,NA,NA,NA,NA,"d4fe05fba86ad47f27ecc0a2843641fc598e7ee2","2020-03-07T21:00:00Z",NA,NA,48,48,48,35,0,0,32,0,32
"2626",20200307,"NV",1,14,NA,NA,NA,NA,NA,NA,NA,NA,"ff7e53fb3780e09b6df2422f8b4c69da6e7984d0","2020-03-07T21:00:00Z",NA,NA,15,15,15,32,0,0,0,0,0
"2627",20200307,"NY",76,92,236,NA,NA,NA,NA,NA,NA,NA,"53a82f90b4d4a28a5b06248b1e4c78e9229312dd","2020-03-07T21:00:00Z",NA,NA,404,168,168,36,0,0,0,43,43
"2628",20200307,"OH",0,9,5,NA,NA,NA,NA,NA,NA,NA,"c69dfa83b8288b3843884ff6e720c8496b379d9f","2020-03-07T21:00:00Z",NA,NA,14,9,9,39,0,0,1,0,1
"2629",20200307,"OK",1,NA,NA,NA,NA,NA,NA,NA,NA,NA,"a289923d68e5122aaffefddb8b334840537c641f","2020-03-07T21:00:00Z",NA,NA,1,1,1,40,NA,NA,NA,NA,NA
"2630",20200307,"OR",7,77,40,NA,NA,NA,NA,NA,NA,NA,"46f67721ac9c9e4bf2223020998c4d83fcc7f249","2020-03-07T21:00:00Z",NA,NA,124,84,84,41,0,0,13,4,17
"2631",20200307,"PA",4,NA,NA,NA,NA,NA,NA,NA,NA,NA,"062165de38bf4ef54e8456000bb3d8a0ed14a6a4","2020-03-07T21:00:00Z",NA,NA,4,4,4,42,0,0,0,2,2
"2632",20200307,"RI",2,30,NA,NA,NA,NA,NA,NA,NA,NA,"9235e76ca0650027d60ea79ed06e02846b6fcdb8","2020-03-07T21:00:00Z",NA,NA,32,32,32,44,0,0,13,-1,12
"2633",20200307,"SC",2,8,NA,NA,NA,NA,NA,NA,NA,NA,"8544336c14b8c734fc20a32a015006d676c30244","2020-03-07T21:00:00Z",NA,NA,10,10,10,45,0,0,3,2,5
"2634",20200307,"SD",0,5,0,NA,NA,NA,NA,NA,NA,NA,"f9c85d0328866ae577e24ba09e3c4be8f679563c","2020-03-07T21:00:00Z",NA,NA,5,5,5,46,NA,NA,NA,NA,NA
"2635",20200307,"TN",1,NA,NA,NA,NA,NA,NA,NA,NA,NA,"1052cb0a616ff027ac81ae4e021811dfcde09418","2020-03-07T21:00:00Z",NA,NA,1,1,1,47,0,0,0,0,0
"2636",20200307,"TX",8,NA,NA,NA,NA,NA,NA,NA,NA,NA,"9442e419a19fb5a72a0c4f5541eb6988e51a4011","2020-03-07T21:00:00Z",NA,NA,8,8,8,48,0,0,0,3,3
"2637",20200307,"UT",1,NA,NA,NA,NA,NA,NA,NA,NA,NA,"a85957691ce29b13c25a9fa29751a40218bf593d","2020-03-07T21:00:00Z",NA,NA,1,1,1,49,NA,NA,NA,NA,NA
"2638",20200307,"VA",0,31,7,NA,NA,NA,NA,NA,NA,NA,"6e84c7d2e592ebc2a18731e74f79dbd87b2a9867","2020-03-07T21:00:00Z",NA,NA,38,31,31,51,0,0,10,0,10
"2639",20200307,"VT",0,16,NA,NA,NA,NA,NA,NA,NA,NA,"ff9af8b98a1d797de0df45f07ebcd9cd6f10d588","2020-03-07T21:00:00Z",NA,NA,16,16,16,50,0,0,8,0,8
"2640",20200307,"WA",182,370,66,NA,NA,NA,NA,NA,NA,NA,"fcf8fe2d8dd76def4f72fe536fe3ad97b01d3061","2020-03-07T21:00:00Z",27,NA,618,552,552,53,1,0,0,32,32
"2641",20200307,"WI",1,31,12,NA,NA,NA,NA,NA,NA,NA,"6ed08976196b8624bb1e5ae7c5fa420f672cd583","2020-03-07T21:00:00Z",NA,NA,44,32,32,55,0,0,0,0,0
"2642",20200307,"WV",0,2,3,NA,NA,NA,NA,NA,NA,NA,"709d5b8a2116344cd59199a1b319fae5f11d6bca","2020-03-07T21:00:00Z",NA,NA,5,2,2,54,0,0,1,0,1
"2643",20200307,"WY",0,NA,NA,NA,NA,NA,NA,NA,NA,NA,"265de6c0d476b4e78ad567a501a52ea9d1846184","2020-03-07T21:00:00Z",NA,NA,0,0,0,56,NA,NA,NA,NA,NA
"2644",20200306,"AK",0,8,1,NA,NA,NA,NA,NA,NA,NA,"afd8084305ea1ec41b5746d77dfc27eed92e555f","2020-03-06T21:00:00Z",0,NA,9,8,8,2,NA,NA,NA,NA,NA
"2645",20200306,"AR",0,6,0,NA,NA,NA,NA,NA,NA,NA,"baadb217d3fcf5f4811488adcd8f345a2a29e391","2020-03-06T21:00:00Z",NA,NA,6,6,6,5,NA,NA,NA,NA,NA
"2646",20200306,"AZ",3,33,15,NA,NA,NA,NA,NA,NA,NA,"bcfcf56b97c3f10a640d25f6148abbc1f17fa07d","2020-03-06T21:00:00Z",NA,NA,51,36,36,4,0,0,5,1,6
"2647",20200306,"CA",60,462,NA,NA,NA,NA,NA,NA,NA,NA,"ed5984edee3bf6ee9bc3b89bc15e52f3bdade592","2020-03-06T21:00:00Z",NA,NA,522,522,522,6,0,0,0,7,7
"2648",20200306,"CO",2,46,30,NA,NA,NA,NA,NA,NA,NA,"2affe95a8de9524f8e77344a5a354729331024fa","2020-03-06T21:00:00Z",NA,NA,78,48,48,8,0,0,27,2,29
"2649",20200306,"DC",0,8,1,NA,NA,NA,NA,NA,NA,NA,"0916c062b23fb7dafb1a661e9e93554b146102bc","2020-03-06T21:00:00Z",NA,NA,9,8,8,11,0,0,2,0,2
"2650",20200306,"DE",0,10,0,NA,NA,NA,NA,NA,NA,NA,"ce64a0188bd545e3f624bf5c958ad5a308f7c042","2020-03-06T21:00:00Z",NA,NA,10,10,10,10,NA,NA,NA,NA,NA
"2651",20200306,"FL",9,55,51,NA,NA,NA,NA,NA,NA,NA,"ec1d19fd312871b78238dee947a1614eb253b818","2020-03-06T21:00:00Z",NA,NA,115,64,64,12,0,0,24,0,24
"2652",20200306,"GA",2,NA,NA,NA,NA,NA,NA,NA,NA,NA,"d6ae73ad152b1a4b8de98e45e77180669400ec85","2020-03-06T21:00:00Z",NA,NA,2,2,2,13,0,0,0,0,0
"2653",20200306,"IA",0,15,2,NA,NA,NA,NA,NA,NA,NA,"73ace108c09e0e8391d16fb4cc771e1dd2107a8a","2020-03-06T21:00:00Z",NA,NA,17,15,15,19,NA,NA,NA,NA,NA
"2654",20200306,"IL",5,180,35,NA,NA,NA,NA,NA,NA,NA,"cea4d67d62c223cc0e6e983c16ec4eb1e7e287e7","2020-03-06T21:00:00Z",NA,NA,220,185,185,17,0,0,15,0,15
"2655",20200306,"IN",1,NA,NA,NA,NA,NA,NA,NA,NA,NA,"57d3744352ffb9db87fd1bf34f0a80df811443d2","2020-03-06T21:00:00Z",NA,NA,1,1,1,18,NA,NA,NA,NA,NA
"2656",20200306,"KS",0,4,0,NA,NA,NA,NA,NA,NA,NA,"69d9379255fba9dc0e12dc3d34568cf662050519","2020-03-06T21:00:00Z",NA,NA,4,4,4,20,NA,NA,NA,NA,NA
"2657",20200306,"KY",0,7,3,NA,NA,NA,NA,NA,NA,NA,"d14490bb62ff36a14f6d7d3983dcc37a6213f306","2020-03-06T21:00:00Z",NA,NA,10,7,7,21,NA,NA,NA,NA,NA
"2658",20200306,"MA",8,NA,NA,NA,NA,NA,NA,NA,NA,NA,"ba07a81180b3f869f4fc9a15473d56c77bda4a58","2020-03-06T21:00:00Z",NA,NA,8,8,8,25,0,0,0,6,6
"2659",20200306,"MD",3,26,12,NA,NA,NA,NA,NA,NA,NA,"1fa11fd8e4ccf23cd88dad0abf8f2ed09692b6f7","2020-03-06T21:00:00Z",NA,NA,41,29,29,24,0,0,9,3,12
"2660",20200306,"MI",98,8,8,NA,NA,NA,NA,NA,NA,NA,"ec49ca56f5a15fa1d7ab227db8ee518383b80bd1","2020-03-06T21:00:00Z",NA,NA,114,106,106,26,0,0,0,26,26
"2661",20200306,"MN",0,36,NA,NA,NA,NA,NA,NA,NA,NA,"e5132c799bd8a985ee5eebaa58cc91fe172d2252","2020-03-06T21:00:00Z",NA,NA,36,36,36,27,NA,NA,NA,NA,NA
"2662",20200306,"NC",2,NA,NA,NA,NA,NA,NA,NA,NA,NA,"7dc32933c444ad3ead82aae5b70360d952aa26f5","2020-03-06T21:00:00Z",NA,NA,2,2,2,37,0,0,0,1,1
"2663",20200306,"NE",0,17,5,NA,NA,NA,NA,NA,NA,NA,"f6a3dae478e443059d53552df4bcdfcbf1df1562","2020-03-06T21:00:00Z",NA,NA,22,17,17,31,0,0,0,0,0
"2664",20200306,"NH",2,20,3,NA,NA,NA,NA,NA,NA,NA,"cb6d3e65ea48c1b73ea053bd4fff5effe820cd79","2020-03-06T21:00:00Z",NA,NA,25,22,22,33,0,0,4,0,4
"2665",20200306,"NJ",1,NA,NA,NA,NA,NA,NA,NA,NA,NA,"c1ebdfb1febe7a106dd31b8742d983a21185c3bf","2020-03-06T21:00:00Z",NA,NA,1,1,1,34,0,0,0,0,0
"2666",20200306,"NM",0,16,0,NA,NA,NA,NA,NA,NA,NA,"a7fdde839cc24edda883ae6eded317516823f0d3","2020-03-06T21:00:00Z",NA,NA,16,16,16,35,NA,NA,NA,NA,NA
"2667",20200306,"NV",1,14,NA,NA,NA,NA,NA,NA,NA,NA,"987c6d506024afbec19c37ec86dbb2f36578a842","2020-03-06T21:00:00Z",NA,NA,15,15,15,32,0,0,0,0,0
"2668",20200306,"NY",33,92,236,NA,NA,NA,NA,NA,NA,NA,"18e7306085561597629e7ffac110572b1aa9f9e5","2020-03-06T21:00:00Z",NA,NA,361,125,125,36,0,0,16,11,27
"2669",20200306,"OH",0,8,2,NA,NA,NA,NA,NA,NA,NA,"053530986545d47250674a6c7891318414ac402d","2020-03-06T21:00:00Z",NA,NA,10,8,8,39,0,0,1,0,1
"2670",20200306,"OR",3,64,28,NA,NA,NA,NA,NA,NA,NA,"8c2cf703264be22af405b67f312c031ee48a2c49","2020-03-06T21:00:00Z",NA,NA,95,67,67,41,0,0,19,0,19
"2671",20200306,"PA",2,NA,NA,NA,NA,NA,NA,NA,NA,NA,"3ce04ca60daa0171a4965e6870cd5710345e8669","2020-03-06T21:00:00Z",NA,NA,2,2,2,42,NA,NA,NA,NA,NA
"2672",20200306,"RI",3,17,NA,NA,NA,NA,NA,NA,NA,NA,"132069fe25a4d56033778fb0b12c743931e65638","2020-03-06T21:00:00Z",NA,NA,20,20,20,44,0,0,0,1,1
"2673",20200306,"SC",0,5,NA,NA,NA,NA,NA,NA,NA,NA,"3b871b1d4242a1fb3eb15e01fdb317126da865b0","2020-03-06T21:00:00Z",NA,NA,5,5,5,45,0,0,0,0,0
"2674",20200306,"TN",1,NA,NA,NA,NA,NA,NA,NA,NA,NA,"c08f2fdfc2a48fde032229c9b4181788db59f9f3","2020-03-06T21:00:00Z",NA,NA,1,1,1,47,0,0,0,0,0
"2675",20200306,"TX",5,NA,NA,NA,NA,NA,NA,NA,NA,NA,"cd363e289639a9dfe6b4575b0f64f46900a7901b","2020-03-06T21:00:00Z",NA,NA,5,5,5,48,0,0,0,4,4
"2676",20200306,"VA",0,21,10,NA,NA,NA,NA,NA,NA,NA,"d226abb632c34f9036421499b7f6c7bc248bb483","2020-03-06T21:00:00Z",NA,NA,31,21,21,51,0,0,3,0,3
"2677",20200306,"VT",0,8,NA,NA,NA,NA,NA,NA,NA,NA,"a4dec17604c465729da7a9dfe9e9ec4426c32672","2020-03-06T21:00:00Z",NA,NA,8,8,8,50,NA,NA,NA,NA,NA
"2678",20200306,"WA",150,370,NA,NA,NA,NA,NA,NA,NA,NA,"0ff03b67b7e977308b908f519e0e563edcd4b225","2020-03-06T21:00:00Z",26,NA,520,520,520,53,6,0,370,53,423
"2679",20200306,"WI",1,31,12,NA,NA,NA,NA,NA,NA,NA,"b96ccd39757d6ceed4a2d639e0095b3d8f8f3434","2020-03-06T21:00:00Z",NA,NA,44,32,32,55,0,0,12,0,12
"2680",20200306,"WV",0,1,4,NA,NA,NA,NA,NA,NA,NA,"68d062b16bb06f20eabeb52ee79544ec7a511018","2020-03-06T21:00:00Z",NA,NA,5,1,1,54,NA,NA,NA,NA,NA
"2681",20200305,"AZ",2,28,6,NA,NA,NA,NA,NA,NA,NA,"3e94b739062d1c0306f5279361451cd382171ccf","2020-03-05T21:00:00Z",NA,NA,36,30,30,4,0,0,1,0,1
"2682",20200305,"CA",53,462,NA,NA,NA,NA,NA,NA,NA,NA,"ce0755ed64d8d97da631569ac60cacb5e301a000","2020-03-05T21:00:00Z",NA,NA,515,515,515,6,0,0,0,0,0
"2683",20200305,"CO",0,19,21,NA,NA,NA,NA,NA,NA,NA,"e45a58fa7b4795ecc217438ff041a6bd2b925fe3","2020-03-05T21:00:00Z",NA,NA,40,19,19,8,NA,NA,NA,NA,NA
"2684",20200305,"DC",0,6,2,NA,NA,NA,NA,NA,NA,NA,"86141ea62e1c9a456849cf2f2196a31ac9669154","2020-03-05T21:00:00Z",NA,NA,8,6,6,11,NA,NA,NA,NA,NA
"2685",20200305,"FL",9,31,69,NA,NA,NA,NA,NA,NA,NA,"d7d91ffc92fbbfad57ff361b0193d3f7df25b958","2020-03-05T21:00:00Z",NA,NA,109,40,40,12,0,0,7,7,14
"2686",20200305,"GA",2,NA,NA,NA,NA,NA,NA,NA,NA,NA,"4247fbf0514b9492027b2328f3f2dc0b2e45f063","2020-03-05T21:00:00Z",NA,NA,2,2,2,13,0,0,0,0,0
"2687",20200305,"IL",5,165,27,NA,NA,NA,NA,NA,NA,NA,"b4c9428d01eee9c65c8053a8cd8af2b28f9d7440","2020-03-05T21:00:00Z",NA,NA,197,170,170,17,0,0,41,1,42
"2688",20200305,"MA",2,NA,NA,NA,NA,NA,NA,NA,NA,NA,"ad6e88d352dfa8b8f0dd1bf41a2c506911f25bc0","2020-03-05T21:00:00Z",NA,NA,2,2,2,25,0,0,0,0,0
"2689",20200305,"MD",0,17,14,NA,NA,NA,NA,NA,NA,NA,"0d90494b997e148552cd6034f5f347e1d5afb802","2020-03-05T21:00:00Z",NA,NA,31,17,17,24,NA,NA,NA,NA,NA
"2690",20200305,"MI",72,8,0,NA,NA,NA,NA,NA,NA,NA,"4a992bf64f4a07cb05d05455dfbc9e029ed9b7bd","2020-03-05T21:00:00Z",NA,NA,80,80,80,26,0,0,8,20,28
"2691",20200305,"NC",1,NA,NA,NA,NA,NA,NA,NA,NA,NA,"d3f8875e94e71c97de0283327b26f1feca9172e0","2020-03-05T21:00:00Z",NA,NA,1,1,1,37,0,0,0,0,0
"2692",20200305,"NE",0,17,5,NA,NA,NA,NA,NA,NA,NA,"5a0d06bda6fe7a3d859877a222126a595c97fc61","2020-03-05T21:00:00Z",NA,NA,22,17,17,31,NA,NA,NA,NA,NA
"2693",20200305,"NH",2,16,4,NA,NA,NA,NA,NA,NA,NA,"7e34f4dacfe1b54e984b2725002f97e08fbae32d","2020-03-05T21:00:00Z",NA,NA,22,18,18,33,0,0,6,0,6
"2694",20200305,"NJ",1,NA,NA,NA,NA,NA,NA,NA,NA,NA,"80fa3d5297f9e2b3a46fa82bf816c002d9da0976","2020-03-05T21:00:00Z",NA,NA,1,1,1,34,NA,NA,NA,NA,NA
"2695",20200305,"NV",1,14,NA,NA,NA,NA,NA,NA,NA,NA,"c75ee774e7c6ee7ca098db7e8bdd27109e94471a","2020-03-05T21:00:00Z",NA,NA,15,15,15,32,NA,NA,NA,NA,NA
"2696",20200305,"NY",22,76,24,NA,NA,NA,NA,NA,NA,NA,"a5eb1a3c895ee3acd8c87b19363bab6d581b3933","2020-03-05T21:00:00Z",NA,NA,122,98,98,36,0,0,28,16,44
"2697",20200305,"OH",0,7,3,NA,NA,NA,NA,NA,NA,NA,"1bbd3319a4e6db7805828c6b8588392ceb2ad0f0","2020-03-05T21:00:00Z",NA,NA,10,7,7,39,NA,NA,NA,NA,NA
"2698",20200305,"OR",3,45,13,NA,NA,NA,NA,NA,NA,NA,"99211bd19ed97ed9d4cf2ff512e5df794b13f3b8","2020-03-05T21:00:00Z",NA,NA,61,48,48,41,0,0,16,0,16
"2699",20200305,"RI",2,17,NA,NA,NA,NA,NA,NA,NA,NA,"0cb8184c9f75efd169366f854e083f655d5d8587","2020-03-05T21:00:00Z",NA,NA,19,19,19,44,0,0,6,0,6
"2700",20200305,"SC",0,5,NA,NA,NA,NA,NA,NA,NA,NA,"dd1265c2ed9b63d775342c5be9e03be78801ba0c","2020-03-05T21:00:00Z",NA,NA,5,5,5,45,0,0,0,0,0
"2701",20200305,"TN",1,NA,NA,NA,NA,NA,NA,NA,NA,NA,"d6b98cde0f741d1de22a669e2bcbdd2455e12b8a","2020-03-05T21:00:00Z",NA,NA,1,1,1,47,NA,NA,NA,NA,NA
"2702",20200305,"TX",1,NA,NA,NA,NA,NA,NA,NA,NA,NA,"d7dc50f88fb103b81e0745b9f7824ed7ee6c1738","2020-03-05T21:00:00Z",NA,NA,1,1,1,48,0,0,0,0,0
"2703",20200305,"VA",0,18,3,NA,NA,NA,NA,NA,NA,NA,"c34566b6ec1573923e494c44f1c6b744fed9b3ad","2020-03-05T21:00:00Z",NA,NA,21,18,18,51,NA,NA,NA,NA,NA
"2704",20200305,"WA",97,NA,NA,NA,NA,NA,NA,NA,NA,NA,"a1f71da81ebb96f592dccf731b295fddac77f04a","2020-03-05T21:00:00Z",20,NA,97,97,97,53,4,0,0,21,21
"2705",20200305,"WI",1,19,6,NA,NA,NA,NA,NA,NA,NA,"3620b6a39cef411a89d895ac830c5c954ce63541","2020-03-05T21:00:00Z",NA,NA,26,20,20,55,0,0,0,0,0
"2706",20200304,"AZ",2,27,5,NA,NA,NA,NA,NA,NA,NA,"f9b5336be00388e0549a6e35cfbe7ec911597df2","2020-03-04T21:00:00Z",NA,NA,34,29,29,4,NA,NA,NA,NA,NA
"2707",20200304,"CA",53,462,NA,NA,NA,NA,NA,NA,NA,NA,"e89c69dcaf7f202257af579a58f86c340eee886a","2020-03-04T21:00:00Z",NA,NA,515,515,515,6,NA,NA,NA,NA,NA
"2708",20200304,"FL",2,24,16,NA,NA,NA,NA,NA,NA,NA,"827f5f46040136c1b1901fef08f15b03805c57f5","2020-03-04T21:00:00Z",NA,NA,42,26,26,12,NA,NA,NA,NA,NA
"2709",20200304,"GA",2,NA,NA,NA,NA,NA,NA,NA,NA,NA,"5a4b97663e22df521e97a56f67c3f458eafb2e59","2020-03-04T21:00:00Z",NA,NA,2,2,2,13,NA,NA,NA,NA,NA
"2710",20200304,"IL",4,124,27,NA,NA,NA,NA,NA,NA,NA,"c99302904c1de329aeb568cdf92affb6dd5921ad","2020-03-04T21:00:00Z",NA,NA,155,128,128,17,NA,NA,NA,NA,NA
"2711",20200304,"MA",2,NA,NA,NA,NA,NA,NA,NA,NA,NA,"36d8d4b1b34007477b562a078613309f63e7bd0e","2020-03-04T21:00:00Z",NA,NA,2,2,2,25,NA,NA,NA,NA,NA
"2712",20200304,"MI",52,NA,NA,NA,NA,NA,NA,NA,NA,NA,"50cc0fb10791e6f2cb774135dd28ee2c6fc0f942","2020-03-04T21:00:00Z",NA,NA,52,52,52,26,0,0,0,18,18
"2713",20200304,"NC",1,NA,NA,NA,NA,NA,NA,NA,NA,NA,"0361de92db7c1867144ce35f0d61e1588f3a13d5","2020-03-04T21:00:00Z",NA,NA,1,1,1,37,NA,NA,NA,NA,NA
"2714",20200304,"NH",2,10,7,NA,NA,NA,NA,NA,NA,NA,"57c57bb5f40efbba8ab043701700324b09ac602d","2020-03-04T21:00:00Z",NA,NA,19,12,12,33,NA,NA,NA,NA,NA
"2715",20200304,"NY",6,48,24,NA,NA,NA,NA,NA,NA,NA,"0e095e2b3db515b00d892276e6cac6912b1e0111","2020-03-04T21:00:00Z",NA,NA,78,54,54,36,NA,NA,NA,NA,NA
"2716",20200304,"OR",3,29,18,NA,NA,NA,NA,NA,NA,NA,"d63f4cf486a6d2f86062b9af1bd46955abd90cb9","2020-03-04T21:00:00Z",NA,NA,50,32,32,41,NA,NA,NA,NA,NA
"2717",20200304,"RI",2,11,NA,NA,NA,NA,NA,NA,NA,NA,"577f034e9cef2b6ed639a0ad879ad6a0c9d464fb","2020-03-04T21:00:00Z",NA,NA,13,13,13,44,0,0,5,0,5
"2718",20200304,"SC",0,5,NA,NA,NA,NA,NA,NA,NA,NA,"b244652e8adea8d1cc5d5961f023465f579156e0","2020-03-04T21:00:00Z",NA,NA,5,5,5,45,NA,NA,NA,NA,NA
"2719",20200304,"TX",1,NA,NA,NA,NA,NA,NA,NA,NA,NA,"d29839e81cae6ba53df2d1a1d7bfeddfd4fc8509","2020-03-04T21:00:00Z",NA,NA,1,1,1,48,NA,NA,NA,NA,NA
"2720",20200304,"WA",76,NA,NA,NA,NA,NA,NA,NA,NA,NA,"73e895391b8ece472eb367f685b93311f5272435","2020-03-04T21:00:00Z",16,NA,76,76,76,53,2,0,0,18,18
"2721",20200304,"WI",1,19,6,NA,NA,NA,NA,NA,NA,NA,"c1fede94be9a426dc9c3b5d26d33b9f168fec21c","2020-03-04T21:00:00Z",NA,NA,26,20,20,55,NA,NA,NA,NA,NA
"2722",20200303,"MI",34,NA,NA,NA,NA,NA,NA,NA,NA,NA,"fd660f6b972506bb4cd22c405ccc50fe1bc78034","2020-03-03T21:00:00Z",NA,NA,34,34,34,26,0,0,0,16,16
"2723",20200303,"RI",2,6,NA,NA,NA,NA,NA,NA,NA,NA,"2178a2f31e1a9100543e0beeea446d5520c2eeaa","2020-03-03T21:00:00Z",NA,NA,8,8,8,44,0,0,6,1,7
"2724",20200303,"WA",58,NA,NA,NA,NA,NA,NA,NA,NA,NA,"a96ba58ec4c5d84a9ba6568a8803d46be50c085c","2020-03-03T21:00:00Z",14,NA,58,58,58,53,3,0,0,24,24
"2725",20200302,"MI",18,NA,NA,NA,NA,NA,NA,NA,NA,NA,"f3f4de102c6a551d77afba110d25593544389fea","2020-03-02T21:00:00Z",NA,NA,18,18,18,26,0,0,0,9,9
"2726",20200302,"RI",1,NA,NA,NA,NA,NA,NA,NA,NA,NA,"6049ac06541847a4b2afaaef7ea4b08defbc8d8d","2020-03-02T21:00:00Z",NA,NA,1,1,1,44,0,0,0,0,0
"2727",20200302,"WA",34,NA,NA,NA,NA,NA,NA,NA,NA,NA,"260b8492bd547848413805f76957352609ec0adb","2020-03-02T21:00:00Z",11,NA,34,34,34,53,3,0,0,4,4
"2728",20200301,"MI",9,NA,NA,NA,NA,NA,NA,NA,NA,NA,"32031e8ccdd5e7665b34254420b0a13603a06f23","2020-03-01T21:00:00Z",NA,NA,9,9,9,26,NA,NA,NA,NA,NA
"2729",20200301,"RI",1,NA,NA,NA,NA,NA,NA,NA,NA,NA,"a988931eea2a273da2fbabc46829f2afaf5eb0af","2020-03-01T21:00:00Z",NA,NA,1,1,1,44,NA,NA,NA,NA,NA
"2730",20200301,"WA",30,NA,NA,NA,NA,NA,NA,NA,NA,NA,"29062fbf668444e85f93fd9ecdc31123e5b2eaea","2020-03-01T21:00:00Z",8,NA,30,30,30,53,3,0,0,12,12
"2731",20200229,"WA",18,NA,NA,NA,NA,NA,NA,NA,NA,NA,"f76eb082634b68db6443b792f481a86c6c41f20b","2020-02-29T21:00:00Z",5,NA,18,18,18,53,1,0,0,9,9
"2732",20200228,"WA",9,NA,NA,NA,NA,NA,NA,NA,NA,NA,"d89ae68938d114a40da5cf3a26c2a9e1301713a6","2020-02-28T21:00:00Z",4,NA,9,9,9,53,4,0,0,7,7
"2733",20200227,"WA",2,NA,NA,NA,NA,NA,NA,NA,NA,NA,"319d1bf6077ccf2f394eb8cabbb580b376438221","2020-02-27T21:00:00Z",NA,NA,2,2,2,53,0,0,0,0,0
"2734",20200226,"WA",2,NA,NA,NA,NA,NA,NA,NA,NA,NA,"d0f828e00868304ff6766fe51764dcab75662038","2020-02-26T21:00:00Z",NA,NA,2,2,2,53,0,0,0,0,0
"2735",20200225,"WA",2,NA,NA,NA,NA,NA,NA,NA,NA,NA,"68dc2f361ec0699c027370cc8a12cedd3b2f57b2","2020-02-25T21:00:00Z",NA,NA,2,2,2,53,0,0,0,0,0
"2736",20200224,"WA",2,NA,NA,NA,NA,NA,NA,NA,NA,NA,"7a2455094f6696e6faf83899ec20b7bddfe24126","2020-02-24T21:00:00Z",NA,NA,2,2,2,53,0,0,0,0,0
"2737",20200223,"WA",2,NA,NA,NA,NA,NA,NA,NA,NA,NA,"cc05fc1bf2ca804190d87169cc4f4b43bac23182","2020-02-23T21:00:00Z",NA,NA,2,2,2,53,0,0,0,0,0
"2738",20200222,"WA",2,NA,NA,NA,NA,NA,NA,NA,NA,NA,"0b0c39f4a18bade675668306af136ab2f53697fe","2020-02-22T21:00:00Z",NA,NA,2,2,2,53,0,0,0,0,0
"2739",20200221,"WA",2,NA,NA,NA,NA,NA,NA,NA,NA,NA,"eaff5214cdc4093f59ce5263f18e38fbeb77494f","2020-02-21T21:00:00Z",NA,NA,2,2,2,53,0,0,0,0,0
"2740",20200220,"WA",2,NA,NA,NA,NA,NA,NA,NA,NA,NA,"d12c28e16b6c035d831f66f1f2ff4e21428d8410","2020-02-20T21:00:00Z",NA,NA,2,2,2,53,0,0,0,0,0
"2741",20200219,"WA",2,NA,NA,NA,NA,NA,NA,NA,NA,NA,"33a0bde3a78c103d70d40f0e4b082e0924bb88a9","2020-02-19T21:00:00Z",NA,NA,2,2,2,53,0,0,0,0,0
"2742",20200218,"WA",2,NA,NA,NA,NA,NA,NA,NA,NA,NA,"94e59f706a1ba4aa5625505a161a75ece80a2da7","2020-02-18T21:00:00Z",NA,NA,2,2,2,53,0,0,0,0,0
"2743",20200217,"WA",2,NA,NA,NA,NA,NA,NA,NA,NA,NA,"3f8596d7c483dba78113e8d0d65ed4d99a6d04a7","2020-02-17T21:00:00Z",NA,NA,2,2,2,53,0,0,0,0,0
"2744",20200216,"WA",2,NA,NA,NA,NA,NA,NA,NA,NA,NA,"af9516a222c7f704d59d4e6d6195e6dca877916f","2020-02-16T21:00:00Z",NA,NA,2,2,2,53,0,0,0,0,0
"2745",20200215,"WA",2,NA,NA,NA,NA,NA,NA,NA,NA,NA,"0b9c33043957b09ee2efbfe857464c77ef941b10","2020-02-15T21:00:00Z",NA,NA,2,2,2,53,0,0,0,0,0
"2746",20200214,"WA",2,NA,NA,NA,NA,NA,NA,NA,NA,NA,"8dfd28c8d7682539add565c210d8a0f70993edf4","2020-02-14T21:00:00Z",NA,NA,2,2,2,53,0,0,0,0,0
"2747",20200213,"WA",2,NA,NA,NA,NA,NA,NA,NA,NA,NA,"5bdde2575d31ba09e348483d4ac4c60e0e3dfea4","2020-02-13T21:00:00Z",NA,NA,2,2,2,53,0,0,0,0,0
"2748",20200212,"WA",2,NA,NA,NA,NA,NA,NA,NA,NA,NA,"fd56c52779001fe578fa700d170055d8b36b6159","2020-02-12T21:00:00Z",NA,NA,2,2,2,53,0,0,0,0,0
"2749",20200211,"WA",2,NA,NA,NA,NA,NA,NA,NA,NA,NA,"1c7c51ebe96c06f3c1cefb071f1ab57ff61e2496","2020-02-11T21:00:00Z",NA,NA,2,2,2,53,0,0,0,0,0
"2750",20200210,"WA",2,NA,NA,NA,NA,NA,NA,NA,NA,NA,"ff9c0bcb7288f5f6e85046a96a89aca422e939dd","2020-02-10T21:00:00Z",NA,NA,2,2,2,53,0,0,0,0,0
"2751",20200209,"WA",2,NA,NA,NA,NA,NA,NA,NA,NA,NA,"e8120b7135f2fc4c57551fd8554a82cb385271b0","2020-02-09T21:00:00Z",NA,NA,2,2,2,53,0,0,0,0,0
"2752",20200208,"WA",2,NA,NA,NA,NA,NA,NA,NA,NA,NA,"3718ec25876bd3354eb87168a1ee3374198dd439","2020-02-08T21:00:00Z",NA,NA,2,2,2,53,0,0,0,0,0
"2753",20200207,"WA",2,NA,NA,NA,NA,NA,NA,NA,NA,NA,"c8987a6f7b6bda4a108b0bfbbfba4c9c206dbdf2","2020-02-07T21:00:00Z",NA,NA,2,2,2,53,0,0,0,1,1
"2754",20200206,"WA",1,NA,NA,NA,NA,NA,NA,NA,NA,NA,"77480a3b7eef8ef3f86746ba93a3c41a9f028eab","2020-02-06T21:00:00Z",NA,NA,1,1,1,53,0,0,0,0,0
"2755",20200205,"WA",1,NA,NA,NA,NA,NA,NA,NA,NA,NA,"9953c7552e586867ae42a8fc6b1957e653f2ab3c","2020-02-05T21:00:00Z",NA,NA,1,1,1,53,0,0,0,0,0
"2756",20200204,"WA",1,NA,NA,NA,NA,NA,NA,NA,NA,NA,"809dd1add519b3d81fcc94cf845f572096c7ed1c","2020-02-04T21:00:00Z",NA,NA,1,1,1,53,0,0,0,0,0
"2757",20200203,"WA",1,NA,NA,NA,NA,NA,NA,NA,NA,NA,"9500e206243c7dec91d1f89092aba0c92bf5aad2","2020-02-03T21:00:00Z",NA,NA,1,1,1,53,0,0,0,0,0
"2758",20200202,"WA",1,NA,NA,NA,NA,NA,NA,NA,NA,NA,"34b3c8d84417aff0ffa65274a6ccae208269b2c5","2020-02-02T21:00:00Z",NA,NA,1,1,1,53,0,0,0,0,0
"2759",20200201,"WA",1,NA,NA,NA,NA,NA,NA,NA,NA,NA,"7f6e2e3541cc39c8faf360eded70120ef1f01374","2020-02-01T21:00:00Z",NA,NA,1,1,1,53,0,0,0,0,0
"2760",20200131,"WA",1,NA,NA,NA,NA,NA,NA,NA,NA,NA,"e2c94eb4a9635a3bf35ae46ceb7f5496ae5596d4","2020-01-31T21:00:00Z",NA,NA,1,1,1,53,0,0,0,0,0
"2761",20200130,"WA",1,NA,NA,NA,NA,NA,NA,NA,NA,NA,"ba725dcd4055b95a974e7ad68b415e63cc026664","2020-01-30T21:00:00Z",NA,NA,1,1,1,53,0,0,0,0,0
"2762",20200129,"WA",1,NA,NA,NA,NA,NA,NA,NA,NA,NA,"ebd3db8123a213ec18160315a9cae98933f811a3","2020-01-29T21:00:00Z",NA,NA,1,1,1,53,0,0,0,0,0
"2763",20200128,"WA",1,NA,NA,NA,NA,NA,NA,NA,NA,NA,"40d46918d08a46309d5228751d4d315d972428a5","2020-01-28T21:00:00Z",NA,NA,1,1,1,53,0,0,0,0,0
"2764",20200127,"WA",1,NA,NA,NA,NA,NA,NA,NA,NA,NA,"15d0ad948df84d87c31ab25a4091a1980670fedd","2020-01-27T21:00:00Z",NA,NA,1,1,1,53,0,0,0,0,0
"2765",20200126,"WA",1,NA,NA,NA,NA,NA,NA,NA,NA,NA,"405aae8b4155c77878ab1e2a85f32d7bb7a45c9a","2020-01-26T21:00:00Z",NA,NA,1,1,1,53,0,0,0,0,0
"2766",20200125,"WA",1,NA,NA,NA,NA,NA,NA,NA,NA,NA,"f17fc4cde1b2e7b57e946752d620e48d7f02c7ce","2020-01-25T21:00:00Z",NA,NA,1,1,1,53,0,0,0,0,0
"2767",20200124,"WA",1,NA,NA,NA,NA,NA,NA,NA,NA,NA,"4763cdf13300976ba41317d7c7767e1c558a1134","2020-01-24T21:00:00Z",NA,NA,1,1,1,53,0,0,0,0,0
"2768",20200123,"WA",1,NA,NA,NA,NA,NA,NA,NA,NA,NA,"faa0d0b985f479eac50082e417dc84f9e645db8f","2020-01-23T21:00:00Z",NA,NA,1,1,1,53,0,0,0,0,0
"2769",20200122,"WA",1,NA,NA,NA,NA,NA,NA,NA,NA,NA,"299b5b62b4d05b5d61eba3e3730bb17d025ceb75","2020-01-22T21:00:00Z",NA,NA,1,1,1,53,NA,NA,NA,NA,NA
